id,user_id,sum_amount_usd,count_amount_usd,transactions_2018,transactions_2019_May,last_transaction_month,months,transaction_april,transaction_may
0,user_0,13684,389,254,135,May-19,0,1,1
1,user_1,6104,129,113,16,Feb-19,3,0,0
2,user_2,1335,96,68,28,Apr-19,1,1,0
3,user_3,16578,268,266,2,Mar-19,2,0,0
4,user_4,9127,47,43,4,Jan-19,4,0,0
5,user_5,1632,51,44,7,May-19,0,1,1
6,user_6,11,2,2,0,Dec-18,5,0,0
7,user_7,1074,7,6,1,Jan-19,4,0,0
8,user_8,856,51,51,0,Dec-18,5,0,0
9,user_9,13909,79,66,13,May-19,0,0,1
10,user_10,52150,1053,721,332,May-19,0,1,1
11,user_11,1468,7,7,0,Feb-18,15,0,0
12,user_12,37106,499,491,8,May-19,0,1,1
13,user_13,1433,71,67,4,Mar-19,2,0,0
14,user_14,10745,31,4,27,May-19,0,1,1
15,user_15,21463,206,192,14,Mar-19,2,0,0
16,user_16,2601,121,69,52,May-19,0,0,1
17,user_17,19873,46,43,3,Feb-19,3,0,0
18,user_18,9971,20,20,0,Mar-18,14,0,0
19,user_19,41409,424,304,120,May-19,0,1,1
20,user_20,23401,404,216,188,May-19,0,1,1
21,user_21,12272,90,37,53,Apr-19,1,1,0
22,user_22,20913,135,110,25,Apr-19,1,1,0
23,user_23,19712,37,37,0,Sep-18,8,0,0
24,user_24,11,1,0,1,Apr-19,1,1,0
25,user_25,2791,21,18,3,Mar-19,2,0,0
26,user_26,6637,194,193,1,Apr-19,1,1,0
27,user_27,17481,334,333,1,Jan-19,4,0,0
28,user_28,331,17,14,3,Apr-19,1,1,0
29,user_29,7951,225,181,44,May-19,0,1,1
30,user_30,13211,697,355,342,May-19,0,1,1
31,user_31,14376,57,57,0,Nov-18,6,0,0
32,user_32,151,3,0,3,Feb-19,3,0,0
33,user_33,404,20,20,0,Jun-18,11,0,0
34,user_34,2133,141,101,40,Apr-19,1,1,0
35,user_35,1715,114,80,34,May-19,0,1,1
36,user_36,68105,220,177,43,May-19,0,1,1
37,user_37,20763,633,631,2,Mar-19,2,0,0
38,user_38,11625,367,367,0,Nov-18,6,0,0
39,user_39,2648,65,57,8,May-19,0,1,1
40,user_40,955,35,35,0,Aug-18,9,0,0
41,user_41,471,32,13,19,May-19,0,0,1
42,user_42,5678,119,119,0,Nov-18,6,0,0
43,user_43,754,50,39,11,May-19,0,1,1
44,user_44,189,4,4,0,Feb-18,15,0,0
45,user_45,12661,147,147,0,Jul-18,10,0,0
46,user_46,1053,23,23,0,Mar-18,14,0,0
47,user_47,27661,371,215,156,May-19,0,1,1
48,user_48,4961,79,0,79,May-19,0,1,1
49,user_49,314,11,6,5,Mar-19,2,0,0
50,user_50,20,5,5,0,Mar-18,14,0,0
51,user_51,2927,120,68,52,May-19,0,1,1
52,user_52,12771,235,132,103,Apr-19,1,1,0
53,user_53,32915,117,112,5,May-19,0,0,1
54,user_54,49792,484,296,188,Apr-19,1,1,0
55,user_55,35878,258,167,91,May-19,0,1,1
56,user_56,1476,36,0,36,Apr-19,1,1,0
57,user_57,1084,193,128,65,May-19,0,1,1
58,user_58,6353,64,63,1,May-19,0,0,1
59,user_59,10863,198,158,40,Apr-19,1,1,0
61,user_61,22398,881,613,268,May-19,0,1,1
62,user_62,17683,938,67,871,May-19,0,1,1
63,user_63,8489,121,78,43,Apr-19,1,1,0
64,user_64,72130,460,215,245,May-19,0,1,1
65,user_65,326,9,7,2,Feb-19,3,0,0
66,user_66,101,40,29,11,Apr-19,1,1,0
67,user_67,82,15,0,15,May-19,0,1,1
68,user_68,1525,58,15,43,May-19,0,1,1
69,user_69,761,35,20,15,May-19,0,1,1
70,user_70,5601,203,156,47,Apr-19,1,1,0
71,user_71,1223,21,20,1,Feb-19,3,0,0
72,user_72,513,5,5,0,Jan-18,16,0,0
73,user_73,1523,9,7,2,Apr-19,1,1,0
74,user_74,4047,266,184,82,May-19,0,1,1
75,user_75,3959,60,60,0,Jul-18,10,0,0
76,user_76,3092,49,49,0,Sep-18,8,0,0
78,user_78,1534,12,7,5,Jan-19,4,0,0
79,user_79,17679,372,283,89,May-19,0,1,1
80,user_80,4020,8,5,3,Feb-19,3,0,0
81,user_81,4431,32,30,2,May-19,0,0,1
82,user_82,7135,128,128,0,Sep-18,8,0,0
83,user_83,7852,85,75,10,Apr-19,1,1,0
84,user_84,77310,370,171,199,May-19,0,1,1
85,user_85,30074,295,203,92,May-19,0,1,1
86,user_86,2237,34,31,3,Apr-19,1,1,0
87,user_87,1710,17,17,0,Nov-18,6,0,0
88,user_88,25475,436,246,190,May-19,0,1,1
89,user_89,470,26,19,7,Apr-19,1,1,0
90,user_90,336,32,26,6,May-19,0,1,1
91,user_91,13208,386,19,367,May-19,0,1,1
92,user_92,1770,58,57,1,Mar-19,2,0,0
93,user_93,7192,54,54,0,Aug-18,9,0,0
94,user_94,26349,728,702,26,Feb-19,3,0,0
95,user_95,701,5,5,0,Feb-18,15,0,0
96,user_96,11064,151,108,43,May-19,0,1,1
97,user_97,658,27,24,3,Feb-19,3,0,0
98,user_98,1792,14,14,0,May-18,12,0,0
99,user_99,2074,38,38,0,Nov-18,6,0,0
100,user_100,20778,133,74,59,May-19,0,1,1
101,user_101,455,34,30,4,Apr-19,1,1,0
103,user_103,1621,58,58,0,Jul-18,10,0,0
104,user_104,4961,327,212,115,May-19,0,1,1
105,user_105,54,6,6,0,Apr-18,13,0,0
106,user_106,3760,164,153,11,Mar-19,2,0,0
107,user_107,2525,109,62,47,Apr-19,1,1,0
108,user_108,3904,269,199,70,May-19,0,1,1
109,user_109,25382,499,184,315,May-19,0,1,1
110,user_110,21331,53,42,11,Mar-19,2,0,0
111,user_111,443,30,0,30,May-19,0,1,1
112,user_112,2952,98,37,61,May-19,0,1,1
113,user_113,19561,503,212,291,May-19,0,1,1
114,user_114,10266,188,140,48,May-19,0,1,1
115,user_115,346,10,6,4,Apr-19,1,1,0
116,user_116,6898,266,197,69,May-19,0,1,1
117,user_117,1442,45,33,12,Mar-19,2,0,0
118,user_118,2766,124,88,36,May-19,0,1,1
119,user_119,23335,226,155,71,May-19,0,1,1
120,user_120,42084,2687,1879,808,May-19,0,1,1
121,user_121,1455,97,97,0,Nov-18,6,0,0
122,user_122,28758,923,743,180,May-19,0,1,1
123,user_123,2282,12,12,0,Jan-18,16,0,0
124,user_124,21997,345,193,152,May-19,0,1,1
125,user_125,2352,27,27,0,Mar-18,14,0,0
126,user_126,6418,476,300,176,May-19,0,1,1
127,user_127,6804,90,57,33,May-19,0,1,1
128,user_128,617,25,0,25,Apr-19,1,1,0
129,user_129,2444,20,20,0,Oct-18,7,0,0
130,user_130,281,16,14,2,Apr-19,1,1,0
131,user_131,129372,172,114,58,Apr-19,1,1,0
132,user_132,9823,130,129,1,Mar-19,2,0,0
133,user_133,3817,20,17,3,May-19,0,1,1
134,user_134,1516,14,14,0,Oct-18,7,0,0
135,user_135,2266,24,15,9,May-19,0,0,1
136,user_136,69481,780,542,238,May-19,0,1,1
137,user_137,1084,46,28,18,Apr-19,1,1,0
138,user_138,34,7,7,0,Feb-18,15,0,0
139,user_139,1815,97,75,22,May-19,0,1,1
140,user_140,28677,101,46,55,May-19,0,1,1
141,user_141,7994,34,22,12,May-19,0,1,1
142,user_142,16490,35,33,2,May-19,0,0,1
144,user_144,918,44,44,0,Sep-18,8,0,0
145,user_145,4389,133,84,49,May-19,0,1,1
146,user_146,16544,859,565,294,May-19,0,1,1
147,user_147,2567,10,10,0,Apr-18,13,0,0
148,user_148,3849,37,37,0,Jul-18,10,0,0
150,user_150,9605,134,25,109,Apr-19,1,1,0
153,user_153,3345,50,27,23,Mar-19,2,0,0
154,user_154,17117,114,75,39,May-19,0,0,1
155,user_155,7743,38,38,0,Sep-18,8,0,0
156,user_156,13061,422,311,111,Apr-19,1,1,0
157,user_157,48370,2437,1236,1201,May-19,0,1,1
158,user_158,503,84,62,22,Apr-19,1,1,0
159,user_159,145,8,8,0,Sep-18,8,0,0
160,user_160,5761,120,95,25,May-19,0,0,1
161,user_161,69446,834,385,449,May-19,0,1,1
162,user_162,65134,1979,950,1029,May-19,0,1,1
163,user_163,69672,1644,969,675,May-19,0,1,1
164,user_164,1059,44,35,9,May-19,0,1,1
165,user_165,157,6,6,0,May-18,12,0,0
166,user_166,12082,682,474,208,May-19,0,1,1
167,user_167,81,15,0,15,May-19,0,1,1
168,user_168,12834,342,226,116,May-19,0,1,1
169,user_169,292,7,5,2,Feb-19,3,0,0
170,user_170,215,10,9,1,Jan-19,4,0,0
171,user_171,4530,114,102,12,Mar-19,2,0,0
172,user_172,22839,730,624,106,May-19,0,1,1
173,user_173,17511,144,115,29,May-19,0,1,1
174,user_174,7585,73,38,35,May-19,0,1,1
175,user_175,19729,632,631,1,Feb-19,3,0,0
176,user_176,13666,238,134,104,May-19,0,1,1
177,user_177,1142,13,8,5,Jan-19,4,0,0
178,user_178,2416,48,42,6,May-19,0,0,1
179,user_179,5139,153,123,30,May-19,0,1,1
180,user_180,6962,74,71,3,Feb-19,3,0,0
181,user_181,22718,69,69,0,Nov-18,6,0,0
182,user_182,4609,11,11,0,Mar-18,14,0,0
183,user_183,1192,7,7,0,Feb-18,15,0,0
184,user_184,1300,84,84,0,Jun-18,11,0,0
185,user_185,50921,910,593,317,May-19,0,1,1
186,user_186,290,45,0,45,May-19,0,1,1
187,user_187,16244,428,268,160,May-19,0,1,1
188,user_188,12004,74,60,14,May-19,0,1,1
189,user_189,38654,2762,2050,712,May-19,0,1,1
190,user_190,363,17,17,0,Jul-18,10,0,0
191,user_191,23096,509,427,82,Apr-19,1,1,0
192,user_192,1363,51,50,1,Apr-19,1,1,0
193,user_193,9,2,2,0,Jun-18,11,0,0
194,user_194,279,16,4,12,Apr-19,1,1,0
195,user_195,103335,558,453,105,Apr-19,1,1,0
196,user_196,2559,189,150,39,May-19,0,1,1
197,user_197,8878,34,34,0,Jan-18,16,0,0
198,user_198,43,2,2,0,Jan-18,16,0,0
199,user_199,2520,114,78,36,Apr-19,1,1,0
200,user_200,4603,198,168,30,May-19,0,1,1
201,user_201,31,4,2,2,Apr-19,1,1,0
202,user_202,15267,311,203,108,May-19,0,1,1
203,user_203,61,7,6,1,Feb-19,3,0,0
204,user_204,414,8,4,4,May-19,0,0,1
205,user_205,2710,95,77,18,Apr-19,1,1,0
206,user_206,1392,22,1,21,May-19,0,1,1
207,user_207,12651,218,42,176,May-19,0,1,1
208,user_208,2805,28,28,0,Mar-18,14,0,0
209,user_209,5860,515,345,170,May-19,0,1,1
210,user_210,227,6,6,0,Feb-18,15,0,0
211,user_211,10680,149,141,8,Jan-19,4,0,0
212,user_212,100,2,2,0,Jan-18,16,0,0
213,user_213,6521,182,56,126,May-19,0,1,1
214,user_214,28034,95,92,3,Apr-19,1,1,0
215,user_215,19977,1190,673,517,May-19,0,1,1
216,user_216,597,9,9,0,Feb-18,15,0,0
217,user_217,3867,67,46,21,May-19,0,1,1
218,user_218,1819,37,37,0,Dec-18,5,0,0
219,user_219,22218,567,372,195,May-19,0,1,1
221,user_221,6406,212,128,84,May-19,0,1,1
222,user_222,111661,31,23,8,May-19,0,0,1
223,user_223,18031,485,415,70,Apr-19,1,1,0
224,user_224,23,6,6,0,Oct-18,7,0,0
225,user_225,18284,386,369,17,Apr-19,1,1,0
226,user_226,627,22,22,0,Oct-18,7,0,0
227,user_227,55,7,7,0,Jan-18,16,0,0
228,user_228,54,1,1,0,Jan-18,16,0,0
229,user_229,22,5,5,0,Jun-18,11,0,0
230,user_230,201,16,6,10,Apr-19,1,1,0
231,user_231,965,29,22,7,Jan-19,4,0,0
232,user_232,228,8,4,4,Apr-19,1,1,0
233,user_233,1918,75,74,1,Jan-19,4,0,0
234,user_234,36,7,2,5,Apr-19,1,1,0
235,user_235,2115,95,70,25,May-19,0,1,1
236,user_236,21953,375,269,106,May-19,0,1,1
237,user_237,12946,679,496,183,May-19,0,1,1
238,user_238,2897,66,40,26,May-19,0,1,1
239,user_239,497,6,6,0,Jan-18,16,0,0
240,user_240,20901,287,192,95,Apr-19,1,1,0
241,user_241,5068,140,120,20,May-19,0,1,1
242,user_242,3181,73,48,25,Feb-19,3,0,0
243,user_243,34745,38,30,8,Mar-19,2,0,0
244,user_244,13666,495,444,51,Jan-19,4,0,0
245,user_245,6040,146,146,0,Jul-18,10,0,0
247,user_247,365,18,1,17,Apr-19,1,1,0
248,user_248,95,7,7,0,Jan-18,16,0,0
249,user_249,4021,98,79,19,Apr-19,1,1,0
250,user_250,11383,389,248,141,May-19,0,1,1
251,user_251,30485,233,145,88,May-19,0,1,1
252,user_252,20366,65,34,31,May-19,0,1,1
253,user_253,244,22,22,0,Jun-18,11,0,0
254,user_254,3979,137,89,48,May-19,0,1,1
255,user_255,602,21,21,0,Dec-18,5,0,0
256,user_256,18,3,2,1,Apr-19,1,1,0
257,user_257,16,3,3,0,Jan-18,16,0,0
258,user_258,9,2,0,2,Apr-19,1,1,0
259,user_259,34450,352,290,62,May-19,0,1,1
260,user_260,8132,138,138,0,Oct-18,7,0,0
261,user_261,707,4,4,0,Nov-18,6,0,0
262,user_262,29352,48,48,0,Oct-18,7,0,0
264,user_264,8970,218,187,31,Apr-19,1,1,0
265,user_265,3616,62,42,20,Apr-19,1,1,0
266,user_266,5597,154,109,45,Apr-19,1,1,0
267,user_267,4031,31,30,1,Apr-19,1,1,0
269,user_269,297,13,11,2,Apr-19,1,1,0
270,user_270,100,2,2,0,Jan-18,16,0,0
271,user_271,22585,213,168,45,May-19,0,1,1
272,user_272,1164,15,9,6,Apr-19,1,1,0
273,user_273,36082,1078,757,321,May-19,0,1,1
274,user_274,11641,309,292,17,May-19,0,1,1
275,user_275,4771,55,54,1,Apr-19,1,1,0
276,user_276,86189,322,319,3,Jan-19,4,0,0
277,user_277,37380,282,170,112,May-19,0,1,1
278,user_278,53350,189,147,42,May-19,0,1,1
279,user_279,8214,96,96,0,Apr-18,13,0,0
280,user_280,30001,601,475,126,May-19,0,1,1
281,user_281,3217,42,39,3,Jan-19,4,0,0
282,user_282,54970,1435,1294,141,May-19,0,1,1
283,user_283,113,19,19,0,Feb-18,15,0,0
284,user_284,141,17,17,0,Oct-18,7,0,0
285,user_285,1604,22,1,21,May-19,0,1,1
286,user_286,2132,62,45,17,May-19,0,1,1
287,user_287,9539,155,136,19,Apr-19,1,1,0
288,user_288,2686,95,95,0,Apr-18,13,0,0
289,user_289,5849,131,120,11,May-19,0,1,1
290,user_290,3507,246,131,115,May-19,0,1,1
291,user_291,1252,25,25,0,Aug-18,9,0,0
292,user_292,3498,89,87,2,Feb-19,3,0,0
293,user_293,10201,234,123,111,May-19,0,1,1
294,user_294,18943,1054,462,592,May-19,0,1,1
295,user_295,40,5,5,0,Feb-18,15,0,0
296,user_296,19302,399,206,193,May-19,0,1,1
297,user_297,3244,107,79,28,May-19,0,1,1
298,user_298,11937,77,30,47,May-19,0,1,1
299,user_299,3243,275,188,87,May-19,0,1,1
300,user_300,2236,8,3,5,May-19,0,0,1
302,user_302,2328,104,93,11,Mar-19,2,0,0
303,user_303,20,4,4,0,Apr-18,13,0,0
304,user_304,15327,223,176,47,Mar-19,2,0,0
305,user_305,81325,112,66,46,Apr-19,1,1,0
306,user_306,95,12,12,0,Mar-18,14,0,0
307,user_307,4431,85,34,51,May-19,0,1,1
308,user_308,4035,143,94,49,May-19,0,1,1
309,user_309,313087,637,475,162,May-19,0,1,1
310,user_310,48994,322,140,182,May-19,0,1,1
311,user_311,2939,35,35,0,Mar-18,14,0,0
312,user_312,112,6,4,2,Apr-19,1,1,0
313,user_313,200834,67,63,4,Apr-19,1,1,0
314,user_314,390,7,7,0,Aug-18,9,0,0
315,user_315,2796,22,21,1,Apr-19,1,1,0
316,user_316,7154,173,140,33,May-19,0,1,1
317,user_317,31552,1776,1281,495,May-19,0,1,1
318,user_318,3671,173,155,18,May-19,0,1,1
319,user_319,2374,80,13,67,May-19,0,1,1
320,user_320,4309,64,60,4,Apr-19,1,1,0
321,user_321,422,16,2,14,Apr-19,1,1,0
322,user_322,8212,187,180,7,Apr-19,1,1,0
323,user_323,875,100,16,84,May-19,0,1,1
324,user_324,26493,199,171,28,May-19,0,1,1
325,user_325,555,28,3,25,May-19,0,1,1
326,user_326,2446,32,7,25,May-19,0,1,1
327,user_327,7814,144,121,23,Apr-19,1,1,0
328,user_328,572,14,12,2,Apr-19,1,1,0
329,user_329,297,17,17,0,Jul-18,10,0,0
330,user_330,1843,91,48,43,Apr-19,1,1,0
331,user_331,5865,54,46,8,May-19,0,0,1
332,user_332,3098,42,11,31,May-19,0,1,1
333,user_333,4486,25,18,7,Apr-19,1,1,0
334,user_334,10736,159,109,50,May-19,0,1,1
335,user_335,609,83,56,27,May-19,0,1,1
336,user_336,875,74,33,41,Apr-19,1,1,0
337,user_337,6125,176,176,0,Jul-18,10,0,0
338,user_338,10705,209,52,157,Apr-19,1,1,0
339,user_339,2185,57,57,0,Aug-18,9,0,0
340,user_340,2676,71,42,29,Mar-19,2,0,0
341,user_341,6071,216,180,36,Feb-19,3,0,0
342,user_342,57300,205,154,51,May-19,0,1,1
343,user_343,4358,154,112,42,May-19,0,1,1
344,user_344,889,18,18,0,Jun-18,11,0,0
346,user_346,916,40,22,18,May-19,0,1,1
347,user_347,12594,97,81,16,Feb-19,3,0,0
348,user_348,357,11,11,0,Oct-18,7,0,0
349,user_349,85,2,1,1,Mar-19,2,0,0
350,user_350,97,7,7,0,Mar-18,14,0,0
351,user_351,5412,268,97,171,May-19,0,1,1
352,user_352,5887,174,105,69,May-19,0,1,1
353,user_353,489,5,5,0,Jan-18,16,0,0
354,user_354,40373,997,524,473,May-19,0,1,1
355,user_355,4533,91,58,33,Mar-19,2,0,0
356,user_356,21,4,4,0,Apr-18,13,0,0
357,user_357,11776,65,60,5,Jan-19,4,0,0
358,user_358,1187,45,7,38,Mar-19,2,0,0
359,user_359,5825,85,75,10,May-19,0,0,1
360,user_360,8973,278,275,3,Mar-19,2,0,0
361,user_361,3521,88,80,8,Apr-19,1,1,0
362,user_362,203,23,6,17,May-19,0,1,1
363,user_363,57840,418,289,129,May-19,0,1,1
364,user_364,32187,78,0,78,May-19,0,1,1
366,user_366,10808,487,320,167,Apr-19,1,1,0
368,user_368,9211,89,82,7,Apr-19,1,1,0
369,user_369,2129,45,45,0,Jun-18,11,0,0
370,user_370,448,13,13,0,Sep-18,8,0,0
371,user_371,3171,41,7,34,May-19,0,1,1
372,user_372,3158,99,88,11,May-19,0,1,1
373,user_373,3236,91,41,50,Apr-19,1,1,0
374,user_374,19888,32,23,9,Apr-19,1,1,0
375,user_375,552,8,8,0,Aug-18,9,0,0
376,user_376,1801,73,73,0,Nov-18,6,0,0
377,user_377,452,73,1,72,May-19,0,1,1
378,user_378,59842,46,38,8,Feb-19,3,0,0
379,user_379,7064,96,96,0,Oct-18,7,0,0
380,user_380,152,7,7,0,Apr-18,13,0,0
381,user_381,22988,356,323,33,May-19,0,1,1
382,user_382,1273,63,58,5,Feb-19,3,0,0
383,user_383,1012,19,19,0,Oct-18,7,0,0
384,user_384,137,3,3,0,Jan-18,16,0,0
385,user_385,18896,815,566,249,May-19,0,1,1
386,user_386,1221,27,0,27,May-19,0,1,1
387,user_387,21610,545,376,169,May-19,0,1,1
388,user_388,2,2,2,0,Jan-18,16,0,0
389,user_389,4301,127,117,10,Feb-19,3,0,0
390,user_390,9501,264,223,41,Mar-19,2,0,0
391,user_391,67590,1168,664,504,May-19,0,1,1
392,user_392,725,7,7,0,May-18,12,0,0
393,user_393,1992,43,21,22,Apr-19,1,1,0
394,user_394,43,3,3,0,Jan-18,16,0,0
395,user_395,7173,471,296,175,May-19,0,1,1
396,user_396,473,27,7,20,Apr-19,1,1,0
397,user_397,2570,203,69,134,May-19,0,1,1
398,user_398,27469,267,142,125,May-19,0,1,1
399,user_399,175,23,23,0,Feb-18,15,0,0
400,user_400,4864,17,17,0,May-18,12,0,0
401,user_401,59951,372,285,87,May-19,0,1,1
403,user_403,19538,302,222,80,May-19,0,1,1
404,user_404,39304,1467,760,707,May-19,0,1,1
405,user_405,10746,198,148,50,May-19,0,1,1
406,user_406,3008,285,121,164,May-19,0,1,1
407,user_407,16,3,3,0,Mar-18,14,0,0
408,user_408,3967,158,144,14,May-19,0,0,1
409,user_409,3092,86,86,0,Dec-18,5,0,0
410,user_410,859,21,12,9,Apr-19,1,1,0
411,user_411,684,72,26,46,May-19,0,1,1
412,user_412,69909,617,350,267,May-19,0,1,1
413,user_413,2808,51,51,0,Dec-18,5,0,0
414,user_414,10221,282,138,144,May-19,0,1,1
415,user_415,36787,472,422,50,Apr-19,1,1,0
416,user_416,21,2,2,0,Mar-18,14,0,0
417,user_417,402,22,18,4,Apr-19,1,1,0
418,user_418,11453,237,175,62,Feb-19,3,0,0
419,user_419,15042,428,225,203,May-19,0,1,1
420,user_420,3985,32,10,22,Apr-19,1,1,0
421,user_421,5900,518,350,168,May-19,0,1,1
422,user_422,2452,89,55,34,May-19,0,1,1
423,user_423,35425,270,127,143,May-19,0,1,1
424,user_424,2336,73,73,0,Dec-18,5,0,0
425,user_425,2703,34,34,0,Dec-18,5,0,0
427,user_427,874,38,20,18,May-19,0,1,1
428,user_428,20260,901,487,414,May-19,0,1,1
429,user_429,13776,241,211,30,Apr-19,1,1,0
431,user_431,12895,556,391,165,May-19,0,1,1
432,user_432,1257,47,37,10,Apr-19,1,1,0
433,user_433,1387,147,146,1,Jan-19,4,0,0
434,user_434,86,7,7,0,Oct-18,7,0,0
435,user_435,104,6,6,0,Jan-18,16,0,0
436,user_436,32124,768,449,319,May-19,0,1,1
437,user_437,574,21,4,17,May-19,0,0,1
438,user_438,9012,441,293,148,May-19,0,1,1
439,user_439,1871,18,15,3,Mar-19,2,0,0
440,user_440,22093,868,298,570,May-19,0,1,1
441,user_441,9155,430,336,94,May-19,0,1,1
442,user_442,16458,592,336,256,May-19,0,1,1
443,user_443,10309,77,59,18,Apr-19,1,1,0
444,user_444,365,35,29,6,Apr-19,1,1,0
445,user_445,50,10,10,0,Aug-18,9,0,0
446,user_446,35832,162,128,34,May-19,0,1,1
448,user_448,121594,100,80,20,May-19,0,0,1
449,user_449,1410,38,36,2,May-19,0,1,1
450,user_450,67,1,1,0,Jan-18,16,0,0
451,user_451,75728,379,212,167,May-19,0,1,1
452,user_452,22,4,3,1,Apr-19,1,1,0
453,user_453,45070,414,270,144,May-19,0,1,1
454,user_454,3019,87,69,18,May-19,0,0,1
455,user_455,4071,145,94,51,May-19,0,1,1
456,user_456,16366,484,269,215,May-19,0,1,1
457,user_457,3203,114,60,54,Jan-19,4,0,0
458,user_458,3365,141,105,36,May-19,0,1,1
459,user_459,27,8,8,0,Apr-18,13,0,0
460,user_460,922,8,8,0,Jan-18,16,0,0
461,user_461,2972,50,44,6,Apr-19,1,1,0
462,user_462,2166,6,6,0,Jun-18,11,0,0
463,user_463,2556,180,142,38,Apr-19,1,1,0
464,user_464,94,29,15,14,May-19,0,1,1
465,user_465,14068,471,471,0,Nov-18,6,0,0
466,user_466,4548,108,107,1,Apr-19,1,1,0
467,user_467,5846,168,132,36,Apr-19,1,1,0
468,user_468,953,36,36,0,Oct-18,7,0,0
469,user_469,982,10,10,0,May-18,12,0,0
470,user_470,23080,158,148,10,May-19,0,1,1
471,user_471,31822,564,414,150,May-19,0,1,1
472,user_472,26960,759,426,333,May-19,0,1,1
473,user_473,2083,40,40,0,Apr-18,13,0,0
474,user_474,1251,13,9,4,Apr-19,1,1,0
475,user_475,847,35,32,3,Mar-19,2,0,0
476,user_476,824,16,16,0,Jul-18,10,0,0
478,user_478,3163,7,7,0,Feb-18,15,0,0
479,user_479,9206,167,136,31,May-19,0,1,1
480,user_480,1516,78,51,27,Feb-19,3,0,0
482,user_482,387,3,3,0,Jan-18,16,0,0
483,user_483,12357,174,139,35,Apr-19,1,1,0
484,user_484,65107,222,163,59,May-19,0,1,1
485,user_485,2254,111,55,56,Feb-19,3,0,0
486,user_486,174,7,3,4,Jan-19,4,0,0
487,user_487,565,19,9,10,Jan-19,4,0,0
488,user_488,10767,415,3,412,May-19,0,1,1
489,user_489,5687,70,70,0,Dec-18,5,0,0
490,user_490,24276,460,359,101,May-19,0,1,1
491,user_491,2137,35,21,14,Feb-19,3,0,0
492,user_492,60,3,3,0,Jan-18,16,0,0
493,user_493,4035,194,88,106,May-19,0,1,1
494,user_494,13869,478,345,133,May-19,0,1,1
495,user_495,2602,101,97,4,Apr-19,1,1,0
496,user_496,2057,81,64,17,May-19,0,1,1
497,user_497,8,4,4,0,Jan-18,16,0,0
498,user_498,11595,565,456,109,Apr-19,1,1,0
499,user_499,504,10,10,0,Jan-18,16,0,0
500,user_500,799,57,56,1,Apr-19,1,1,0
501,user_501,3080,93,70,23,Apr-19,1,1,0
502,user_502,13391,80,41,39,Apr-19,1,1,0
503,user_503,7916,619,237,382,May-19,0,1,1
504,user_504,7825,320,196,124,May-19,0,1,1
505,user_505,16649,217,215,2,Apr-19,1,1,0
506,user_506,10765,55,25,30,Apr-19,1,1,0
507,user_507,6071,136,86,50,Apr-19,1,1,0
508,user_508,2818,51,51,0,Jul-18,10,0,0
509,user_509,72186,1553,753,800,May-19,0,1,1
510,user_510,68055,529,327,202,May-19,0,1,1
511,user_511,5590,257,228,29,May-19,0,1,1
512,user_512,1486,58,57,1,Jan-19,4,0,0
513,user_513,4084,56,56,0,Aug-18,9,0,0
514,user_514,14898,210,181,29,Apr-19,1,1,0
515,user_515,103,5,5,0,Apr-18,13,0,0
516,user_516,13972,15,13,2,Mar-19,2,0,0
517,user_517,1207,41,34,7,Apr-19,1,1,0
518,user_518,8242,70,63,7,May-19,0,1,1
519,user_519,14716,360,311,49,May-19,0,1,1
520,user_520,33857,191,140,51,Apr-19,1,1,0
521,user_521,22120,735,208,527,Mar-19,2,0,0
522,user_522,12425,94,75,19,May-19,0,1,1
523,user_523,11310,113,77,36,Apr-19,1,1,0
524,user_524,18833,309,309,0,Aug-18,9,0,0
525,user_525,12165,113,113,0,Nov-18,6,0,0
526,user_526,877,17,0,17,May-19,0,1,1
527,user_527,8171,65,51,14,May-19,0,1,1
528,user_528,4303,100,100,0,Oct-18,7,0,0
529,user_529,1558,10,10,0,Sep-18,8,0,0
530,user_530,2786,69,69,0,Oct-18,7,0,0
531,user_531,304,9,9,0,Nov-18,6,0,0
532,user_532,10162,166,137,29,May-19,0,1,1
533,user_533,4343,82,61,21,May-19,0,0,1
534,user_534,32418,1544,973,571,May-19,0,1,1
535,user_535,378,21,21,0,Nov-18,6,0,0
536,user_536,16978,351,245,106,May-19,0,1,1
537,user_537,22963,239,162,77,May-19,0,1,1
538,user_538,2194,64,56,8,May-19,0,0,1
539,user_539,2430,55,36,19,Apr-19,1,1,0
540,user_540,10222,373,240,133,May-19,0,1,1
541,user_541,830,26,26,0,Oct-18,7,0,0
542,user_542,7971,396,366,30,Apr-19,1,1,0
543,user_543,6856,47,43,4,May-19,0,1,1
544,user_544,1587,87,68,19,Apr-19,1,1,0
545,user_545,208,9,9,0,Dec-18,5,0,0
546,user_546,109243,1367,924,443,May-19,0,1,1
547,user_547,7068,121,92,29,Mar-19,2,0,0
548,user_548,200,13,13,0,Feb-18,15,0,0
549,user_549,3089,45,0,45,May-19,0,1,1
550,user_550,16236,618,580,38,May-19,0,1,1
551,user_551,18012,394,234,160,May-19,0,1,1
552,user_552,484,29,22,7,Jan-19,4,0,0
553,user_553,77,9,9,0,Sep-18,8,0,0
554,user_554,6219,136,133,3,Apr-19,1,1,0
555,user_555,10664,544,418,126,May-19,0,1,1
556,user_556,16521,399,284,115,May-19,0,1,1
557,user_557,16590,105,91,14,Mar-19,2,0,0
558,user_558,14997,272,29,243,May-19,0,1,1
559,user_559,91,7,7,0,Mar-18,14,0,0
560,user_560,1028,58,58,0,Apr-18,13,0,0
561,user_561,290966,724,460,264,May-19,0,1,1
562,user_562,2201,417,334,83,May-19,0,1,1
563,user_563,30032,472,432,40,May-19,0,1,1
564,user_564,817,14,14,0,Jun-18,11,0,0
565,user_565,2985,112,100,12,Apr-19,1,1,0
566,user_566,3064,78,78,0,Dec-18,5,0,0
567,user_567,82409,1233,654,579,May-19,0,1,1
568,user_568,11232,196,131,65,May-19,0,0,1
569,user_569,13155,126,84,42,May-19,0,1,1
570,user_570,64458,667,548,119,May-19,0,1,1
571,user_571,97,8,8,0,May-18,12,0,0
572,user_572,86477,121,121,0,Sep-18,8,0,0
573,user_573,8383,135,126,9,Apr-19,1,1,0
574,user_574,4960,108,107,1,Jan-19,4,0,0
575,user_575,3084,39,16,23,May-19,0,1,1
576,user_576,11572,162,162,0,Jul-18,10,0,0
577,user_577,20266,124,83,41,May-19,0,1,1
578,user_578,41,5,5,0,Jun-18,11,0,0
579,user_579,13778,384,306,78,May-19,0,1,1
580,user_580,22764,597,566,31,May-19,0,1,1
581,user_581,5353,199,169,30,May-19,0,1,1
582,user_582,1097,12,12,0,Jan-18,16,0,0
583,user_583,2185,257,136,121,May-19,0,1,1
584,user_584,10288,148,122,26,Apr-19,1,1,0
586,user_586,23292,243,216,27,May-19,0,0,1
587,user_587,44443,472,334,138,May-19,0,1,1
588,user_588,3330,154,44,110,Apr-19,1,1,0
589,user_589,10560,78,74,4,Mar-19,2,0,0
590,user_590,4266,233,196,37,May-19,0,1,1
591,user_591,3862,52,52,0,Feb-18,15,0,0
592,user_592,9742,505,290,215,May-19,0,1,1
593,user_593,3690,71,71,0,Sep-18,8,0,0
594,user_594,47428,1870,1494,376,May-19,0,1,1
595,user_595,16617,190,131,59,May-19,0,1,1
596,user_596,79,9,9,0,Nov-18,6,0,0
597,user_597,15143,243,235,8,Apr-19,1,1,0
598,user_598,9603,175,111,64,May-19,0,1,1
599,user_599,1849,94,41,53,Apr-19,1,1,0
600,user_600,2130,81,72,9,May-19,0,0,1
601,user_601,321,47,22,25,May-19,0,1,1
602,user_602,11789,334,262,72,May-19,0,1,1
603,user_603,211,14,14,0,Jul-18,10,0,0
604,user_604,281,33,10,23,May-19,0,1,1
605,user_605,940,22,22,0,Sep-18,8,0,0
606,user_606,9256,377,368,9,Feb-19,3,0,0
607,user_607,742,8,8,0,Jan-18,16,0,0
608,user_608,5247,116,91,25,Apr-19,1,1,0
609,user_609,86,2,2,0,Feb-18,15,0,0
610,user_610,39002,1011,695,316,May-19,0,1,1
612,user_612,20066,248,218,30,May-19,0,1,1
613,user_613,9946,209,117,92,May-19,0,1,1
614,user_614,24557,379,313,66,Apr-19,1,1,0
615,user_615,6050,171,118,53,May-19,0,1,1
616,user_616,26482,255,193,62,Apr-19,1,1,0
617,user_617,4256,36,36,0,Jun-18,11,0,0
618,user_618,8120,299,145,154,May-19,0,1,1
619,user_619,22,4,0,4,May-19,0,1,1
620,user_620,4553,109,20,89,Apr-19,1,1,0
621,user_621,1115,15,12,3,Jan-19,4,0,0
622,user_622,4493,184,151,33,Apr-19,1,1,0
623,user_623,8795,152,66,86,May-19,0,1,1
624,user_624,4501,275,152,123,May-19,0,1,1
625,user_625,1306,41,38,3,Feb-19,3,0,0
626,user_626,136,10,10,0,Apr-18,13,0,0
627,user_627,975,40,13,27,Apr-19,1,1,0
628,user_628,799,43,33,10,Apr-19,1,1,0
629,user_629,11946,242,107,135,May-19,0,1,1
630,user_630,66222,1508,715,793,May-19,0,1,1
631,user_631,9341,222,41,181,May-19,0,1,1
632,user_632,1925,47,35,12,Apr-19,1,1,0
634,user_634,2224,65,52,13,Apr-19,1,1,0
635,user_635,70,1,1,0,Jan-18,16,0,0
636,user_636,1122,76,65,11,May-19,0,1,1
637,user_637,4855,187,152,35,Apr-19,1,1,0
638,user_638,29952,124,97,27,May-19,0,1,1
639,user_639,16470,582,196,386,May-19,0,1,1
640,user_640,61990,713,494,219,May-19,0,1,1
641,user_641,3924,105,95,10,May-19,0,1,1
642,user_642,1199,15,15,0,Jul-18,10,0,0
643,user_643,9018,364,154,210,May-19,0,1,1
644,user_644,2089,42,0,42,Apr-19,1,1,0
645,user_645,18,3,0,3,Apr-19,1,1,0
646,user_646,42040,1644,1102,542,May-19,0,1,1
647,user_647,2089,57,51,6,Mar-19,2,0,0
648,user_648,8310,93,41,52,Apr-19,1,1,0
649,user_649,9874,211,122,89,May-19,0,1,1
650,user_650,14,8,8,0,Sep-18,8,0,0
651,user_651,3000,308,147,161,May-19,0,1,1
652,user_652,218,32,19,13,Apr-19,1,1,0
653,user_653,11586,41,41,0,Oct-18,7,0,0
654,user_654,1920,11,11,0,Apr-18,13,0,0
655,user_655,18,4,4,0,Apr-18,13,0,0
656,user_656,59,8,8,0,Feb-18,15,0,0
657,user_657,1261,67,5,62,May-19,0,1,1
658,user_658,247,16,14,2,May-19,0,1,1
659,user_659,113,6,6,0,Feb-18,15,0,0
660,user_660,1764,23,11,12,Jan-19,4,0,0
661,user_661,664,28,21,7,Mar-19,2,0,0
662,user_662,730,25,25,0,Jun-18,11,0,0
664,user_664,1881,16,16,0,Feb-18,15,0,0
665,user_665,561,11,7,4,Apr-19,1,1,0
666,user_666,511,7,7,0,Feb-18,15,0,0
667,user_667,455,17,17,0,Jun-18,11,0,0
668,user_668,22396,55,27,28,Apr-19,1,1,0
669,user_669,5164,119,104,15,May-19,0,1,1
670,user_670,9023,73,52,21,Mar-19,2,0,0
671,user_671,269,9,9,0,Jan-18,16,0,0
672,user_672,14273,223,146,77,May-19,0,1,1
673,user_673,2064,10,10,0,Feb-18,15,0,0
674,user_674,149,4,3,1,Feb-19,3,0,0
675,user_675,12468,287,274,13,Mar-19,2,0,0
676,user_676,2290,9,9,0,Nov-18,6,0,0
677,user_677,94,16,15,1,Apr-19,1,1,0
678,user_678,4995,97,97,0,Dec-18,5,0,0
679,user_679,4801,119,82,37,Apr-19,1,1,0
680,user_680,13491,123,38,85,May-19,0,1,1
681,user_681,57080,549,370,179,May-19,0,1,1
682,user_682,306,5,5,0,Jul-18,10,0,0
683,user_683,300,39,13,26,Mar-19,2,0,0
684,user_684,26383,968,872,96,May-19,0,1,1
685,user_685,17380,481,413,68,May-19,0,1,1
686,user_686,242594,96,94,2,Mar-19,2,0,0
687,user_687,650,14,14,0,Nov-18,6,0,0
688,user_688,4321,353,340,13,May-19,0,1,1
689,user_689,1836,49,23,26,Mar-19,2,0,0
690,user_690,33541,220,179,41,May-19,0,0,1
691,user_691,40312,330,150,180,May-19,0,1,1
692,user_692,389,16,11,5,Apr-19,1,1,0
693,user_693,69227,1234,715,519,May-19,0,1,1
694,user_694,7443,52,46,6,Feb-19,3,0,0
695,user_695,1822,22,8,14,Apr-19,1,1,0
696,user_696,2840,93,92,1,Jan-19,4,0,0
697,user_697,19,2,2,0,Jan-18,16,0,0
698,user_698,26207,56,19,37,May-19,0,1,1
699,user_699,183,13,13,0,Aug-18,9,0,0
700,user_700,2190,35,35,0,Nov-18,6,0,0
701,user_701,15012,602,390,212,May-19,0,1,1
702,user_702,34603,301,123,178,May-19,0,1,1
703,user_703,8076,146,93,53,May-19,0,0,1
704,user_704,41,3,3,0,Jan-18,16,0,0
705,user_705,14418,43,43,0,Jun-18,11,0,0
706,user_706,3956,51,49,2,Apr-19,1,1,0
707,user_707,1647,35,35,0,Jun-18,11,0,0
708,user_708,299,18,18,0,Oct-18,7,0,0
709,user_709,27833,63,46,17,Apr-19,1,1,0
710,user_710,72412,1538,1330,208,May-19,0,1,1
711,user_711,10,1,0,1,Feb-19,3,0,0
712,user_712,5624,62,61,1,Jan-19,4,0,0
713,user_713,27191,384,240,144,May-19,0,1,1
715,user_715,8462,284,2,282,May-19,0,1,1
716,user_716,12307,153,128,25,Apr-19,1,1,0
717,user_717,10362,110,77,33,Apr-19,1,1,0
718,user_718,178,6,6,0,Jan-18,16,0,0
719,user_719,3652,185,122,63,May-19,0,1,1
720,user_720,7004,143,84,59,May-19,0,1,1
721,user_721,35813,589,536,53,May-19,0,1,1
722,user_722,10721,20,20,0,Feb-18,15,0,0
724,user_724,10273,291,218,73,May-19,0,1,1
725,user_725,2433,19,17,2,Apr-19,1,1,0
726,user_726,8518,175,109,66,Apr-19,1,1,0
727,user_727,51,6,6,0,Jan-18,16,0,0
728,user_728,231,23,17,6,May-19,0,1,1
729,user_729,19458,215,32,183,May-19,0,1,1
730,user_730,7894,161,161,0,May-18,12,0,0
731,user_731,12250,546,430,116,May-19,0,1,1
732,user_732,9,2,2,0,Mar-18,14,0,0
733,user_733,27,5,5,0,Dec-18,5,0,0
734,user_734,22823,84,59,25,Apr-19,1,1,0
735,user_735,993,6,6,0,Jan-18,16,0,0
736,user_736,24944,530,359,171,Apr-19,1,1,0
737,user_737,25560,530,334,196,May-19,0,1,1
738,user_738,6069,121,56,65,May-19,0,1,1
739,user_739,404,26,25,1,Feb-19,3,0,0
740,user_740,253,9,9,0,Jun-18,11,0,0
741,user_741,13995,313,266,47,Mar-19,2,0,0
742,user_742,12401,189,171,18,May-19,0,1,1
743,user_743,676,126,89,37,May-19,0,1,1
745,user_745,1675,36,36,0,Dec-18,5,0,0
746,user_746,3541,151,141,10,May-19,0,0,1
747,user_747,4761,140,72,68,May-19,0,1,1
748,user_748,51,4,4,0,Oct-18,7,0,0
749,user_749,11917,413,294,119,May-19,0,1,1
750,user_750,4446,71,68,3,Jan-19,4,0,0
751,user_751,1860,37,37,0,Oct-18,7,0,0
752,user_752,6635,93,71,22,Jan-19,4,0,0
754,user_754,53832,249,27,222,May-19,0,1,1
755,user_755,916,33,29,4,Apr-19,1,1,0
756,user_756,11060,237,184,53,May-19,0,1,1
757,user_757,4191,74,69,5,Apr-19,1,1,0
758,user_758,1979,198,150,48,Apr-19,1,1,0
759,user_759,9139,324,165,159,May-19,0,1,1
760,user_760,43134,949,876,73,Apr-19,1,1,0
761,user_761,857,39,25,14,Apr-19,1,1,0
762,user_762,72009,1168,506,662,May-19,0,1,1
763,user_763,157,6,3,3,Jan-19,4,0,0
764,user_764,52478,553,342,211,May-19,0,1,1
765,user_765,1301,48,48,0,Dec-18,5,0,0
766,user_766,10245,243,227,16,May-19,0,1,1
767,user_767,3009,502,252,250,May-19,0,1,1
768,user_768,2829,11,11,0,Jan-18,16,0,0
769,user_769,32,9,0,9,Apr-19,1,1,0
770,user_770,3645,18,18,0,Feb-18,15,0,0
771,user_771,2114,58,56,2,Apr-19,1,1,0
772,user_772,5888,149,113,36,May-19,0,1,1
773,user_773,6256,143,100,43,May-19,0,1,1
774,user_774,33182,1041,703,338,May-19,0,1,1
775,user_775,949,16,16,0,Aug-18,9,0,0
776,user_776,162716,1557,1008,549,May-19,0,1,1
777,user_777,13345,521,346,175,May-19,0,1,1
778,user_778,6935,131,80,51,Apr-19,1,1,0
779,user_779,10057,128,101,27,May-19,0,1,1
780,user_780,2363,29,29,0,Dec-18,5,0,0
781,user_781,7344,136,135,1,Jan-19,4,0,0
782,user_782,2746,72,69,3,Apr-19,1,1,0
783,user_783,1983,40,40,0,Jul-18,10,0,0
784,user_784,1612,62,42,20,Apr-19,1,1,0
785,user_785,697,24,24,0,May-18,12,0,0
786,user_786,2330,112,98,14,Mar-19,2,0,0
787,user_787,23229,15,10,5,Jan-19,4,0,0
788,user_788,48556,304,169,135,May-19,0,1,1
789,user_789,511,4,3,1,Feb-19,3,0,0
790,user_790,24913,137,128,9,May-19,0,1,1
791,user_791,534,6,5,1,Mar-19,2,0,0
793,user_793,94493,298,212,86,Apr-19,1,1,0
794,user_794,4771,111,55,56,May-19,0,1,1
795,user_795,3848,51,48,3,May-19,0,0,1
796,user_796,40123,528,417,111,May-19,0,1,1
797,user_797,6475,572,370,202,May-19,0,1,1
798,user_798,17681,245,70,175,May-19,0,1,1
799,user_799,5252,118,100,18,May-19,0,1,1
800,user_800,8338,421,354,67,May-19,0,1,1
801,user_801,14524,593,324,269,May-19,0,1,1
802,user_802,304,10,10,0,Feb-18,15,0,0
803,user_803,7641,224,113,111,May-19,0,1,1
804,user_804,15435,896,570,326,May-19,0,1,1
805,user_805,2423,78,62,16,Mar-19,2,0,0
806,user_806,608,52,14,38,May-19,0,1,1
807,user_807,15625,157,122,35,May-19,0,1,1
808,user_808,1526,26,26,0,May-18,12,0,0
809,user_809,27355,1219,719,500,May-19,0,1,1
810,user_810,6573,395,360,35,Apr-19,1,1,0
811,user_811,1255,26,6,20,May-19,0,1,1
812,user_812,9559,80,68,12,Feb-19,3,0,0
813,user_813,19964,1026,605,421,May-19,0,1,1
815,user_815,10549,39,33,6,Feb-19,3,0,0
816,user_816,55,4,3,1,Jan-19,4,0,0
817,user_817,59266,933,575,358,May-19,0,1,1
818,user_818,577491,574,488,86,May-19,0,1,1
819,user_819,11566,94,90,4,Jan-19,4,0,0
820,user_820,45766,78,78,0,Dec-18,5,0,0
821,user_821,2204,66,24,42,Apr-19,1,1,0
822,user_822,7520,19,19,0,Oct-18,7,0,0
823,user_823,242,29,6,23,May-19,0,1,1
824,user_824,28201,160,137,23,Apr-19,1,1,0
825,user_825,57938,373,281,92,May-19,0,1,1
826,user_826,2128,21,21,0,Jul-18,10,0,0
827,user_827,8585,369,314,55,May-19,0,1,1
828,user_828,3746,55,40,15,Mar-19,2,0,0
829,user_829,166,22,22,0,Oct-18,7,0,0
830,user_830,9,2,2,0,Mar-18,14,0,0
831,user_831,10108,420,420,0,Aug-18,9,0,0
832,user_832,20494,64,64,0,Sep-18,8,0,0
833,user_833,68271,1641,985,656,May-19,0,1,1
834,user_834,171,5,4,1,Feb-19,3,0,0
835,user_835,6875,200,174,26,May-19,0,1,1
836,user_836,6909,836,776,60,May-19,0,1,1
837,user_837,23629,614,554,60,May-19,0,1,1
838,user_838,53003,707,375,332,May-19,0,1,1
839,user_839,3512,67,37,30,Feb-19,3,0,0
840,user_840,22072,594,480,114,May-19,0,1,1
841,user_841,102827,59,59,0,Jul-18,10,0,0
842,user_842,3934,130,60,70,Apr-19,1,1,0
843,user_843,18908,1005,830,175,May-19,0,1,1
844,user_844,5891,29,29,0,Sep-18,8,0,0
845,user_845,24891,197,100,97,May-19,0,1,1
846,user_846,2722,139,60,79,May-19,0,1,1
847,user_847,1482,39,38,1,Mar-19,2,0,0
848,user_848,13145,135,135,0,Sep-18,8,0,0
849,user_849,139,5,5,0,Feb-18,15,0,0
850,user_850,2671,74,50,24,May-19,0,1,1
851,user_851,1015,12,11,1,Apr-19,1,1,0
852,user_852,11684,196,151,45,May-19,0,1,1
853,user_853,12681,153,108,45,May-19,0,1,1
854,user_854,47,8,8,0,Jan-18,16,0,0
855,user_855,1646,50,0,50,Apr-19,1,1,0
856,user_856,92398,442,283,159,May-19,0,1,1
857,user_857,16456,162,152,10,Apr-19,1,1,0
858,user_858,946,34,0,34,Feb-19,3,0,0
859,user_859,8358,111,81,30,May-19,0,1,1
860,user_860,12922,83,82,1,Feb-19,3,0,0
861,user_861,509,11,4,7,May-19,0,0,1
862,user_862,10330,458,439,19,Apr-19,1,1,0
863,user_863,6306,345,223,122,May-19,0,1,1
864,user_864,7381,308,193,115,Mar-19,2,0,0
865,user_865,16385,128,115,13,May-19,0,0,1
867,user_867,3011,22,21,1,Feb-19,3,0,0
868,user_868,1016,61,5,56,May-19,0,1,1
869,user_869,6116,55,2,53,May-19,0,1,1
870,user_870,2517,100,100,0,Sep-18,8,0,0
871,user_871,41,6,6,0,Jun-18,11,0,0
872,user_872,2750,54,14,40,Apr-19,1,1,0
873,user_873,41,7,7,0,Feb-18,15,0,0
874,user_874,426,8,0,8,May-19,0,1,1
875,user_875,56191,441,372,69,May-19,0,1,1
876,user_876,8053,34,33,1,Jan-19,4,0,0
877,user_877,18336,351,60,291,May-19,0,1,1
879,user_879,21,4,0,4,May-19,0,0,1
880,user_880,190,6,6,0,Jan-18,16,0,0
881,user_881,9267,94,94,0,Aug-18,9,0,0
882,user_882,8062,87,86,1,Apr-19,1,1,0
883,user_883,24899,1432,918,514,May-19,0,1,1
884,user_884,492,16,13,3,Jan-19,4,0,0
885,user_885,254,6,5,1,Apr-19,1,1,0
886,user_886,3150,18,15,3,Mar-19,2,0,0
887,user_887,6429,54,33,21,Feb-19,3,0,0
888,user_888,3838,141,122,19,May-19,0,0,1
889,user_889,6440,125,117,8,Feb-19,3,0,0
890,user_890,6537,184,79,105,May-19,0,0,1
891,user_891,26348,894,738,156,Apr-19,1,1,0
892,user_892,34991,1450,813,637,May-19,0,1,1
893,user_893,2301,35,35,0,May-18,12,0,0
894,user_894,146,14,14,0,Jul-18,10,0,0
895,user_895,10833,148,108,40,May-19,0,0,1
896,user_896,27,5,5,0,Feb-18,15,0,0
897,user_897,5770,108,79,29,Mar-19,2,0,0
898,user_898,6507,261,242,19,May-19,0,1,1
899,user_899,10,4,4,0,Apr-18,13,0,0
900,user_900,51055,21,21,0,Apr-18,13,0,0
901,user_901,1068,59,55,4,Jan-19,4,0,0
902,user_902,97138,294,165,129,May-19,0,1,1
903,user_903,50,1,1,0,Jan-18,16,0,0
904,user_904,2495,21,1,20,May-19,0,1,1
905,user_905,12041,211,132,79,May-19,0,1,1
906,user_906,4998,75,1,74,May-19,0,1,1
907,user_907,1772,81,60,21,May-19,0,1,1
908,user_908,19,4,2,2,Jan-19,4,0,0
909,user_909,56655,1026,425,601,May-19,0,1,1
910,user_910,2827,103,31,72,Apr-19,1,1,0
911,user_911,2455,249,239,10,Apr-19,1,1,0
912,user_912,620,13,12,1,Mar-19,2,0,0
913,user_913,2812,58,52,6,Apr-19,1,1,0
914,user_914,1354,7,7,0,Sep-18,8,0,0
915,user_915,47055,729,508,221,May-19,0,1,1
917,user_917,7043,209,202,7,Apr-19,1,1,0
918,user_918,20427,528,470,58,Apr-19,1,1,0
919,user_919,19959,50,22,28,May-19,0,1,1
920,user_920,6465,119,92,27,May-19,0,1,1
921,user_921,1297,89,67,22,Apr-19,1,1,0
922,user_922,3763,88,81,7,May-19,0,1,1
923,user_923,3832,84,81,3,Jan-19,4,0,0
924,user_924,1412,16,16,0,Feb-18,15,0,0
925,user_925,3945,164,150,14,Apr-19,1,1,0
926,user_926,534,7,7,0,Jun-18,11,0,0
927,user_927,1416,57,57,0,Dec-18,5,0,0
928,user_928,986,29,11,18,Apr-19,1,1,0
929,user_929,2378,145,102,43,May-19,0,1,1
930,user_930,953,42,39,3,May-19,0,1,1
931,user_931,54,2,1,1,Jan-19,4,0,0
932,user_932,11224,310,289,21,Feb-19,3,0,0
933,user_933,1755,246,221,25,Apr-19,1,1,0
934,user_934,390,2,2,0,Sep-18,8,0,0
935,user_935,1544,30,22,8,Apr-19,1,1,0
936,user_936,3052,8,8,0,Mar-18,14,0,0
937,user_937,126,16,16,0,Jun-18,11,0,0
938,user_938,616,30,30,0,Aug-18,9,0,0
939,user_939,2013,9,9,0,May-18,12,0,0
940,user_940,1788,19,0,19,Apr-19,1,1,0
941,user_941,36584,514,265,249,Apr-19,1,1,0
942,user_942,1349,67,67,0,Jun-18,11,0,0
943,user_943,3291,25,24,1,Feb-19,3,0,0
944,user_944,15732,206,115,91,May-19,0,1,1
945,user_945,2199,181,137,44,May-19,0,1,1
946,user_946,8083,181,181,0,May-18,12,0,0
947,user_947,7343,742,539,203,May-19,0,1,1
948,user_948,8240,240,168,72,May-19,0,1,1
950,user_950,3908,42,28,14,May-19,0,0,1
951,user_951,168,18,18,0,Apr-18,13,0,0
952,user_952,5530,202,140,62,Apr-19,1,1,0
953,user_953,23206,467,341,126,May-19,0,1,1
954,user_954,538,18,8,10,May-19,0,1,1
955,user_955,64,4,4,0,Jul-18,10,0,0
956,user_956,178,13,12,1,Mar-19,2,0,0
957,user_957,9,2,2,0,Mar-18,14,0,0
958,user_958,8132,174,116,58,Mar-19,2,0,0
959,user_959,97,3,2,1,May-19,0,0,1
960,user_960,2721,96,89,7,May-19,0,1,1
961,user_961,686,60,49,11,Mar-19,2,0,0
962,user_962,67035,1262,648,614,May-19,0,1,1
963,user_963,22229,560,426,134,May-19,0,1,1
964,user_964,50426,339,273,66,May-19,0,1,1
965,user_965,13566,112,112,0,Oct-18,7,0,0
966,user_966,27,4,3,1,May-19,0,0,1
967,user_967,58031,1309,882,427,May-19,0,1,1
968,user_968,4529,80,57,23,Mar-19,2,0,0
969,user_969,41235,651,362,289,May-19,0,1,1
970,user_970,710,16,10,6,Apr-19,1,1,0
971,user_971,1221,10,10,0,Jan-18,16,0,0
972,user_972,1050,32,24,8,Apr-19,1,1,0
973,user_973,5349,95,59,36,May-19,0,1,1
974,user_974,1360,64,58,6,Mar-19,2,0,0
975,user_975,3045,22,21,1,Mar-19,2,0,0
976,user_976,68578,174,74,100,May-19,0,1,1
977,user_977,1278,72,27,45,Apr-19,1,1,0
978,user_978,5818,290,258,32,Apr-19,1,1,0
979,user_979,38,2,2,0,Jan-18,16,0,0
980,user_980,222827,209,145,64,May-19,0,1,1
981,user_981,5145,226,120,106,May-19,0,1,1
982,user_982,4574,115,85,30,Mar-19,2,0,0
983,user_983,36,7,7,0,Jan-18,16,0,0
984,user_984,10726,154,153,1,Mar-19,2,0,0
985,user_985,22535,975,714,261,May-19,0,1,1
986,user_986,37,6,6,0,Feb-18,15,0,0
987,user_987,43,1,1,0,Feb-18,15,0,0
988,user_988,551,183,68,115,May-19,0,1,1
989,user_989,209,3,3,0,Aug-18,9,0,0
990,user_990,1060,11,11,0,Jul-18,10,0,0
991,user_991,18077,755,65,690,May-19,0,1,1
992,user_992,16375,773,551,222,May-19,0,1,1
993,user_993,43,14,14,0,Aug-18,9,0,0
994,user_994,2603,137,77,60,May-19,0,1,1
995,user_995,51343,221,146,75,May-19,0,1,1
996,user_996,90,3,2,1,Feb-19,3,0,0
997,user_997,3270,96,96,0,Aug-18,9,0,0
998,user_998,415,7,7,0,Sep-18,8,0,0
999,user_999,13790,237,147,90,May-19,0,1,1
1000,user_1000,21565,39,39,0,Jun-18,11,0,0
1001,user_1001,1341,34,34,0,Jun-18,11,0,0
1002,user_1002,28939,254,133,121,Mar-19,2,0,0
1003,user_1003,17371,103,72,31,May-19,0,1,1
1004,user_1004,25,5,5,0,Jan-18,16,0,0
1005,user_1005,17847,268,227,41,May-19,0,1,1
1006,user_1006,6220,9,0,9,Apr-19,1,1,0
1007,user_1007,1820,47,28,19,May-19,0,1,1
1008,user_1008,28,6,6,0,Nov-18,6,0,0
1009,user_1009,34958,773,575,198,May-19,0,1,1
1010,user_1010,23530,802,416,386,May-19,0,1,1
1011,user_1011,1220,40,40,0,Apr-18,13,0,0
1012,user_1012,21577,593,426,167,May-19,0,1,1
1013,user_1013,1855,12,12,0,Jul-18,10,0,0
1014,user_1014,24600,142,91,51,May-19,0,1,1
1015,user_1015,5917,71,67,4,Feb-19,3,0,0
1016,user_1016,1341,74,74,0,Sep-18,8,0,0
1017,user_1017,43719,575,140,435,May-19,0,1,1
1018,user_1018,6026,214,119,95,May-19,0,1,1
1019,user_1019,7386,281,151,130,May-19,0,1,1
1020,user_1020,6037,31,31,0,Aug-18,9,0,0
1021,user_1021,12394,427,378,49,Apr-19,1,1,0
1022,user_1022,10,1,1,0,Jul-18,10,0,0
1023,user_1023,6948,44,9,35,Apr-19,1,1,0
1024,user_1024,95672,166,2,164,May-19,0,1,1
1027,user_1027,326,7,2,5,Mar-19,2,0,0
1028,user_1028,7124,182,149,33,May-19,0,1,1
1029,user_1029,4432,67,36,31,May-19,0,1,1
1030,user_1030,37,6,5,1,Mar-19,2,0,0
1031,user_1031,8483,317,317,0,Sep-18,8,0,0
1032,user_1032,1442,50,50,0,May-18,12,0,0
1033,user_1033,3027,46,26,20,May-19,0,0,1
1034,user_1034,25,3,2,1,Feb-19,3,0,0
1035,user_1035,219526,710,482,228,May-19,0,1,1
1036,user_1036,714,14,14,0,May-18,12,0,0
1037,user_1037,1537,152,4,148,May-19,0,1,1
1038,user_1038,9002,142,6,136,May-19,0,1,1
1039,user_1039,888,27,27,0,Oct-18,7,0,0
1040,user_1040,965,29,26,3,Jan-19,4,0,0
1041,user_1041,62,9,9,0,Aug-18,9,0,0
1042,user_1042,1004,9,6,3,Apr-19,1,1,0
1043,user_1043,2015,30,21,9,Apr-19,1,1,0
1044,user_1044,14162,146,55,91,May-19,0,1,1
1045,user_1045,2466,222,184,38,May-19,0,1,1
1046,user_1046,33582,49,40,9,Apr-19,1,1,0
1047,user_1047,20034,685,418,267,May-19,0,1,1
1048,user_1048,19627,655,237,418,May-19,0,1,1
1049,user_1049,4,2,2,0,Apr-18,13,0,0
1050,user_1050,8314,131,47,84,May-19,0,1,1
1051,user_1051,15830,391,259,132,May-19,0,1,1
1052,user_1052,524,13,10,3,Mar-19,2,0,0
1053,user_1053,53958,1201,497,704,May-19,0,1,1
1054,user_1054,2566,187,105,82,May-19,0,1,1
1055,user_1055,44727,589,499,90,May-19,0,1,1
1056,user_1056,5809,181,135,46,May-19,0,1,1
1057,user_1057,73224,417,293,124,May-19,0,1,1
1058,user_1058,7268,109,84,25,May-19,0,1,1
1059,user_1059,461,9,9,0,Mar-18,14,0,0
1060,user_1060,16340,249,192,57,May-19,0,1,1
1061,user_1061,39359,164,164,0,Dec-18,5,0,0
1062,user_1062,765,95,49,46,May-19,0,1,1
1063,user_1063,18946,176,147,29,May-19,0,1,1
1064,user_1064,29524,1007,339,668,May-19,0,1,1
1065,user_1065,208,6,4,2,Jan-19,4,0,0
1066,user_1066,162064,660,382,278,May-19,0,1,1
1067,user_1067,10229,177,150,27,Mar-19,2,0,0
1068,user_1068,79424,372,228,144,May-19,0,1,1
1069,user_1069,21460,1080,761,319,May-19,0,1,1
1070,user_1070,39,3,2,1,Apr-19,1,1,0
1071,user_1071,781,6,6,0,Feb-18,15,0,0
1072,user_1072,147,8,5,3,Apr-19,1,1,0
1074,user_1074,2030,114,114,0,Nov-18,6,0,0
1075,user_1075,27053,12,12,0,Jun-18,11,0,0
1076,user_1076,38,8,8,0,May-18,12,0,0
1077,user_1077,23859,947,580,367,May-19,0,1,1
1078,user_1078,1120,17,6,11,Mar-19,2,0,0
1079,user_1079,4585,12,12,0,Jan-18,16,0,0
1080,user_1080,24416,552,440,112,May-19,0,1,1
1081,user_1081,11476,119,92,27,Apr-19,1,1,0
1082,user_1082,21160,123,123,0,Jun-18,11,0,0
1083,user_1083,147186,733,437,296,May-19,0,1,1
1084,user_1084,85,5,5,0,Nov-18,6,0,0
1085,user_1085,1593,18,18,0,Mar-18,14,0,0
1086,user_1086,1231,65,41,24,May-19,0,1,1
1087,user_1087,11,2,2,0,Mar-18,14,0,0
1088,user_1088,2938,129,110,19,Mar-19,2,0,0
1089,user_1089,10025,1006,652,354,May-19,0,1,1
1090,user_1090,1143,47,10,37,Apr-19,1,1,0
1091,user_1091,45396,950,573,377,May-19,0,1,1
1092,user_1092,13861,60,47,13,May-19,0,1,1
1093,user_1093,9036,152,151,1,Mar-19,2,0,0
1094,user_1094,32874,761,688,73,May-19,0,1,1
1096,user_1096,1709,59,17,42,Apr-19,1,1,0
1097,user_1097,4124,109,83,26,May-19,0,1,1
1098,user_1098,172,7,7,0,Feb-18,15,0,0
1099,user_1099,54,1,1,0,Jan-18,16,0,0
1100,user_1100,1534,132,105,27,Apr-19,1,1,0
1101,user_1101,4766,46,12,34,May-19,0,1,1
1102,user_1102,25530,623,533,90,May-19,0,0,1
1103,user_1103,16,3,3,0,Feb-18,15,0,0
1104,user_1104,121212,1002,411,591,May-19,0,1,1
1105,user_1105,39477,620,412,208,May-19,0,1,1
1106,user_1106,109133,89,74,15,May-19,0,1,1
1107,user_1107,9727,407,290,117,May-19,0,1,1
1108,user_1108,100,3,3,0,Jan-18,16,0,0
1109,user_1109,5116,171,140,31,Jan-19,4,0,0
1110,user_1110,11118,426,133,293,May-19,0,1,1
1111,user_1111,16,3,3,0,Feb-18,15,0,0
1112,user_1112,2004,68,33,35,May-19,0,1,1
1113,user_1113,4017,49,48,1,Jan-19,4,0,0
1115,user_1115,38203,776,553,223,May-19,0,1,1
1116,user_1116,22501,128,116,12,May-19,0,1,1
1117,user_1117,4942,181,148,33,May-19,0,1,1
1118,user_1118,5272,93,73,20,Apr-19,1,1,0
1119,user_1119,5113,239,159,80,May-19,0,1,1
1120,user_1120,1813,10,4,6,May-19,0,0,1
1121,user_1121,1458,68,57,11,May-19,0,1,1
1122,user_1122,345,16,16,0,Jun-18,11,0,0
1123,user_1123,3478,138,134,4,May-19,0,0,1
1124,user_1124,27934,456,341,115,May-19,0,1,1
1125,user_1125,86,3,3,0,Jan-18,16,0,0
1126,user_1126,11057,47,47,0,Jun-18,11,0,0
1127,user_1127,5713,146,130,16,Apr-19,1,1,0
1128,user_1128,33473,148,47,101,May-19,0,1,1
1129,user_1129,5048,90,45,45,May-19,0,1,1
1130,user_1130,1728,9,9,0,Jan-18,16,0,0
1131,user_1131,61150,751,600,151,Apr-19,1,1,0
1132,user_1132,4767,146,131,15,Apr-19,1,1,0
1133,user_1133,22,4,4,0,Jan-18,16,0,0
1134,user_1134,1302,27,27,0,Dec-18,5,0,0
1135,user_1135,10271,130,98,32,May-19,0,1,1
1136,user_1136,6779,126,124,2,Jan-19,4,0,0
1137,user_1137,17842,307,239,68,May-19,0,1,1
1138,user_1138,43,7,7,0,Mar-18,14,0,0
1139,user_1139,8116,147,147,0,Nov-18,6,0,0
1140,user_1140,2641,101,69,32,May-19,0,1,1
1141,user_1141,1985,10,10,0,Feb-18,15,0,0
1142,user_1142,13081,257,228,29,Apr-19,1,1,0
1143,user_1143,1275,22,10,12,Apr-19,1,1,0
1144,user_1144,5259,60,60,0,Sep-18,8,0,0
1145,user_1145,6356,288,186,102,May-19,0,1,1
1146,user_1146,977,4,4,0,Oct-18,7,0,0
1147,user_1147,6243,199,156,43,May-19,0,1,1
1148,user_1148,7186,133,104,29,Jan-19,4,0,0
1149,user_1149,4157,106,72,34,May-19,0,0,1
1150,user_1150,29,12,12,0,Mar-18,14,0,0
1151,user_1151,30979,241,223,18,Apr-19,1,1,0
1153,user_1153,1299,24,0,24,May-19,0,1,1
1154,user_1154,45725,260,159,101,Apr-19,1,1,0
1155,user_1155,11698,333,331,2,Feb-19,3,0,0
1156,user_1156,6777,229,138,91,May-19,0,1,1
1157,user_1157,3221,137,135,2,Jan-19,4,0,0
1158,user_1158,6489,206,171,35,Apr-19,1,1,0
1159,user_1159,1224,13,10,3,Apr-19,1,1,0
1160,user_1160,6675,216,157,59,May-19,0,1,1
1161,user_1161,4175,169,134,35,Mar-19,2,0,0
1162,user_1162,6824,188,171,17,Apr-19,1,1,0
1163,user_1163,434,10,10,0,Jul-18,10,0,0
1165,user_1165,159390,1283,929,354,May-19,0,1,1
1166,user_1166,8651,277,222,55,May-19,0,1,1
1167,user_1167,3773,77,59,18,Apr-19,1,1,0
1168,user_1168,9861,108,6,102,May-19,0,1,1
1169,user_1169,73598,91,87,4,Mar-19,2,0,0
1170,user_1170,9973,223,216,7,May-19,0,1,1
1171,user_1171,6949,261,34,227,May-19,0,1,1
1172,user_1172,9955,117,103,14,Apr-19,1,1,0
1173,user_1173,632,8,8,0,Mar-18,14,0,0
1174,user_1174,15814,47,28,19,Mar-19,2,0,0
1175,user_1175,26668,456,345,111,May-19,0,1,1
1176,user_1176,10947,157,97,60,Apr-19,1,1,0
1177,user_1177,388,57,57,0,Sep-18,8,0,0
1178,user_1178,13681,144,141,3,Mar-19,2,0,0
1179,user_1179,14059,457,228,229,May-19,0,1,1
1180,user_1180,4578,125,65,60,Apr-19,1,1,0
1181,user_1181,119,5,5,0,Feb-18,15,0,0
1182,user_1182,2835,67,46,21,May-19,0,1,1
1183,user_1183,2274,23,23,0,Jun-18,11,0,0
1184,user_1184,8147,225,149,76,May-19,0,1,1
1185,user_1185,7702,93,80,13,Feb-19,3,0,0
1186,user_1186,98169,383,279,104,May-19,0,1,1
1187,user_1187,101,3,3,0,Mar-18,14,0,0
1188,user_1188,1552,21,7,14,May-19,0,1,1
1189,user_1189,11407,267,182,85,May-19,0,1,1
1190,user_1190,5578,99,99,0,Dec-18,5,0,0
1191,user_1191,11448,219,172,47,Apr-19,1,1,0
1192,user_1192,26757,1346,916,430,May-19,0,1,1
1193,user_1193,10646,93,31,62,Apr-19,1,1,0
1194,user_1194,3842,168,108,60,Apr-19,1,1,0
1195,user_1195,2584,308,253,55,May-19,0,1,1
1196,user_1196,14,3,3,0,Feb-18,15,0,0
1197,user_1197,517667,91,6,85,May-19,0,1,1
1198,user_1198,43,12,12,0,Apr-18,13,0,0
1199,user_1199,96249,385,143,242,May-19,0,1,1
1200,user_1200,12824,417,0,417,May-19,0,1,1
1201,user_1201,22824,331,277,54,May-19,0,1,1
1202,user_1202,326,10,10,0,Feb-18,15,0,0
1203,user_1203,5374,142,136,6,Apr-19,1,1,0
1204,user_1204,338,18,0,18,May-19,0,1,1
1205,user_1205,21,3,3,0,Feb-18,15,0,0
1206,user_1206,1193,296,151,145,May-19,0,1,1
1207,user_1207,42166,673,551,122,May-19,0,1,1
1209,user_1209,12218,615,546,69,May-19,0,1,1
1210,user_1210,3551,67,67,0,Jul-18,10,0,0
1211,user_1211,106,9,5,4,Apr-19,1,1,0
1212,user_1212,7476,100,78,22,Apr-19,1,1,0
1213,user_1213,8278,239,239,0,Sep-18,8,0,0
1214,user_1214,60,2,2,0,Feb-18,15,0,0
1215,user_1215,81,7,7,0,Jun-18,11,0,0
1216,user_1216,585,12,12,0,Mar-18,14,0,0
1217,user_1217,976,18,13,5,Feb-19,3,0,0
1218,user_1218,57342,109,76,33,May-19,0,1,1
1219,user_1219,86,19,10,9,Mar-19,2,0,0
1220,user_1220,186,7,7,0,Apr-18,13,0,0
1221,user_1221,107563,952,845,107,May-19,0,1,1
1222,user_1222,11348,133,124,9,Jan-19,4,0,0
1223,user_1223,3991,422,284,138,May-19,0,1,1
1224,user_1224,2238,101,57,44,Apr-19,1,1,0
1225,user_1225,1084,56,13,43,May-19,0,1,1
1226,user_1226,3477,98,93,5,Apr-19,1,1,0
1227,user_1227,7103,166,115,51,May-19,0,1,1
1228,user_1228,9603,92,92,0,Jun-18,11,0,0
1229,user_1229,93615,183,132,51,May-19,0,1,1
1230,user_1230,6600,173,123,50,May-19,0,1,1
1232,user_1232,3444,150,116,34,May-19,0,1,1
1233,user_1233,11,7,7,0,Jul-18,10,0,0
1234,user_1234,6965,65,64,1,Mar-19,2,0,0
1235,user_1235,2996,235,150,85,May-19,0,1,1
1236,user_1236,55807,81,59,22,May-19,0,1,1
1237,user_1237,12468,681,442,239,May-19,0,1,1
1238,user_1238,1736,129,117,12,May-19,0,0,1
1239,user_1239,3513,236,195,41,May-19,0,1,1
1240,user_1240,112996,1089,794,295,May-19,0,1,1
1241,user_1241,9515,157,148,9,May-19,0,1,1
1242,user_1242,5480,255,171,84,May-19,0,1,1
1243,user_1243,802,11,11,0,Aug-18,9,0,0
1244,user_1244,12174,236,182,54,May-19,0,1,1
1245,user_1245,32677,473,236,237,May-19,0,1,1
1246,user_1246,100,2,2,0,Feb-18,15,0,0
1247,user_1247,60,4,2,2,Mar-19,2,0,0
1248,user_1248,92,4,3,1,Apr-19,1,1,0
1249,user_1249,4517,79,2,77,May-19,0,1,1
1250,user_1250,710,9,9,0,Apr-18,13,0,0
1251,user_1251,17058,54,45,9,Mar-19,2,0,0
1252,user_1252,17289,158,0,158,May-19,0,1,1
1253,user_1253,2486,112,32,80,May-19,0,1,1
1254,user_1254,151,7,7,0,Mar-18,14,0,0
1255,user_1255,15863,734,711,23,Apr-19,1,1,0
1256,user_1256,6601,79,53,26,Mar-19,2,0,0
1257,user_1257,1871,67,66,1,Mar-19,2,0,0
1258,user_1258,14750,54,41,13,Apr-19,1,1,0
1259,user_1259,10870,636,394,242,May-19,0,1,1
1260,user_1260,329,13,2,11,Mar-19,2,0,0
1261,user_1261,3000,82,80,2,Feb-19,3,0,0
1262,user_1262,59700,279,195,84,May-19,0,1,1
1263,user_1263,35,5,5,0,Feb-18,15,0,0
1264,user_1264,22546,462,435,27,May-19,0,1,1
1265,user_1265,11251,223,221,2,May-19,0,0,1
1266,user_1266,15,3,0,3,May-19,0,1,1
1267,user_1267,4497,132,100,32,Apr-19,1,1,0
1268,user_1268,4695,424,310,114,May-19,0,1,1
1269,user_1269,6109,72,72,0,Oct-18,7,0,0
1270,user_1270,101,3,3,0,Mar-18,14,0,0
1271,user_1271,62,3,3,0,Feb-18,15,0,0
1273,user_1273,2025,30,28,2,Mar-19,2,0,0
1274,user_1274,5385,94,94,0,Aug-18,9,0,0
1275,user_1275,4908,30,25,5,Apr-19,1,1,0
1276,user_1276,3666,168,118,50,May-19,0,1,1
1277,user_1277,11854,387,237,150,May-19,0,1,1
1278,user_1278,5464,226,100,126,May-19,0,1,1
1279,user_1279,3184,43,43,0,Nov-18,6,0,0
1280,user_1280,94,4,4,0,May-18,12,0,0
1281,user_1281,32195,445,375,70,Apr-19,1,1,0
1282,user_1282,2100,51,50,1,Mar-19,2,0,0
1283,user_1283,3844,185,104,81,May-19,0,1,1
1284,user_1284,130,8,6,2,Jan-19,4,0,0
1285,user_1285,50998,3056,1646,1410,May-19,0,1,1
1286,user_1286,10112,703,400,303,May-19,0,1,1
1287,user_1287,1239,18,11,7,Apr-19,1,1,0
1288,user_1288,344,12,12,0,Apr-18,13,0,0
1289,user_1289,4404,73,65,8,Apr-19,1,1,0
1290,user_1290,16926,184,132,52,May-19,0,1,1
1291,user_1291,27438,483,178,305,May-19,0,1,1
1292,user_1292,8890,108,92,16,Apr-19,1,1,0
1293,user_1293,64001,330,207,123,May-19,0,1,1
1294,user_1294,40965,1349,1055,294,May-19,0,1,1
1295,user_1295,10714,196,176,20,May-19,0,0,1
1296,user_1296,121,21,16,5,May-19,0,1,1
1297,user_1297,226182,1569,741,828,May-19,0,1,1
1298,user_1298,5791,338,216,122,May-19,0,1,1
1299,user_1299,3356,105,97,8,Feb-19,3,0,0
1300,user_1300,306,7,5,2,Feb-19,3,0,0
1301,user_1301,23563,943,718,225,May-19,0,1,1
1302,user_1302,40641,172,122,50,Mar-19,2,0,0
1303,user_1303,1681,86,21,65,May-19,0,1,1
1304,user_1304,4376,145,94,51,May-19,0,1,1
1305,user_1305,40419,422,209,213,May-19,0,1,1
1306,user_1306,14766,415,363,52,May-19,0,1,1
1307,user_1307,9,2,2,0,Mar-18,14,0,0
1308,user_1308,107237,107,77,30,Mar-19,2,0,0
1309,user_1309,18364,500,418,82,May-19,0,1,1
1310,user_1310,6823,138,134,4,Apr-19,1,1,0
1311,user_1311,724,16,15,1,Apr-19,1,1,0
1312,user_1312,140,23,23,0,Jul-18,10,0,0
1314,user_1314,18497,246,235,11,Feb-19,3,0,0
1315,user_1315,20792,446,314,132,May-19,0,1,1
1316,user_1316,6072,224,155,69,May-19,0,1,1
1317,user_1317,97,7,7,0,Feb-18,15,0,0
1318,user_1318,1548,52,43,9,Mar-19,2,0,0
1319,user_1319,61934,185,140,45,May-19,0,1,1
1320,user_1320,2816,34,33,1,Jan-19,4,0,0
1322,user_1322,15916,332,288,44,May-19,0,1,1
1323,user_1323,29166,156,59,97,May-19,0,1,1
1324,user_1324,12667,290,189,101,May-19,0,1,1
1325,user_1325,6460,247,202,45,May-19,0,0,1
1326,user_1326,6281,79,66,13,Apr-19,1,1,0
1327,user_1327,20950,529,399,130,May-19,0,1,1
1328,user_1328,5117,151,142,9,Mar-19,2,0,0
1329,user_1329,3209,109,63,46,May-19,0,1,1
1330,user_1330,20123,689,473,216,May-19,0,1,1
1331,user_1331,117,22,19,3,Mar-19,2,0,0
1332,user_1332,3360,26,26,0,Apr-18,13,0,0
1333,user_1333,1304,26,26,0,Sep-18,8,0,0
1334,user_1334,4370,52,41,11,Apr-19,1,1,0
1335,user_1335,12256,76,50,26,Apr-19,1,1,0
1336,user_1336,10383,13,13,0,Jul-18,10,0,0
1337,user_1337,21753,530,329,201,May-19,0,1,1
1338,user_1338,0,1,1,0,Mar-18,14,0,0
1339,user_1339,7716,375,322,53,May-19,0,1,1
1340,user_1340,26,4,4,0,Feb-18,15,0,0
1341,user_1341,374450,53,11,42,May-19,0,1,1
1342,user_1342,33148,71,42,29,May-19,0,1,1
1343,user_1343,10760,138,102,36,May-19,0,1,1
1344,user_1344,44,3,3,0,Feb-18,15,0,0
1345,user_1345,17786,567,318,249,May-19,0,1,1
1346,user_1346,3921,52,52,0,May-18,12,0,0
1347,user_1347,1200,85,14,71,May-19,0,1,1
1348,user_1348,128561,1528,787,741,May-19,0,1,1
1349,user_1349,2941,100,100,0,Jun-18,11,0,0
1350,user_1350,680,30,30,0,Dec-18,5,0,0
1351,user_1351,4680,86,84,2,Jan-19,4,0,0
1352,user_1352,398,12,12,0,Oct-18,7,0,0
1353,user_1353,299,16,14,2,Jan-19,4,0,0
1354,user_1354,7861,290,161,129,May-19,0,1,1
1355,user_1355,54764,394,189,205,May-19,0,1,1
1356,user_1356,16123,177,144,33,Mar-19,2,0,0
1357,user_1357,2863,38,34,4,Apr-19,1,1,0
1358,user_1358,4507,65,56,9,May-19,0,1,1
1359,user_1359,18,4,4,0,Apr-18,13,0,0
1360,user_1360,7415,366,204,162,May-19,0,1,1
1361,user_1361,1287,44,19,25,May-19,0,1,1
1362,user_1362,8295,146,127,19,Feb-19,3,0,0
1363,user_1363,101991,148,93,55,May-19,0,1,1
1364,user_1364,31974,596,226,370,May-19,0,1,1
1365,user_1365,1387,73,35,38,Apr-19,1,1,0
1366,user_1366,3577,60,53,7,Feb-19,3,0,0
1368,user_1368,7221,216,139,77,May-19,0,1,1
1369,user_1369,977,40,9,31,May-19,0,1,1
1370,user_1370,13893,959,639,320,May-19,0,1,1
1371,user_1371,2303,104,100,4,May-19,0,0,1
1372,user_1372,90,14,11,3,Feb-19,3,0,0
1373,user_1373,80678,1333,1003,330,May-19,0,1,1
1374,user_1374,13320,797,569,228,May-19,0,1,1
1375,user_1375,1317,19,5,14,May-19,0,1,1
1376,user_1376,1211,18,3,15,Apr-19,1,1,0
1377,user_1377,10748,328,68,260,May-19,0,1,1
1378,user_1378,19737,130,115,15,May-19,0,0,1
1379,user_1379,11631,209,115,94,May-19,0,1,1
1380,user_1380,4287,53,44,9,Feb-19,3,0,0
1381,user_1381,44947,2134,1326,808,May-19,0,1,1
1382,user_1382,3525,115,49,66,May-19,0,1,1
1383,user_1383,2778,64,53,11,Feb-19,3,0,0
1384,user_1384,70,1,1,0,Feb-18,15,0,0
1385,user_1385,25008,638,413,225,May-19,0,1,1
1386,user_1386,4690,77,8,69,May-19,0,1,1
1387,user_1387,4272,202,152,50,May-19,0,0,1
1388,user_1388,2500,114,62,52,May-19,0,1,1
1389,user_1389,627,47,26,21,Feb-19,3,0,0
1390,user_1390,3440,55,44,11,May-19,0,0,1
1391,user_1391,2797,34,2,32,Apr-19,1,1,0
1392,user_1392,5442,86,85,1,Mar-19,2,0,0
1396,user_1396,19909,272,272,0,Dec-18,5,0,0
1397,user_1397,16789,471,143,328,May-19,0,1,1
1398,user_1398,545,26,4,22,May-19,0,1,1
1399,user_1399,12564,1037,824,213,May-19,0,1,1
1400,user_1400,779,140,108,32,May-19,0,1,1
1401,user_1401,26,6,6,0,Feb-18,15,0,0
1402,user_1402,18575,449,278,171,May-19,0,1,1
1403,user_1403,1299,26,26,0,Jun-18,11,0,0
1404,user_1404,7407,168,136,32,May-19,0,1,1
1405,user_1405,957,15,14,1,Apr-19,1,1,0
1406,user_1406,18385,22,22,0,Sep-18,8,0,0
1407,user_1407,24,4,4,0,Feb-18,15,0,0
1408,user_1408,14483,144,138,6,Apr-19,1,1,0
1409,user_1409,3222,25,25,0,Sep-18,8,0,0
1410,user_1410,12179,168,82,86,May-19,0,1,1
1411,user_1411,1262,16,5,11,Apr-19,1,1,0
1412,user_1412,15367,270,223,47,May-19,0,1,1
1413,user_1413,25455,104,103,1,Mar-19,2,0,0
1414,user_1414,46736,198,143,55,May-19,0,1,1
1415,user_1415,18707,136,136,0,Aug-18,9,0,0
1417,user_1417,58242,685,370,315,May-19,0,1,1
1418,user_1418,29667,718,568,150,May-19,0,1,1
1419,user_1419,15208,315,169,146,May-19,0,1,1
1420,user_1420,2454,355,203,152,May-19,0,1,1
1421,user_1421,2631,116,107,9,May-19,0,1,1
1422,user_1422,29228,1548,447,1101,May-19,0,1,1
1423,user_1423,8680,14,11,3,Feb-19,3,0,0
1424,user_1424,6117,261,234,27,Apr-19,1,1,0
1425,user_1425,2163,133,94,39,Apr-19,1,1,0
1426,user_1426,3343,153,68,85,May-19,0,1,1
1427,user_1427,12,3,3,0,Sep-18,8,0,0
1428,user_1428,11184,516,393,123,May-19,0,1,1
1429,user_1429,3719,29,29,0,Sep-18,8,0,0
1430,user_1430,19870,489,88,401,May-19,0,1,1
1431,user_1431,892,24,23,1,Apr-19,1,1,0
1433,user_1433,133479,2276,1309,967,May-19,0,1,1
1434,user_1434,27,4,4,0,Feb-18,15,0,0
1435,user_1435,52124,333,188,145,May-19,0,1,1
1436,user_1436,19576,261,121,140,May-19,0,1,1
1437,user_1437,9357,137,107,30,May-19,0,1,1
1438,user_1438,6882,135,112,23,May-19,0,1,1
1439,user_1439,18,9,9,0,Aug-18,9,0,0
1440,user_1440,8302,267,124,143,May-19,0,1,1
1441,user_1441,11264,237,5,232,May-19,0,1,1
1442,user_1442,14017,259,97,162,May-19,0,1,1
1443,user_1443,9222,351,186,165,May-19,0,1,1
1444,user_1444,5149,41,2,39,Mar-19,2,0,0
1445,user_1445,1381,49,48,1,Jan-19,4,0,0
1446,user_1446,2506,29,29,0,Mar-18,14,0,0
1447,user_1447,39771,655,537,118,May-19,0,1,1
1448,user_1448,5872,61,43,18,Mar-19,2,0,0
1450,user_1450,3043,94,59,35,Apr-19,1,1,0
1451,user_1451,10545,221,162,59,May-19,0,1,1
1452,user_1452,1730,144,116,28,Apr-19,1,1,0
1453,user_1453,4325,103,103,0,May-18,12,0,0
1454,user_1454,3675,177,66,111,May-19,0,1,1
1455,user_1455,79,7,7,0,Sep-18,8,0,0
1456,user_1456,61583,284,237,47,May-19,0,1,1
1457,user_1457,3314,138,105,33,Apr-19,1,1,0
1458,user_1458,7128,211,107,104,May-19,0,1,1
1459,user_1459,667,30,30,0,Jul-18,10,0,0
1460,user_1460,6384,113,78,35,May-19,0,1,1
1461,user_1461,20728,211,148,63,May-19,0,1,1
1462,user_1462,31,4,4,0,Mar-18,14,0,0
1463,user_1463,2420,24,24,0,Sep-18,8,0,0
1464,user_1464,18175,60,60,0,Dec-18,5,0,0
1465,user_1465,3777,52,52,0,Nov-18,6,0,0
1466,user_1466,32023,1219,890,329,May-19,0,1,1
1467,user_1467,2365,78,22,56,May-19,0,1,1
1468,user_1468,87,4,4,0,Mar-18,14,0,0
1470,user_1470,23964,1465,527,938,May-19,0,1,1
1471,user_1471,5593,92,75,17,Apr-19,1,1,0
1472,user_1472,16645,168,119,49,Mar-19,2,0,0
1473,user_1473,2885,38,2,36,Mar-19,2,0,0
1474,user_1474,3098,133,104,29,May-19,0,0,1
1475,user_1475,7905,214,65,149,May-19,0,1,1
1476,user_1476,1996,23,23,0,Nov-18,6,0,0
1477,user_1477,25544,118,77,41,May-19,0,1,1
1478,user_1478,11626,64,42,22,May-19,0,1,1
1479,user_1479,4058,112,112,0,Dec-18,5,0,0
1480,user_1480,7939,147,101,46,Feb-19,3,0,0
1481,user_1481,9054,692,540,152,May-19,0,1,1
1482,user_1482,3775,85,79,6,Apr-19,1,1,0
1483,user_1483,113923,322,99,223,May-19,0,1,1
1484,user_1484,3486,61,24,37,May-19,0,1,1
1485,user_1485,2731,76,74,2,Mar-19,2,0,0
1486,user_1486,1253,9,9,0,Mar-18,14,0,0
1487,user_1487,2193,14,3,11,Mar-19,2,0,0
1488,user_1488,5216,102,76,26,Apr-19,1,1,0
1489,user_1489,8745,572,422,150,May-19,0,1,1
1490,user_1490,2799,117,69,48,Apr-19,1,1,0
1491,user_1491,45526,428,343,85,May-19,0,1,1
1492,user_1492,449,26,26,0,Dec-18,5,0,0
1493,user_1493,2744,20,20,0,Aug-18,9,0,0
1494,user_1494,33745,57,57,0,Dec-18,5,0,0
1495,user_1495,176,20,20,0,Feb-18,15,0,0
1496,user_1496,5494,80,60,20,May-19,0,1,1
1497,user_1497,6549,172,172,0,Dec-18,5,0,0
1498,user_1498,3169,80,60,20,Apr-19,1,1,0
1499,user_1499,338,7,7,0,Feb-18,15,0,0
1500,user_1500,150,3,1,2,May-19,0,0,1
1502,user_1502,2117,79,63,16,Feb-19,3,0,0
1503,user_1503,2089,20,2,18,May-19,0,1,1
1504,user_1504,59778,892,668,224,May-19,0,1,1
1505,user_1505,531,33,27,6,May-19,0,1,1
1506,user_1506,2236,30,30,0,Oct-18,7,0,0
1507,user_1507,9165,513,359,154,May-19,0,1,1
1508,user_1508,588346,28,21,7,Apr-19,1,1,0
1509,user_1509,14,3,3,0,Oct-18,7,0,0
1510,user_1510,8620,169,79,90,Apr-19,1,1,0
1511,user_1511,11040,300,292,8,May-19,0,1,1
1512,user_1512,16131,82,69,13,Apr-19,1,1,0
1513,user_1513,669,17,17,0,Apr-18,13,0,0
1514,user_1514,1582,240,49,191,May-19,0,1,1
1515,user_1515,164,11,9,2,Mar-19,2,0,0
1516,user_1516,3704,190,103,87,May-19,0,1,1
1517,user_1517,21,4,4,0,Dec-18,5,0,0
1518,user_1518,1072,96,70,26,May-19,0,1,1
1519,user_1519,9217,183,85,98,May-19,0,1,1
1520,user_1520,319,6,6,0,Oct-18,7,0,0
1521,user_1521,1218,47,47,0,Oct-18,7,0,0
1522,user_1522,6035,346,269,77,Apr-19,1,1,0
1524,user_1524,11650,25,24,1,Feb-19,3,0,0
1525,user_1525,29291,346,310,36,May-19,0,1,1
1526,user_1526,65621,451,339,112,May-19,0,1,1
1527,user_1527,8171,87,87,0,Oct-18,7,0,0
1528,user_1528,621,12,12,0,Jun-18,11,0,0
1529,user_1529,21,3,3,0,Nov-18,6,0,0
1530,user_1530,41641,713,410,303,May-19,0,1,1
1531,user_1531,11532,537,356,181,May-19,0,1,1
1532,user_1532,31140,228,183,45,May-19,0,1,1
1533,user_1533,12143,346,233,113,May-19,0,1,1
1534,user_1534,56102,622,304,318,May-19,0,1,1
1535,user_1535,17104,596,230,366,May-19,0,1,1
1536,user_1536,2026,54,49,5,Apr-19,1,1,0
1537,user_1537,766,37,19,18,May-19,0,1,1
1538,user_1538,1222,91,44,47,May-19,0,1,1
1539,user_1539,256,19,19,0,Aug-18,9,0,0
1540,user_1540,7976,403,281,122,May-19,0,1,1
1541,user_1541,829,6,6,0,Mar-18,14,0,0
1542,user_1542,4471,374,324,50,May-19,0,1,1
1543,user_1543,16,2,0,2,Jan-19,4,0,0
1544,user_1544,2050,84,64,20,Apr-19,1,1,0
1545,user_1545,2972,89,88,1,Feb-19,3,0,0
1546,user_1546,57,7,7,0,Sep-18,8,0,0
1547,user_1547,8520,18,18,0,Nov-18,6,0,0
1548,user_1548,39452,168,117,51,May-19,0,1,1
1549,user_1549,1,1,1,0,Feb-18,15,0,0
1550,user_1550,64462,404,328,76,May-19,0,1,1
1551,user_1551,3644,86,78,8,May-19,0,1,1
1552,user_1552,982,33,33,0,Oct-18,7,0,0
1553,user_1553,462,37,37,0,Jul-18,10,0,0
1554,user_1554,18737,127,127,0,Aug-18,9,0,0
1555,user_1555,7926,127,127,0,Dec-18,5,0,0
1556,user_1556,1176,7,7,0,Feb-18,15,0,0
1557,user_1557,23558,797,491,306,May-19,0,1,1
1558,user_1558,1200,87,69,18,May-19,0,1,1
1559,user_1559,22048,447,317,130,May-19,0,1,1
1560,user_1560,312646,266,180,86,May-19,0,1,1
1561,user_1561,4857,70,58,12,Apr-19,1,1,0
1562,user_1562,13872,144,137,7,Feb-19,3,0,0
1563,user_1563,69,9,9,0,Feb-18,15,0,0
1564,user_1564,7871,38,28,10,May-19,0,1,1
1565,user_1565,2534,49,49,0,Sep-18,8,0,0
1566,user_1566,3221,49,22,27,Apr-19,1,1,0
1567,user_1567,27304,164,152,12,Apr-19,1,1,0
1568,user_1568,3057,77,32,45,Apr-19,1,1,0
1569,user_1569,8318,432,290,142,May-19,0,1,1
1570,user_1570,1897,15,3,12,May-19,0,0,1
1571,user_1571,15436,58,37,21,Apr-19,1,1,0
1572,user_1572,7647,318,233,85,Apr-19,1,1,0
1573,user_1573,255,17,0,17,May-19,0,1,1
1574,user_1574,11044,285,217,68,May-19,0,1,1
1575,user_1575,7835,219,134,85,May-19,0,1,1
1576,user_1576,9,3,3,0,Feb-18,15,0,0
1577,user_1577,62648,918,670,248,May-19,0,1,1
1578,user_1578,493,7,7,0,Jun-18,11,0,0
1579,user_1579,4201,86,78,8,Jan-19,4,0,0
1580,user_1580,1417,53,30,23,Apr-19,1,1,0
1581,user_1581,8465,100,70,30,Apr-19,1,1,0
1582,user_1582,21664,63,25,38,May-19,0,1,1
1583,user_1583,51,10,10,0,Nov-18,6,0,0
1584,user_1584,38765,336,148,188,May-19,0,1,1
1585,user_1585,15416,533,280,253,May-19,0,1,1
1586,user_1586,15401,309,41,268,May-19,0,1,1
1587,user_1587,5265,39,20,19,May-19,0,0,1
1588,user_1588,1077,40,36,4,Feb-19,3,0,0
1589,user_1589,979,32,30,2,Feb-19,3,0,0
1590,user_1590,3023,68,45,23,Apr-19,1,1,0
1591,user_1591,17529,194,155,39,Mar-19,2,0,0
1592,user_1592,38794,259,174,85,May-19,0,1,1
1593,user_1593,17192,211,191,20,Apr-19,1,1,0
1594,user_1594,379,110,86,24,May-19,0,0,1
1595,user_1595,8271,158,76,82,May-19,0,1,1
1596,user_1596,3493,106,51,55,May-19,0,1,1
1597,user_1597,1473,10,10,0,Apr-18,13,0,0
1598,user_1598,34,6,6,0,Mar-18,14,0,0
1599,user_1599,34145,602,448,154,May-19,0,1,1
1600,user_1600,8042,404,239,165,May-19,0,1,1
1601,user_1601,2750,89,52,37,May-19,0,0,1
1602,user_1602,74,5,5,0,Oct-18,7,0,0
1603,user_1603,9405,73,32,41,May-19,0,1,1
1604,user_1604,479,39,3,36,Apr-19,1,1,0
1605,user_1605,4536,146,114,32,May-19,0,1,1
1606,user_1606,1661,52,49,3,Apr-19,1,1,0
1607,user_1607,14041,263,200,63,May-19,0,1,1
1608,user_1608,3432,108,68,40,Apr-19,1,1,0
1609,user_1609,3337,150,83,67,May-19,0,1,1
1610,user_1610,7436,94,61,33,Mar-19,2,0,0
1611,user_1611,194,15,4,11,Mar-19,2,0,0
1612,user_1612,8066,46,45,1,Apr-19,1,1,0
1613,user_1613,28705,813,545,268,May-19,0,1,1
1614,user_1614,8318,301,93,208,May-19,0,1,1
1615,user_1615,4140,78,69,9,Jan-19,4,0,0
1616,user_1616,6111,101,94,7,Feb-19,3,0,0
1617,user_1617,2314,83,67,16,Mar-19,2,0,0
1618,user_1618,11337,177,147,30,May-19,0,1,1
1619,user_1619,76080,102,36,66,May-19,0,1,1
1620,user_1620,24474,495,390,105,May-19,0,1,1
1621,user_1621,2687,102,65,37,Apr-19,1,1,0
1622,user_1622,1908,22,22,0,Jun-18,11,0,0
1623,user_1623,1627,32,9,23,Apr-19,1,1,0
1625,user_1625,13339,176,87,89,May-19,0,1,1
1626,user_1626,3066,282,246,36,May-19,0,1,1
1627,user_1627,1232,51,44,7,Mar-19,2,0,0
1628,user_1628,3494,138,80,58,Apr-19,1,1,0
1629,user_1629,21662,200,156,44,May-19,0,1,1
1630,user_1630,149,32,20,12,Feb-19,3,0,0
1631,user_1631,18158,142,122,20,Apr-19,1,1,0
1632,user_1632,5196,455,303,152,May-19,0,1,1
1633,user_1633,101,13,13,0,Oct-18,7,0,0
1634,user_1634,851614,16,0,16,Apr-19,1,1,0
1635,user_1635,11029,353,244,109,May-19,0,1,1
1636,user_1636,44102,255,154,101,May-19,0,1,1
1637,user_1637,124,13,13,0,Oct-18,7,0,0
1638,user_1638,144007,1112,607,505,May-19,0,1,1
1639,user_1639,2561,48,38,10,Apr-19,1,1,0
1640,user_1640,439,29,7,22,May-19,0,1,1
1641,user_1641,786,23,6,17,May-19,0,1,1
1642,user_1642,965,97,93,4,Jan-19,4,0,0
1643,user_1643,1054,28,26,2,Mar-19,2,0,0
1644,user_1644,21199,186,148,38,Apr-19,1,1,0
1645,user_1645,126930,1241,878,363,May-19,0,1,1
1646,user_1646,24659,930,604,326,Apr-19,1,1,0
1647,user_1647,4494,25,25,0,Oct-18,7,0,0
1648,user_1648,733,54,39,15,May-19,0,1,1
1649,user_1649,5890,184,177,7,Apr-19,1,1,0
1650,user_1650,3438,21,16,5,Mar-19,2,0,0
1651,user_1651,4845,195,188,7,May-19,0,1,1
1652,user_1652,130209,588,419,169,May-19,0,1,1
1653,user_1653,76047,630,434,196,May-19,0,1,1
1654,user_1654,2271,148,64,84,May-19,0,1,1
1655,user_1655,6422,131,84,47,May-19,0,1,1
1656,user_1656,24053,1301,587,714,May-19,0,1,1
1657,user_1657,4219,82,65,17,May-19,0,1,1
1658,user_1658,5197,212,207,5,Apr-19,1,1,0
1659,user_1659,69897,208,121,87,May-19,0,1,1
1660,user_1660,40461,729,714,15,May-19,0,1,1
1661,user_1661,7315,55,24,31,Apr-19,1,1,0
1662,user_1662,47688,756,733,23,May-19,0,1,1
1663,user_1663,2234,18,18,0,Dec-18,5,0,0
1664,user_1664,5953,60,35,25,May-19,0,1,1
1666,user_1666,18087,27,18,9,Mar-19,2,0,0
1667,user_1667,1421,59,13,46,May-19,0,1,1
1668,user_1668,2546,49,49,0,Dec-18,5,0,0
1669,user_1669,7466,246,172,74,May-19,0,1,1
1670,user_1670,14435,170,133,37,Apr-19,1,1,0
1671,user_1671,2292,176,159,17,Apr-19,1,1,0
1672,user_1672,9938,225,215,10,May-19,0,1,1
1673,user_1673,2703,7,7,0,Feb-18,15,0,0
1674,user_1674,10891,917,663,254,May-19,0,1,1
1675,user_1675,2156,33,3,30,Apr-19,1,1,0
1676,user_1676,8754,53,31,22,Apr-19,1,1,0
1677,user_1677,3430,251,53,198,May-19,0,1,1
1678,user_1678,9588,140,101,39,Apr-19,1,1,0
1679,user_1679,335,41,41,0,May-18,12,0,0
1680,user_1680,7633,162,92,70,Apr-19,1,1,0
1681,user_1681,6847,57,50,7,May-19,0,0,1
1682,user_1682,7791,163,103,60,May-19,0,1,1
1683,user_1683,116399,40,32,8,Apr-19,1,1,0
1684,user_1684,9503,43,36,7,Mar-19,2,0,0
1685,user_1685,5768,326,229,97,May-19,0,1,1
1686,user_1686,3285,55,50,5,Jan-19,4,0,0
1687,user_1687,4943,86,49,37,May-19,0,1,1
1688,user_1688,17646,471,300,171,May-19,0,1,1
1689,user_1689,6673,76,76,0,Apr-18,13,0,0
1690,user_1690,1943,42,23,19,Jan-19,4,0,0
1691,user_1691,25535,633,353,280,May-19,0,1,1
1692,user_1692,8181,92,42,50,May-19,0,1,1
1693,user_1693,9,2,2,0,Mar-18,14,0,0
1694,user_1694,8735,181,99,82,May-19,0,1,1
1695,user_1695,44504,202,95,107,May-19,0,1,1
1696,user_1696,1669,12,8,4,Apr-19,1,1,0
1697,user_1697,34453,179,153,26,May-19,0,1,1
1698,user_1698,2382,8,6,2,Mar-19,2,0,0
1699,user_1699,24586,946,593,353,May-19,0,1,1
1700,user_1700,4394,52,52,0,Jun-18,11,0,0
1701,user_1701,11973,113,50,63,May-19,0,1,1
1702,user_1702,3484,54,53,1,Apr-19,1,1,0
1703,user_1703,6880,385,186,199,May-19,0,1,1
1704,user_1704,1094,52,22,30,Apr-19,1,1,0
1705,user_1705,2589,89,88,1,Jan-19,4,0,0
1706,user_1706,3741,144,62,82,May-19,0,1,1
1707,user_1707,53,9,5,4,Apr-19,1,1,0
1708,user_1708,11737,4,4,0,Mar-18,14,0,0
1709,user_1709,23353,300,212,88,May-19,0,1,1
1710,user_1710,5529,16,16,0,Dec-18,5,0,0
1711,user_1711,5087,348,317,31,Apr-19,1,1,0
1712,user_1712,1154,54,22,32,May-19,0,1,1
1713,user_1713,3621,140,107,33,Apr-19,1,1,0
1714,user_1714,7588,362,196,166,May-19,0,1,1
1715,user_1715,10234,33,33,0,Dec-18,5,0,0
1716,user_1716,22694,380,128,252,May-19,0,1,1
1717,user_1717,4356,73,14,59,May-19,0,1,1
1718,user_1718,422,47,14,33,May-19,0,0,1
1719,user_1719,36453,48,48,0,Jun-18,11,0,0
1720,user_1720,265,29,8,21,Apr-19,1,1,0
1721,user_1721,159493,272,228,44,May-19,0,1,1
1722,user_1722,17221,157,82,75,May-19,0,1,1
1723,user_1723,9201,522,255,267,May-19,0,1,1
1724,user_1724,26,11,11,0,Feb-18,15,0,0
1725,user_1725,18,3,3,0,Mar-18,14,0,0
1726,user_1726,1162,14,14,0,May-18,12,0,0
1727,user_1727,2331,34,28,6,Apr-19,1,1,0
1728,user_1728,7989,138,3,135,Apr-19,1,1,0
1729,user_1729,1145,38,18,20,May-19,0,1,1
1730,user_1730,35,4,4,0,May-18,12,0,0
1731,user_1731,8067,701,480,221,May-19,0,1,1
1732,user_1732,15950,25,20,5,Jan-19,4,0,0
1734,user_1734,467,95,5,90,May-19,0,1,1
1735,user_1735,104,8,8,0,Feb-18,15,0,0
1736,user_1736,15450,147,124,23,Apr-19,1,1,0
1737,user_1737,2058,55,52,3,Mar-19,2,0,0
1738,user_1738,2302,114,41,73,May-19,0,1,1
1739,user_1739,27915,524,397,127,May-19,0,1,1
1740,user_1740,15969,632,618,14,May-19,0,1,1
1741,user_1741,3845,63,54,9,Feb-19,3,0,0
1742,user_1742,185,21,21,0,Nov-18,6,0,0
1743,user_1743,11213,61,61,0,May-18,12,0,0
1744,user_1744,3120,51,38,13,Mar-19,2,0,0
1745,user_1745,2126,39,39,0,Jun-18,11,0,0
1746,user_1746,5455,361,135,226,May-19,0,1,1
1747,user_1747,6924,159,140,19,Apr-19,1,1,0
1748,user_1748,15,6,6,0,Mar-18,14,0,0
1749,user_1749,17,3,3,0,Oct-18,7,0,0
1750,user_1750,6593,572,282,290,May-19,0,1,1
1751,user_1751,7714,168,127,41,May-19,0,1,1
1752,user_1752,28,7,7,0,Nov-18,6,0,0
1753,user_1753,24256,180,99,81,May-19,0,1,1
1754,user_1754,436,62,62,0,Dec-18,5,0,0
1755,user_1755,44852,199,154,45,May-19,0,1,1
1756,user_1756,18,3,2,1,Feb-19,3,0,0
1757,user_1757,23667,359,290,69,May-19,0,1,1
1758,user_1758,6935,183,12,171,May-19,0,1,1
1759,user_1759,50204,73,67,6,Apr-19,1,1,0
1760,user_1760,41054,376,173,203,May-19,0,1,1
1761,user_1761,2697,58,14,44,May-19,0,1,1
1762,user_1762,9,3,0,3,Mar-19,2,0,0
1763,user_1763,11557,406,252,154,May-19,0,1,1
1765,user_1765,2857,25,25,0,Aug-18,9,0,0
1766,user_1766,513,23,7,16,Apr-19,1,1,0
1768,user_1768,5481,289,161,128,Mar-19,2,0,0
1769,user_1769,8937,276,276,0,Jun-18,11,0,0
1770,user_1770,26187,34,20,14,Apr-19,1,1,0
1771,user_1771,793,83,76,7,Apr-19,1,1,0
1772,user_1772,501,64,52,12,May-19,0,1,1
1773,user_1773,24468,223,129,94,May-19,0,1,1
1774,user_1774,41,7,7,0,Mar-18,14,0,0
1775,user_1775,886,39,38,1,Mar-19,2,0,0
1776,user_1776,1130,19,0,19,Mar-19,2,0,0
1777,user_1777,24776,298,164,134,May-19,0,1,1
1778,user_1778,1180,9,8,1,May-19,0,0,1
1779,user_1779,644,9,9,0,Jun-18,11,0,0
1780,user_1780,6966,34,26,8,Apr-19,1,1,0
1781,user_1781,6082,133,132,1,Apr-19,1,1,0
1782,user_1782,4988,95,89,6,May-19,0,0,1
1783,user_1783,3,4,4,0,Mar-18,14,0,0
1784,user_1784,9142,182,107,75,May-19,0,1,1
1785,user_1785,490,17,5,12,Feb-19,3,0,0
1786,user_1786,736,5,5,0,Jun-18,11,0,0
1787,user_1787,3988,31,31,0,Aug-18,9,0,0
1788,user_1788,135,10,9,1,Feb-19,3,0,0
1789,user_1789,19153,823,709,114,May-19,0,1,1
1791,user_1791,1243,53,52,1,Feb-19,3,0,0
1792,user_1792,5207,52,30,22,May-19,0,1,1
1793,user_1793,1356,9,5,4,May-19,0,0,1
1794,user_1794,57371,479,347,132,May-19,0,1,1
1795,user_1795,86,6,6,0,Feb-18,15,0,0
1796,user_1796,14648,137,58,79,May-19,0,1,1
1797,user_1797,147,60,60,0,Oct-18,7,0,0
1798,user_1798,3705,90,75,15,Apr-19,1,1,0
1799,user_1799,11335,236,57,179,May-19,0,1,1
1800,user_1800,30499,86,44,42,May-19,0,1,1
1801,user_1801,314,19,16,3,Apr-19,1,1,0
1802,user_1802,15,1,1,0,Feb-18,15,0,0
1803,user_1803,3736,79,79,0,Nov-18,6,0,0
1804,user_1804,115899,599,256,343,May-19,0,1,1
1805,user_1805,349186,1106,741,365,May-19,0,1,1
1806,user_1806,9364,175,132,43,May-19,0,1,1
1807,user_1807,5489,132,117,15,Apr-19,1,1,0
1808,user_1808,33,5,5,0,Feb-18,15,0,0
1809,user_1809,24409,213,208,5,Mar-19,2,0,0
1810,user_1810,57,4,4,0,Feb-18,15,0,0
1811,user_1811,102,7,7,0,Apr-18,13,0,0
1812,user_1812,2910,83,82,1,Feb-19,3,0,0
1813,user_1813,20,2,2,0,Dec-18,5,0,0
1814,user_1814,4819,110,79,31,Apr-19,1,1,0
1815,user_1815,11229,165,156,9,May-19,0,1,1
1816,user_1816,6188,107,101,6,May-19,0,0,1
1817,user_1817,1264,38,18,20,Mar-19,2,0,0
1818,user_1818,1235,9,9,0,Jun-18,11,0,0
1819,user_1819,4899,326,265,61,May-19,0,1,1
1820,user_1820,1547,99,57,42,May-19,0,1,1
1822,user_1822,20,5,5,0,Jun-18,11,0,0
1823,user_1823,4961,25,18,7,Feb-19,3,0,0
1824,user_1824,12771,479,324,155,May-19,0,1,1
1825,user_1825,167628,46,27,19,Feb-19,3,0,0
1826,user_1826,1319,27,27,0,Aug-18,9,0,0
1827,user_1827,1583,35,16,19,May-19,0,1,1
1828,user_1828,6397,85,85,0,Sep-18,8,0,0
1829,user_1829,13563,334,334,0,Jun-18,11,0,0
1830,user_1830,5267,127,56,71,May-19,0,1,1
1831,user_1831,16843,189,145,44,May-19,0,1,1
1832,user_1832,1194,30,30,0,Nov-18,6,0,0
1833,user_1833,17,1,1,0,Aug-18,9,0,0
1834,user_1834,1985,59,49,10,May-19,0,1,1
1835,user_1835,22293,768,585,183,May-19,0,1,1
1836,user_1836,2083,40,33,7,May-19,0,0,1
1837,user_1837,31092,155,125,30,May-19,0,1,1
1838,user_1838,2567,75,73,2,Jan-19,4,0,0
1839,user_1839,18510,241,173,68,May-19,0,1,1
1840,user_1840,2030,69,69,0,Jun-18,11,0,0
1841,user_1841,7993,114,35,79,Apr-19,1,1,0
1842,user_1842,3283,137,72,65,Mar-19,2,0,0
1843,user_1843,295,6,6,0,Feb-18,15,0,0
1844,user_1844,18618,1126,795,331,May-19,0,1,1
1845,user_1845,7216,135,135,0,Oct-18,7,0,0
1846,user_1846,5615,81,81,0,Nov-18,6,0,0
1847,user_1847,18527,727,511,216,May-19,0,1,1
1848,user_1848,10074,449,312,137,May-19,0,1,1
1849,user_1849,35,7,7,0,Mar-18,14,0,0
1850,user_1850,24510,255,194,61,May-19,0,1,1
1851,user_1851,2846,93,91,2,May-19,0,0,1
1852,user_1852,10488,311,238,73,May-19,0,1,1
1853,user_1853,5492,293,188,105,May-19,0,1,1
1854,user_1854,3516,35,16,19,Apr-19,1,1,0
1855,user_1855,69,10,9,1,Jan-19,4,0,0
1856,user_1856,14124,382,382,0,Sep-18,8,0,0
1857,user_1857,926,113,58,55,May-19,0,1,1
1858,user_1858,13980,118,90,28,May-19,0,1,1
1859,user_1859,5549,120,99,21,Apr-19,1,1,0
1860,user_1860,12247,356,268,88,May-19,0,1,1
1861,user_1861,6816,9,9,0,Mar-18,14,0,0
1862,user_1862,343,32,5,27,Apr-19,1,1,0
1863,user_1863,24,3,3,0,May-18,12,0,0
1864,user_1864,43836,353,276,77,May-19,0,1,1
1865,user_1865,3875,33,32,1,Jan-19,4,0,0
1866,user_1866,375,27,27,0,Apr-18,13,0,0
1867,user_1867,5872,189,165,24,Apr-19,1,1,0
1868,user_1868,1883,49,43,6,Apr-19,1,1,0
1869,user_1869,18856,715,369,346,May-19,0,1,1
1870,user_1870,16872,531,195,336,May-19,0,1,1
1871,user_1871,1913,234,131,103,May-19,0,1,1
1872,user_1872,7683,117,86,31,May-19,0,1,1
1873,user_1873,18142,24,11,13,May-19,0,1,1
1874,user_1874,2085,124,101,23,Apr-19,1,1,0
1875,user_1875,5,1,1,0,Feb-18,15,0,0
1876,user_1876,55895,147,120,27,May-19,0,1,1
1877,user_1877,4459,140,99,41,May-19,0,1,1
1878,user_1878,6562,214,105,109,May-19,0,1,1
1879,user_1879,1337,47,45,2,May-19,0,0,1
1880,user_1880,15651,389,389,0,Oct-18,7,0,0
1881,user_1881,1441,16,10,6,Mar-19,2,0,0
1882,user_1882,9006,198,196,2,Mar-19,2,0,0
1883,user_1883,21080,886,567,319,May-19,0,1,1
1884,user_1884,3296,45,41,4,Apr-19,1,1,0
1885,user_1885,285,41,25,16,Apr-19,1,1,0
1886,user_1886,16079,155,132,23,Mar-19,2,0,0
1887,user_1887,414,40,31,9,Apr-19,1,1,0
1888,user_1888,2049,90,87,3,Jan-19,4,0,0
1889,user_1889,774,75,35,40,May-19,0,1,1
1890,user_1890,728,15,15,0,Feb-18,15,0,0
1891,user_1891,31921,1078,921,157,May-19,0,1,1
1892,user_1892,2290,66,60,6,May-19,0,1,1
1893,user_1893,1708,80,68,12,Apr-19,1,1,0
1894,user_1894,11,2,2,0,Oct-18,7,0,0
1895,user_1895,53877,57,57,0,Oct-18,7,0,0
1896,user_1896,9946,162,53,109,May-19,0,1,1
1897,user_1897,64613,177,68,109,May-19,0,1,1
1898,user_1898,15622,473,324,149,Apr-19,1,1,0
1899,user_1899,35717,208,128,80,May-19,0,1,1
1900,user_1900,1146,76,59,17,Apr-19,1,1,0
1901,user_1901,10283,392,201,191,May-19,0,1,1
1902,user_1902,32696,276,180,96,May-19,0,1,1
1903,user_1903,10732,93,43,50,May-19,0,1,1
1904,user_1904,1731,44,23,21,May-19,0,0,1
1905,user_1905,1880,37,20,17,May-19,0,1,1
1906,user_1906,4910,97,95,2,Jan-19,4,0,0
1907,user_1907,27695,614,415,199,May-19,0,1,1
1908,user_1908,28392,859,428,431,May-19,0,1,1
1909,user_1909,1347,17,17,0,Dec-18,5,0,0
1910,user_1910,52,23,23,0,May-18,12,0,0
1911,user_1911,27973,492,140,352,May-19,0,1,1
1912,user_1912,2918,24,13,11,May-19,0,1,1
1913,user_1913,4,3,3,0,Dec-18,5,0,0
1914,user_1914,9332,89,55,34,Apr-19,1,1,0
1915,user_1915,31099,78,54,24,May-19,0,1,1
1917,user_1917,1361,39,37,2,Feb-19,3,0,0
1918,user_1918,1780,40,40,0,Dec-18,5,0,0
1919,user_1919,18904,116,116,0,Oct-18,7,0,0
1920,user_1920,17,3,3,0,Mar-18,14,0,0
1922,user_1922,9,2,2,0,Mar-18,14,0,0
1923,user_1923,1747,106,96,10,Mar-19,2,0,0
1924,user_1924,685,7,7,0,Feb-18,15,0,0
1925,user_1925,38326,69,37,32,May-19,0,1,1
1926,user_1926,3792,140,125,15,Mar-19,2,0,0
1927,user_1927,6020,78,46,32,Mar-19,2,0,0
1928,user_1928,1390,79,77,2,Jan-19,4,0,0
1929,user_1929,2129,23,23,0,Jul-18,10,0,0
1930,user_1930,18252,220,218,2,Jan-19,4,0,0
1932,user_1932,9,2,0,2,Feb-19,3,0,0
1933,user_1933,114873,721,400,321,May-19,0,1,1
1934,user_1934,11392,68,33,35,Apr-19,1,1,0
1935,user_1935,1573,48,0,48,May-19,0,1,1
1936,user_1936,1797,21,21,0,May-18,12,0,0
1937,user_1937,211,14,10,4,May-19,0,0,1
1938,user_1938,11619,159,159,0,Dec-18,5,0,0
1939,user_1939,12243,369,233,136,May-19,0,1,1
1940,user_1940,44428,844,564,280,May-19,0,1,1
1941,user_1941,3759,50,50,0,Oct-18,7,0,0
1942,user_1942,1299,33,33,0,Sep-18,8,0,0
1943,user_1943,273,11,11,0,Aug-18,9,0,0
1944,user_1944,1600,18,18,0,Jun-18,11,0,0
1945,user_1945,116926,128,90,38,May-19,0,1,1
1946,user_1946,21,2,2,0,Feb-18,15,0,0
1947,user_1947,10609,69,69,0,Oct-18,7,0,0
1948,user_1948,4805,63,62,1,Feb-19,3,0,0
1949,user_1949,25973,75,75,0,Aug-18,9,0,0
1950,user_1950,29086,657,231,426,May-19,0,1,1
1951,user_1951,12433,287,181,106,May-19,0,1,1
1952,user_1952,4833,83,83,0,Oct-18,7,0,0
1953,user_1953,4687,107,59,48,Apr-19,1,1,0
1954,user_1954,612,21,6,15,Feb-19,3,0,0
1955,user_1955,1085,98,81,17,Apr-19,1,1,0
1956,user_1956,14699,118,65,53,May-19,0,1,1
1957,user_1957,1503,41,23,18,Apr-19,1,1,0
1958,user_1958,35649,279,278,1,Jan-19,4,0,0
1959,user_1959,1312,52,36,16,May-19,0,1,1
1960,user_1960,209,13,5,8,Mar-19,2,0,0
1961,user_1961,2022,288,199,89,May-19,0,1,1
1962,user_1962,108,7,6,1,Feb-19,3,0,0
1963,user_1963,411,14,14,0,Dec-18,5,0,0
1964,user_1964,27304,501,319,182,Apr-19,1,1,0
1965,user_1965,8306,152,139,13,May-19,0,1,1
1966,user_1966,1760,57,40,17,May-19,0,1,1
1967,user_1967,673,63,35,28,May-19,0,1,1
1968,user_1968,7580,120,119,1,Feb-19,3,0,0
1969,user_1969,9256,242,108,134,Apr-19,1,1,0
1970,user_1970,307,34,24,10,Feb-19,3,0,0
1971,user_1971,343,26,26,0,Jul-18,10,0,0
1972,user_1972,1791,60,43,17,May-19,0,1,1
1973,user_1973,10812,46,45,1,Jan-19,4,0,0
1974,user_1974,13,6,6,0,Feb-18,15,0,0
1975,user_1975,8452,138,111,27,May-19,0,1,1
1976,user_1976,90852,614,387,227,May-19,0,1,1
1977,user_1977,7321,231,194,37,Mar-19,2,0,0
1978,user_1978,23179,582,477,105,May-19,0,1,1
1979,user_1979,6935,106,46,60,May-19,0,1,1
1980,user_1980,27448,863,751,112,May-19,0,1,1
1981,user_1981,15093,166,154,12,Apr-19,1,1,0
1982,user_1982,6683,237,171,66,May-19,0,1,1
1983,user_1983,5737,270,129,141,May-19,0,1,1
1984,user_1984,41755,61,61,0,Dec-18,5,0,0
1985,user_1985,1017,87,51,36,May-19,0,1,1
1986,user_1986,171,7,7,0,May-18,12,0,0
1987,user_1987,26940,1196,699,497,May-19,0,1,1
1988,user_1988,4370,21,9,12,May-19,0,1,1
1989,user_1989,8875,316,197,119,May-19,0,1,1
1990,user_1990,1514,199,172,27,May-19,0,1,1
1991,user_1991,3258,444,441,3,Apr-19,1,1,0
1992,user_1992,7932,387,261,126,May-19,0,1,1
1993,user_1993,5382,234,208,26,May-19,0,1,1
1994,user_1994,7144,184,0,184,May-19,0,1,1
1995,user_1995,4101,7,7,0,Nov-18,6,0,0
1996,user_1996,3166,67,67,0,May-18,12,0,0
1997,user_1997,27652,548,315,233,May-19,0,1,1
1998,user_1998,22,5,5,0,Feb-18,15,0,0
1999,user_1999,1636,69,0,69,May-19,0,1,1
2000,user_2000,17782,401,166,235,May-19,0,1,1
2001,user_2001,6296,112,80,32,Feb-19,3,0,0
2002,user_2002,10413,100,71,29,May-19,0,1,1
2003,user_2003,7300,300,287,13,Mar-19,2,0,0
2004,user_2004,4604,265,139,126,May-19,0,1,1
2005,user_2005,8556,269,182,87,May-19,0,1,1
2006,user_2006,2516,55,51,4,Apr-19,1,1,0
2007,user_2007,86695,1545,933,612,May-19,0,1,1
2008,user_2008,5414,248,88,160,May-19,0,1,1
2009,user_2009,1582,15,15,0,Sep-18,8,0,0
2010,user_2010,2083,16,16,0,Dec-18,5,0,0
2011,user_2011,410,13,9,4,Apr-19,1,1,0
2012,user_2012,1016,26,18,8,Apr-19,1,1,0
2013,user_2013,2995,25,17,8,May-19,0,1,1
2014,user_2014,3645,285,281,4,Apr-19,1,1,0
2015,user_2015,13313,86,86,0,Dec-18,5,0,0
2016,user_2016,1293,33,33,0,Dec-18,5,0,0
2017,user_2017,13148,69,57,12,Jan-19,4,0,0
2018,user_2018,200,1,1,0,Feb-18,15,0,0
2019,user_2019,1211,75,75,0,Mar-18,14,0,0
2020,user_2020,1318,105,67,38,May-19,0,1,1
2021,user_2021,19485,749,347,402,May-19,0,1,1
2022,user_2022,297,4,4,0,Feb-18,15,0,0
2023,user_2023,6643,82,81,1,May-19,0,0,1
2024,user_2024,6569,84,54,30,Mar-19,2,0,0
2025,user_2025,179,9,9,0,Jun-18,11,0,0
2026,user_2026,1126,92,55,37,May-19,0,1,1
2027,user_2027,352,101,13,88,May-19,0,1,1
2028,user_2028,18615,75,57,18,Apr-19,1,1,0
2029,user_2029,138,18,8,10,May-19,0,1,1
2030,user_2030,8,2,2,0,Feb-18,15,0,0
2031,user_2031,49,3,3,0,Feb-18,15,0,0
2032,user_2032,76,8,8,0,Apr-18,13,0,0
2033,user_2033,3406,200,92,108,May-19,0,1,1
2034,user_2034,4296,58,58,0,Aug-18,9,0,0
2035,user_2035,36300,179,118,61,Apr-19,1,1,0
2036,user_2036,15897,223,200,23,May-19,0,1,1
2037,user_2037,2329,44,12,32,May-19,0,1,1
2038,user_2038,133862,513,390,123,May-19,0,1,1
2039,user_2039,199470,714,325,389,May-19,0,1,1
2040,user_2040,1915,79,42,37,Apr-19,1,1,0
2041,user_2041,15616,107,58,49,Apr-19,1,1,0
2042,user_2042,13471,247,246,1,Jan-19,4,0,0
2043,user_2043,40519,263,160,103,May-19,0,1,1
2044,user_2044,36550,122,81,41,May-19,0,1,1
2045,user_2045,2566,129,117,12,Apr-19,1,1,0
2046,user_2046,50116,773,406,367,May-19,0,1,1
2047,user_2047,2701,103,47,56,May-19,0,1,1
2048,user_2048,150,22,21,1,Jan-19,4,0,0
2049,user_2049,11851,187,116,71,May-19,0,1,1
2050,user_2050,19505,41,28,13,Apr-19,1,1,0
2051,user_2051,1360,41,40,1,May-19,0,0,1
2052,user_2052,36503,44,44,0,Nov-18,6,0,0
2053,user_2053,139611,1307,525,782,May-19,0,1,1
2054,user_2054,2976,21,18,3,Apr-19,1,1,0
2055,user_2055,5654,126,90,36,May-19,0,1,1
2056,user_2056,4558,108,57,51,May-19,0,1,1
2057,user_2057,12527,451,212,239,May-19,0,1,1
2058,user_2058,6491,66,56,10,May-19,0,1,1
2059,user_2059,6575,243,179,64,May-19,0,1,1
2060,user_2060,44447,124,69,55,May-19,0,1,1
2061,user_2061,27965,185,106,79,May-19,0,1,1
2062,user_2062,691,8,8,0,Aug-18,9,0,0
2063,user_2063,4894,55,47,8,Feb-19,3,0,0
2064,user_2064,672,38,30,8,Apr-19,1,1,0
2065,user_2065,942,68,59,9,Apr-19,1,1,0
2066,user_2066,612,45,26,19,May-19,0,1,1
2067,user_2067,6658,365,269,96,May-19,0,1,1
2068,user_2068,9848,239,163,76,Mar-19,2,0,0
2069,user_2069,15576,159,118,41,May-19,0,1,1
2070,user_2070,18889,870,259,611,May-19,0,1,1
2071,user_2071,13746,388,283,105,May-19,0,1,1
2072,user_2072,3708,288,286,2,Jan-19,4,0,0
2073,user_2073,20393,347,210,137,May-19,0,1,1
2074,user_2074,6290,233,85,148,May-19,0,1,1
2075,user_2075,1890,20,20,0,Aug-18,9,0,0
2076,user_2076,10410,329,265,64,May-19,0,1,1
2077,user_2077,16060,258,132,126,May-19,0,1,1
2078,user_2078,600,33,0,33,Apr-19,1,1,0
2079,user_2079,520,6,5,1,May-19,0,0,1
2080,user_2080,1676,192,175,17,Apr-19,1,1,0
2081,user_2081,7678,328,138,190,May-19,0,1,1
2082,user_2082,26455,62,62,0,Sep-18,8,0,0
2083,user_2083,1586,19,14,5,Mar-19,2,0,0
2084,user_2084,7858,24,24,0,Jul-18,10,0,0
2085,user_2085,5789,379,256,123,May-19,0,1,1
2086,user_2086,3549,100,91,9,Mar-19,2,0,0
2087,user_2087,10666,207,187,20,May-19,0,1,1
2088,user_2088,9019,105,84,21,Mar-19,2,0,0
2089,user_2089,7735,140,15,125,May-19,0,1,1
2090,user_2090,64,4,4,0,Mar-18,14,0,0
2091,user_2091,12028,145,72,73,May-19,0,1,1
2092,user_2092,9,2,2,0,Feb-18,15,0,0
2093,user_2093,13628,94,77,17,May-19,0,0,1
2094,user_2094,42816,1313,924,389,May-19,0,1,1
2095,user_2095,2432,35,31,4,Apr-19,1,1,0
2096,user_2096,150,8,8,0,Feb-18,15,0,0
2097,user_2097,54620,395,254,141,May-19,0,1,1
2098,user_2098,188,6,6,0,May-18,12,0,0
2099,user_2099,6590,371,250,121,May-19,0,1,1
2100,user_2100,21828,539,419,120,May-19,0,1,1
2101,user_2101,13747,129,103,26,May-19,0,0,1
2102,user_2102,6774,111,97,14,Apr-19,1,1,0
2103,user_2103,25720,365,361,4,Mar-19,2,0,0
2104,user_2104,2583,264,59,205,May-19,0,1,1
2105,user_2105,2908,177,125,52,May-19,0,1,1
2106,user_2106,5276,93,62,31,May-19,0,0,1
2107,user_2107,1410,18,18,0,Oct-18,7,0,0
2108,user_2108,35406,598,440,158,May-19,0,1,1
2109,user_2109,376,52,38,14,May-19,0,1,1
2110,user_2110,12565,475,260,215,May-19,0,1,1
2111,user_2111,359,9,9,0,Jul-18,10,0,0
2112,user_2112,118349,187,125,62,Apr-19,1,1,0
2113,user_2113,86,3,3,0,Mar-18,14,0,0
2114,user_2114,342,15,15,0,Oct-18,7,0,0
2115,user_2115,6131,37,36,1,Feb-19,3,0,0
2116,user_2116,1641,103,68,35,May-19,0,1,1
2117,user_2117,1888,42,42,0,Apr-18,13,0,0
2118,user_2118,16185,555,215,340,May-19,0,1,1
2120,user_2120,92,10,10,0,Dec-18,5,0,0
2121,user_2121,4261,260,183,77,May-19,0,1,1
2122,user_2122,100053,852,288,564,May-19,0,1,1
2123,user_2123,1705,207,164,43,Apr-19,1,1,0
2124,user_2124,11045,244,116,128,May-19,0,1,1
2125,user_2125,841,6,6,0,Mar-18,14,0,0
2126,user_2126,3026,182,182,0,Sep-18,8,0,0
2127,user_2127,13159,72,62,10,May-19,0,0,1
2128,user_2128,6865,268,186,82,May-19,0,1,1
2129,user_2129,26218,164,147,17,Apr-19,1,1,0
2130,user_2130,3925,127,88,39,Mar-19,2,0,0
2131,user_2131,14271,82,44,38,May-19,0,1,1
2132,user_2132,3087,55,41,14,Mar-19,2,0,0
2133,user_2133,51,2,2,0,Mar-18,14,0,0
2134,user_2134,12457,501,484,17,Mar-19,2,0,0
2135,user_2135,2466,36,26,10,Apr-19,1,1,0
2136,user_2136,1570,31,31,0,Jul-18,10,0,0
2137,user_2137,1194,17,17,0,Oct-18,7,0,0
2138,user_2138,254,49,46,3,May-19,0,0,1
2139,user_2139,8,3,0,3,May-19,0,1,1
2140,user_2140,10552,389,264,125,May-19,0,1,1
2141,user_2141,8990,110,81,29,May-19,0,0,1
2142,user_2142,2565,54,41,13,Mar-19,2,0,0
2143,user_2143,1562,22,22,0,Apr-18,13,0,0
2144,user_2144,33812,164,80,84,May-19,0,1,1
2145,user_2145,2089,31,31,0,Nov-18,6,0,0
2146,user_2146,1557,43,43,0,Nov-18,6,0,0
2147,user_2147,439,12,6,6,Apr-19,1,1,0
2148,user_2148,3930,193,161,32,Apr-19,1,1,0
2149,user_2149,1,1,1,0,Mar-18,14,0,0
2150,user_2150,10697,114,82,32,May-19,0,1,1
2151,user_2151,421,6,6,0,Jul-18,10,0,0
2152,user_2152,5955,120,107,13,Apr-19,1,1,0
2153,user_2153,6695,180,70,110,May-19,0,1,1
2154,user_2154,11077,49,21,28,Apr-19,1,1,0
2155,user_2155,1035,11,2,9,Jan-19,4,0,0
2156,user_2156,495,7,4,3,Jan-19,4,0,0
2157,user_2157,6846,63,47,16,Mar-19,2,0,0
2158,user_2158,21,8,6,2,Apr-19,1,1,0
2159,user_2159,7452,245,182,63,May-19,0,1,1
2160,user_2160,13258,886,847,39,May-19,0,0,1
2161,user_2161,4566,125,61,64,Apr-19,1,1,0
2162,user_2162,9312,114,99,15,May-19,0,1,1
2163,user_2163,8189,168,52,116,May-19,0,1,1
2164,user_2164,1413,31,31,0,Dec-18,5,0,0
2165,user_2165,2463,111,111,0,Aug-18,9,0,0
2166,user_2166,13989,504,305,199,May-19,0,1,1
2167,user_2167,16888,457,278,179,May-19,0,1,1
2168,user_2168,91,3,3,0,Mar-18,14,0,0
2169,user_2169,1733,28,28,0,Dec-18,5,0,0
2170,user_2170,1562,96,39,57,May-19,0,1,1
2171,user_2171,5117,36,36,0,Nov-18,6,0,0
2172,user_2172,402,18,0,18,May-19,0,1,1
2173,user_2173,26234,197,181,16,May-19,0,1,1
2174,user_2174,4560,107,66,41,May-19,0,1,1
2175,user_2175,9169,603,422,181,May-19,0,1,1
2177,user_2177,102,4,4,0,Jul-18,10,0,0
2178,user_2178,45746,334,140,194,May-19,0,1,1
2179,user_2179,171,2,2,0,Jun-18,11,0,0
2180,user_2180,3651,97,89,8,Jan-19,4,0,0
2181,user_2181,8487,135,72,63,May-19,0,1,1
2182,user_2182,7809,173,162,11,Apr-19,1,1,0
2184,user_2184,4891,311,172,139,May-19,0,1,1
2185,user_2185,894,59,52,7,Mar-19,2,0,0
2186,user_2186,3712,32,19,13,Apr-19,1,1,0
2187,user_2187,75,12,3,9,May-19,0,0,1
2188,user_2188,2968,50,6,44,Apr-19,1,1,0
2189,user_2189,1935,80,53,27,May-19,0,1,1
2190,user_2190,6787,35,14,21,Apr-19,1,1,0
2191,user_2191,12881,50,50,0,Oct-18,7,0,0
2192,user_2192,426,22,9,13,Apr-19,1,1,0
2193,user_2193,4384,256,120,136,May-19,0,1,1
2194,user_2194,9,2,2,0,Mar-18,14,0,0
2195,user_2195,4324,324,267,57,May-19,0,1,1
2196,user_2196,5180,79,79,0,Sep-18,8,0,0
2197,user_2197,1060,72,72,0,Dec-18,5,0,0
2198,user_2198,12433,144,88,56,May-19,0,1,1
2199,user_2199,2394,80,44,36,Apr-19,1,1,0
2200,user_2200,19586,308,305,3,Feb-19,3,0,0
2201,user_2201,2486,54,20,34,Apr-19,1,1,0
2202,user_2202,1917,89,30,59,Apr-19,1,1,0
2203,user_2203,2228,11,11,0,Aug-18,9,0,0
2204,user_2204,7223,74,74,0,Jul-18,10,0,0
2205,user_2205,9,2,2,0,Jul-18,10,0,0
2206,user_2206,2195,104,104,0,Dec-18,5,0,0
2207,user_2207,483,55,37,18,Apr-19,1,1,0
2208,user_2208,1525,30,19,11,Mar-19,2,0,0
2209,user_2209,14907,253,192,61,Apr-19,1,1,0
2210,user_2210,18644,1429,920,509,May-19,0,1,1
2211,user_2211,27170,427,417,10,May-19,0,1,1
2212,user_2212,85,1,1,0,Apr-18,13,0,0
2213,user_2213,22322,231,227,4,Jan-19,4,0,0
2214,user_2214,9,1,1,0,Mar-18,14,0,0
2215,user_2215,730,16,13,3,Apr-19,1,1,0
2216,user_2216,5793,56,41,15,Mar-19,2,0,0
2217,user_2217,3009,33,15,18,Apr-19,1,1,0
2218,user_2218,20741,292,198,94,May-19,0,1,1
2219,user_2219,34781,237,232,5,Apr-19,1,1,0
2220,user_2220,3091,66,66,0,Oct-18,7,0,0
2221,user_2221,4428,73,6,67,May-19,0,1,1
2222,user_2222,431,52,9,43,May-19,0,1,1
2223,user_2223,40926,281,209,72,Apr-19,1,1,0
2224,user_2224,1522,55,55,0,Oct-18,7,0,0
2225,user_2225,43,7,7,0,Dec-18,5,0,0
2226,user_2226,19,7,7,0,Nov-18,6,0,0
2227,user_2227,12673,540,376,164,May-19,0,1,1
2228,user_2228,1765,89,63,26,May-19,0,1,1
2229,user_2229,753,63,12,51,Mar-19,2,0,0
2230,user_2230,7554,602,576,26,May-19,0,1,1
2231,user_2231,11532,207,99,108,Apr-19,1,1,0
2232,user_2232,242,26,26,0,Jul-18,10,0,0
2233,user_2233,17846,210,161,49,May-19,0,1,1
2234,user_2234,1103,50,50,0,Dec-18,5,0,0
2235,user_2235,190,7,7,0,Dec-18,5,0,0
2236,user_2236,13106,590,438,152,May-19,0,1,1
2237,user_2237,80944,806,425,381,May-19,0,1,1
2238,user_2238,5053,125,61,64,May-19,0,1,1
2239,user_2239,115587,54,47,7,Mar-19,2,0,0
2240,user_2240,8891,31,29,2,Jan-19,4,0,0
2241,user_2241,6636,148,139,9,Mar-19,2,0,0
2242,user_2242,33493,1310,875,435,May-19,0,1,1
2244,user_2244,3581,5,5,0,Mar-18,14,0,0
2245,user_2245,4003,99,72,27,Mar-19,2,0,0
2246,user_2246,2527,91,75,16,May-19,0,1,1
2247,user_2247,6958,118,79,39,Apr-19,1,1,0
2248,user_2248,51037,75,60,15,Apr-19,1,1,0
2249,user_2249,37469,891,763,128,May-19,0,1,1
2250,user_2250,238,18,17,1,Apr-19,1,1,0
2251,user_2251,18890,255,138,117,May-19,0,1,1
2252,user_2252,7246,62,37,25,May-19,0,1,1
2253,user_2253,63308,115,85,30,Mar-19,2,0,0
2254,user_2254,50,5,5,0,Mar-18,14,0,0
2255,user_2255,10772,529,235,294,May-19,0,1,1
2256,user_2256,29,4,4,0,Mar-18,14,0,0
2257,user_2257,15417,216,197,19,May-19,0,1,1
2258,user_2258,611,19,19,0,Sep-18,8,0,0
2259,user_2259,26,5,5,0,Jul-18,10,0,0
2260,user_2260,18649,95,62,33,May-19,0,1,1
2261,user_2261,2889,35,34,1,May-19,0,0,1
2262,user_2262,3931,24,24,0,May-18,12,0,0
2263,user_2263,97558,190,48,142,May-19,0,1,1
2264,user_2264,3289,73,73,0,Jun-18,11,0,0
2265,user_2265,3260,200,122,78,May-19,0,1,1
2266,user_2266,20353,501,435,66,May-19,0,1,1
2267,user_2267,16099,457,415,42,Apr-19,1,1,0
2268,user_2268,92,16,16,0,Nov-18,6,0,0
2269,user_2269,6046,139,79,60,May-19,0,1,1
2270,user_2270,850,66,26,40,May-19,0,0,1
2271,user_2271,243,94,71,23,May-19,0,1,1
2272,user_2272,4451,101,41,60,May-19,0,1,1
2273,user_2273,8175,838,628,210,May-19,0,1,1
2274,user_2274,4858,123,100,23,May-19,0,1,1
2275,user_2275,1930,62,60,2,Mar-19,2,0,0
2276,user_2276,2363,196,183,13,Jan-19,4,0,0
2277,user_2277,3319,42,33,9,Apr-19,1,1,0
2278,user_2278,14388,152,118,34,Mar-19,2,0,0
2279,user_2279,17564,283,135,148,May-19,0,1,1
2280,user_2280,5334,373,174,199,May-19,0,1,1
2281,user_2281,2250,54,46,8,Mar-19,2,0,0
2282,user_2282,4365,96,66,30,May-19,0,1,1
2283,user_2283,337,8,8,0,Mar-18,14,0,0
2284,user_2284,13366,403,394,9,Feb-19,3,0,0
2285,user_2285,168,4,4,0,May-18,12,0,0
2286,user_2286,1033,16,7,9,May-19,0,1,1
2287,user_2287,772,16,5,11,Apr-19,1,1,0
2288,user_2288,5869,95,63,32,Apr-19,1,1,0
2289,user_2289,26966,1116,752,364,May-19,0,1,1
2290,user_2290,23941,710,470,240,May-19,0,1,1
2292,user_2292,6505,53,32,21,May-19,0,1,1
2293,user_2293,96,14,12,2,Mar-19,2,0,0
2294,user_2294,29642,134,122,12,May-19,0,1,1
2295,user_2295,1524,111,65,46,May-19,0,1,1
2296,user_2296,1010,35,35,0,Dec-18,5,0,0
2297,user_2297,8245,201,144,57,May-19,0,1,1
2298,user_2298,18,3,3,0,May-18,12,0,0
2299,user_2299,76,7,7,0,Mar-18,14,0,0
2300,user_2300,1211,70,60,10,Apr-19,1,1,0
2301,user_2301,47268,1535,1170,365,May-19,0,1,1
2302,user_2302,65,11,11,0,Jul-18,10,0,0
2303,user_2303,2418,73,64,9,Feb-19,3,0,0
2304,user_2304,15,6,6,0,Dec-18,5,0,0
2305,user_2305,187,33,20,13,May-19,0,1,1
2306,user_2306,15771,148,106,42,May-19,0,1,1
2307,user_2307,9134,357,238,119,May-19,0,1,1
2308,user_2308,13316,540,382,158,May-19,0,1,1
2309,user_2309,4773,158,114,44,May-19,0,1,1
2310,user_2310,18955,292,149,143,May-19,0,1,1
2311,user_2311,481,10,10,0,Mar-18,14,0,0
2312,user_2312,2090,97,50,47,May-19,0,1,1
2313,user_2313,7263,309,264,45,May-19,0,1,1
2314,user_2314,3796,218,72,146,May-19,0,1,1
2315,user_2315,11,2,2,0,Mar-18,14,0,0
2316,user_2316,2222,26,26,0,May-18,12,0,0
2317,user_2317,8067,176,164,12,Apr-19,1,1,0
2318,user_2318,16549,465,304,161,May-19,0,1,1
2319,user_2319,4406,427,360,67,May-19,0,1,1
2320,user_2320,3917,71,71,0,Nov-18,6,0,0
2321,user_2321,14377,283,183,100,May-19,0,1,1
2322,user_2322,8194,337,171,166,May-19,0,1,1
2323,user_2323,3102,56,52,4,Jan-19,4,0,0
2324,user_2324,8564,421,279,142,May-19,0,1,1
2325,user_2325,2509,11,4,7,May-19,0,0,1
2326,user_2326,9,2,2,0,Mar-18,14,0,0
2327,user_2327,17138,505,423,82,May-19,0,1,1
2328,user_2328,1028,89,79,10,Feb-19,3,0,0
2329,user_2329,11971,249,240,9,Mar-19,2,0,0
2330,user_2330,3370,218,47,171,Apr-19,1,1,0
2331,user_2331,23375,304,263,41,May-19,0,1,1
2332,user_2332,3764,174,163,11,Mar-19,2,0,0
2333,user_2333,17996,24,8,16,Apr-19,1,1,0
2334,user_2334,1347,21,21,0,Jun-18,11,0,0
2335,user_2335,524,13,11,2,Jan-19,4,0,0
2336,user_2336,739,10,10,0,Jun-18,11,0,0
2337,user_2337,10699,215,151,64,May-19,0,1,1
2338,user_2338,32257,1231,797,434,May-19,0,1,1
2339,user_2339,63090,29,27,2,Apr-19,1,1,0
2340,user_2340,3592,61,42,19,May-19,0,1,1
2341,user_2341,5620,161,94,67,Apr-19,1,1,0
2342,user_2342,1856,101,66,35,May-19,0,1,1
2343,user_2343,70516,2340,1367,973,May-19,0,1,1
2344,user_2344,8761,20,13,7,May-19,0,0,1
2345,user_2345,35247,1016,959,57,May-19,0,1,1
2346,user_2346,7473,365,247,118,May-19,0,1,1
2347,user_2347,4400,119,102,17,May-19,0,1,1
2348,user_2348,15424,89,53,36,Apr-19,1,1,0
2349,user_2349,608,37,25,12,May-19,0,1,1
2350,user_2350,6199,406,34,372,May-19,0,1,1
2351,user_2351,167,9,0,9,May-19,0,0,1
2352,user_2352,7276,253,193,60,Apr-19,1,1,0
2353,user_2353,582,6,6,0,Jul-18,10,0,0
2354,user_2354,271,3,3,0,Sep-18,8,0,0
2355,user_2355,5674,42,42,0,Dec-18,5,0,0
2356,user_2356,4050,52,37,15,Apr-19,1,1,0
2357,user_2357,80962,144,100,44,Apr-19,1,1,0
2358,user_2358,120267,125,96,29,May-19,0,1,1
2359,user_2359,20832,76,71,5,Apr-19,1,1,0
2360,user_2360,212,21,20,1,Apr-19,1,1,0
2361,user_2361,50392,538,395,143,May-19,0,1,1
2362,user_2362,4510,255,172,83,Apr-19,1,1,0
2363,user_2363,2407,329,209,120,May-19,0,1,1
2364,user_2364,501,15,6,9,Jan-19,4,0,0
2365,user_2365,1221,336,229,107,May-19,0,1,1
2366,user_2366,2,2,2,0,Mar-18,14,0,0
2367,user_2367,2620,223,187,36,May-19,0,1,1
2368,user_2368,6593,491,335,156,May-19,0,1,1
2369,user_2369,24754,559,496,63,May-19,0,1,1
2370,user_2370,21,3,3,0,May-18,12,0,0
2371,user_2371,136,13,13,0,Apr-18,13,0,0
2372,user_2372,2013,172,114,58,May-19,0,1,1
2373,user_2373,21179,404,236,168,May-19,0,1,1
2374,user_2374,1408,52,32,20,May-19,0,0,1
2375,user_2375,19459,358,293,65,Apr-19,1,1,0
2376,user_2376,23781,244,191,53,Apr-19,1,1,0
2377,user_2377,367,4,4,0,Jul-18,10,0,0
2378,user_2378,10244,340,269,71,May-19,0,1,1
2379,user_2379,280633,563,432,131,May-19,0,1,1
2380,user_2380,4228,103,30,73,Apr-19,1,1,0
2381,user_2381,5797,23,18,5,Feb-19,3,0,0
2382,user_2382,337,31,8,23,Feb-19,3,0,0
2383,user_2383,1017,14,14,0,Aug-18,9,0,0
2384,user_2384,16885,479,403,76,May-19,0,1,1
2385,user_2385,874,9,9,0,Dec-18,5,0,0
2386,user_2386,17541,406,395,11,Apr-19,1,1,0
2387,user_2387,13264,104,77,27,Apr-19,1,1,0
2388,user_2388,694,62,62,0,Jul-18,10,0,0
2390,user_2390,1666,41,19,22,May-19,0,1,1
2391,user_2391,9183,86,75,11,Mar-19,2,0,0
2392,user_2392,2207,111,33,78,May-19,0,1,1
2393,user_2393,15422,115,69,46,Apr-19,1,1,0
2394,user_2394,1766,52,36,16,Apr-19,1,1,0
2395,user_2395,11589,86,73,13,Apr-19,1,1,0
2396,user_2396,31777,554,475,79,Apr-19,1,1,0
2397,user_2397,5722,199,111,88,Mar-19,2,0,0
2398,user_2398,5303,148,86,62,May-19,0,1,1
2399,user_2399,1062,29,20,9,Apr-19,1,1,0
2400,user_2400,13700,133,78,55,May-19,0,1,1
2401,user_2401,6377,476,336,140,May-19,0,1,1
2402,user_2402,7748,77,53,24,Mar-19,2,0,0
2403,user_2403,1596,32,27,5,Apr-19,1,1,0
2404,user_2404,1603,102,39,63,Mar-19,2,0,0
2405,user_2405,176,20,9,11,Apr-19,1,1,0
2406,user_2406,1952,21,21,0,Apr-18,13,0,0
2407,user_2407,262,56,4,52,Apr-19,1,1,0
2409,user_2409,6728,75,75,0,Nov-18,6,0,0
2410,user_2410,6072,70,21,49,May-19,0,0,1
2411,user_2411,26445,788,569,219,May-19,0,1,1
2412,user_2412,1248,181,151,30,May-19,0,1,1
2413,user_2413,7172,406,198,208,May-19,0,1,1
2414,user_2414,1771,53,43,10,May-19,0,1,1
2415,user_2415,5478,10,10,0,Jun-18,11,0,0
2416,user_2416,3575,103,79,24,Apr-19,1,1,0
2417,user_2417,21,3,3,0,Mar-18,14,0,0
2418,user_2418,14187,439,230,209,May-19,0,1,1
2419,user_2419,4,1,0,1,Mar-19,2,0,0
2420,user_2420,2218,139,95,44,Apr-19,1,1,0
2421,user_2421,10,3,3,0,Mar-18,14,0,0
2422,user_2422,5558,77,77,0,Dec-18,5,0,0
2423,user_2423,16563,212,96,116,May-19,0,1,1
2424,user_2424,3659,68,37,31,May-19,0,0,1
2425,user_2425,33,5,5,0,Apr-18,13,0,0
2426,user_2426,7417,117,69,48,Apr-19,1,1,0
2427,user_2427,208,8,6,2,Jan-19,4,0,0
2428,user_2428,13469,112,61,51,May-19,0,1,1
2429,user_2429,16802,476,205,271,May-19,0,1,1
2430,user_2430,4833,139,111,28,May-19,0,0,1
2431,user_2431,1043,55,12,43,May-19,0,1,1
2432,user_2432,9013,57,56,1,Jan-19,4,0,0
2433,user_2433,11853,628,567,61,Apr-19,1,1,0
2434,user_2434,3779,98,59,39,Apr-19,1,1,0
2435,user_2435,2625,51,44,7,Apr-19,1,1,0
2436,user_2436,11355,159,114,45,May-19,0,1,1
2437,user_2437,2543,114,78,36,May-19,0,1,1
2438,user_2438,541,42,6,36,May-19,0,1,1
2439,user_2439,64506,182,103,79,Mar-19,2,0,0
2440,user_2440,2103,28,24,4,Feb-19,3,0,0
2441,user_2441,86,4,4,0,Sep-18,8,0,0
2442,user_2442,6106,234,180,54,May-19,0,1,1
2443,user_2443,896,14,13,1,Jan-19,4,0,0
2444,user_2444,3548,52,39,13,May-19,0,0,1
2445,user_2445,8398,91,81,10,Jan-19,4,0,0
2446,user_2446,7942,176,131,45,May-19,0,1,1
2447,user_2447,500,67,55,12,Apr-19,1,1,0
2448,user_2448,1992,43,40,3,Jan-19,4,0,0
2449,user_2449,244,14,10,4,Apr-19,1,1,0
2450,user_2450,861,40,37,3,Mar-19,2,0,0
2451,user_2451,987,188,103,85,May-19,0,1,1
2452,user_2452,1274,38,8,30,May-19,0,1,1
2453,user_2453,792,36,36,0,Jun-18,11,0,0
2454,user_2454,865505,395,318,77,May-19,0,1,1
2455,user_2455,3968,153,38,115,May-19,0,1,1
2456,user_2456,11158,187,100,87,May-19,0,1,1
2457,user_2457,5578,42,31,11,Mar-19,2,0,0
2458,user_2458,1617,38,29,9,Apr-19,1,1,0
2459,user_2459,69045,403,352,51,May-19,0,1,1
2460,user_2460,8,2,2,0,Mar-18,14,0,0
2461,user_2461,3,2,2,0,Jun-18,11,0,0
2462,user_2462,1042,27,5,22,Apr-19,1,1,0
2463,user_2463,530,14,3,11,Mar-19,2,0,0
2464,user_2464,180,4,4,0,Dec-18,5,0,0
2465,user_2465,37549,260,157,103,May-19,0,1,1
2466,user_2466,2703,64,14,50,Mar-19,2,0,0
2467,user_2467,853,112,88,24,Apr-19,1,1,0
2468,user_2468,4,5,5,0,Mar-18,14,0,0
2469,user_2469,622,15,15,0,Apr-18,13,0,0
2470,user_2470,1302,76,71,5,Mar-19,2,0,0
2471,user_2471,1890,228,153,75,May-19,0,1,1
2472,user_2472,840,27,27,0,Mar-18,14,0,0
2473,user_2473,4876,50,22,28,Apr-19,1,1,0
2474,user_2474,16828,279,110,169,May-19,0,1,1
2475,user_2475,26885,294,198,96,Apr-19,1,1,0
2476,user_2476,63,6,6,0,Jun-18,11,0,0
2477,user_2477,10117,72,54,18,Apr-19,1,1,0
2478,user_2478,1380,64,38,26,Apr-19,1,1,0
2479,user_2479,8051,97,73,24,Apr-19,1,1,0
2480,user_2480,1298,37,37,0,Apr-18,13,0,0
2481,user_2481,95577,204,117,87,May-19,0,1,1
2482,user_2482,2510,29,15,14,May-19,0,0,1
2483,user_2483,7001,236,113,123,May-19,0,1,1
2484,user_2484,817,24,24,0,Jun-18,11,0,0
2485,user_2485,3690,44,17,27,May-19,0,1,1
2486,user_2486,8059,274,165,109,May-19,0,1,1
2487,user_2487,1143,85,63,22,Apr-19,1,1,0
2488,user_2488,3903,86,68,18,Apr-19,1,1,0
2489,user_2489,3428,162,134,28,Apr-19,1,1,0
2490,user_2490,5149,333,218,115,May-19,0,1,1
2491,user_2491,535,84,47,37,May-19,0,1,1
2492,user_2492,903,51,37,14,May-19,0,1,1
2493,user_2493,31786,164,118,46,Apr-19,1,1,0
2494,user_2494,2327,161,104,57,May-19,0,1,1
2495,user_2495,739,28,28,0,Aug-18,9,0,0
2496,user_2496,4705,181,143,38,May-19,0,1,1
2497,user_2497,10580,90,52,38,May-19,0,1,1
2498,user_2498,38506,180,180,0,Dec-18,5,0,0
2499,user_2499,3210,176,96,80,May-19,0,1,1
2500,user_2500,1424,49,49,0,Sep-18,8,0,0
2501,user_2501,33286,891,661,230,May-19,0,1,1
2502,user_2502,12130,394,186,208,May-19,0,1,1
2503,user_2503,13952,166,117,49,May-19,0,1,1
2504,user_2504,4148,146,79,67,May-19,0,1,1
2505,user_2505,1211,47,17,30,Apr-19,1,1,0
2506,user_2506,10,5,5,0,Mar-18,14,0,0
2507,user_2507,20811,229,182,47,Apr-19,1,1,0
2508,user_2508,2085,50,34,16,Apr-19,1,1,0
2509,user_2509,5645,148,73,75,May-19,0,1,1
2510,user_2510,3132,50,31,19,May-19,0,1,1
2511,user_2511,21728,502,381,121,May-19,0,1,1
2512,user_2512,1755,24,17,7,Apr-19,1,1,0
2513,user_2513,109,37,11,26,Apr-19,1,1,0
2514,user_2514,1805,18,9,9,Mar-19,2,0,0
2515,user_2515,6129,106,106,0,Jun-18,11,0,0
2516,user_2516,9,2,2,0,Mar-18,14,0,0
2517,user_2517,1073,41,40,1,Apr-19,1,1,0
2518,user_2518,729,39,37,2,May-19,0,0,1
2519,user_2519,3848,247,123,124,May-19,0,1,1
2520,user_2520,191,15,15,0,Aug-18,9,0,0
2521,user_2521,35362,923,540,383,May-19,0,1,1
2522,user_2522,7008,145,101,44,May-19,0,1,1
2523,user_2523,1853,47,47,0,Aug-18,9,0,0
2524,user_2524,6408,255,162,93,May-19,0,1,1
2525,user_2525,38652,307,201,106,May-19,0,1,1
2527,user_2527,23435,1315,786,529,May-19,0,1,1
2528,user_2528,8972,288,260,28,May-19,0,1,1
2529,user_2529,4582,84,20,64,May-19,0,1,1
2530,user_2530,5391,49,25,24,Apr-19,1,1,0
2531,user_2531,11801,384,338,46,Feb-19,3,0,0
2532,user_2532,776,10,8,2,Feb-19,3,0,0
2533,user_2533,1411,25,25,0,Jun-18,11,0,0
2534,user_2534,18217,536,363,173,May-19,0,1,1
2535,user_2535,987,41,33,8,Apr-19,1,1,0
2536,user_2536,5248,180,141,39,Apr-19,1,1,0
2537,user_2537,1654,17,17,0,Oct-18,7,0,0
2538,user_2538,18,3,3,0,Apr-18,13,0,0
2539,user_2539,6983,130,123,7,Jan-19,4,0,0
2540,user_2540,14,3,3,0,Mar-18,14,0,0
2541,user_2541,14549,159,75,84,May-19,0,1,1
2542,user_2542,505,15,15,0,Apr-18,13,0,0
2543,user_2543,627,55,29,26,Mar-19,2,0,0
2544,user_2544,32038,103,66,37,May-19,0,1,1
2545,user_2545,103,14,2,12,Mar-19,2,0,0
2546,user_2546,11,2,2,0,Mar-18,14,0,0
2547,user_2547,3621,120,51,69,May-19,0,1,1
2548,user_2548,62,16,14,2,Apr-19,1,1,0
2549,user_2549,43210,183,81,102,May-19,0,1,1
2550,user_2550,304,27,3,24,May-19,0,1,1
2552,user_2552,1295,32,27,5,Feb-19,3,0,0
2553,user_2553,11284,126,52,74,Apr-19,1,1,0
2554,user_2554,21329,1595,1086,509,May-19,0,1,1
2556,user_2556,1245,21,11,10,May-19,0,1,1
2557,user_2557,8784,262,217,45,May-19,0,1,1
2558,user_2558,1433,12,2,10,Apr-19,1,1,0
2559,user_2559,547,41,32,9,Apr-19,1,1,0
2560,user_2560,11771,356,271,85,May-19,0,1,1
2561,user_2561,278,35,18,17,Apr-19,1,1,0
2562,user_2562,104,16,16,0,Jul-18,10,0,0
2563,user_2563,1986,41,29,12,Feb-19,3,0,0
2564,user_2564,2169,31,16,15,May-19,0,0,1
2565,user_2565,1511,4,2,2,Apr-19,1,1,0
2566,user_2566,167345,320,165,155,May-19,0,1,1
2567,user_2567,3494,52,33,19,Apr-19,1,1,0
2568,user_2568,9,1,1,0,Mar-18,14,0,0
2569,user_2569,18,5,0,5,Mar-19,2,0,0
2570,user_2570,96,9,9,0,Aug-18,9,0,0
2571,user_2571,40203,460,301,159,May-19,0,1,1
2572,user_2572,381,12,9,3,Jan-19,4,0,0
2573,user_2573,14544,92,80,12,May-19,0,1,1
2574,user_2574,1675,198,91,107,May-19,0,1,1
2575,user_2575,6219,27,21,6,Feb-19,3,0,0
2576,user_2576,9652,88,63,25,May-19,0,1,1
2577,user_2577,5,6,6,0,Mar-18,14,0,0
2578,user_2578,960,103,82,21,May-19,0,1,1
2579,user_2579,79,12,12,0,Oct-18,7,0,0
2580,user_2580,3685,118,90,28,May-19,0,1,1
2581,user_2581,13490,302,223,79,May-19,0,1,1
2582,user_2582,121,10,10,0,Jun-18,11,0,0
2583,user_2583,7188,481,481,0,Dec-18,5,0,0
2584,user_2584,70,6,5,1,Feb-19,3,0,0
2585,user_2585,248,10,10,0,Dec-18,5,0,0
2586,user_2586,5334,92,55,37,May-19,0,0,1
2587,user_2587,381,15,15,0,Oct-18,7,0,0
2588,user_2588,61,4,4,0,Apr-18,13,0,0
2589,user_2589,21,3,3,0,Jul-18,10,0,0
2590,user_2590,24442,448,337,111,May-19,0,1,1
2591,user_2591,8589,135,75,60,May-19,0,1,1
2592,user_2592,477,15,11,4,Apr-19,1,1,0
2593,user_2593,48008,671,250,421,May-19,0,1,1
2594,user_2594,4,2,2,0,Jun-18,11,0,0
2595,user_2595,124,9,9,0,Mar-18,14,0,0
2596,user_2596,18080,326,326,0,Dec-18,5,0,0
2597,user_2597,851,59,30,29,Apr-19,1,1,0
2598,user_2598,9505,336,225,111,Apr-19,1,1,0
2600,user_2600,8,3,3,0,Mar-18,14,0,0
2601,user_2601,14148,671,430,241,May-19,0,1,1
2602,user_2602,7582,84,82,2,Apr-19,1,1,0
2603,user_2603,80,7,0,7,Apr-19,1,1,0
2604,user_2604,103,8,6,2,Apr-19,1,1,0
2605,user_2605,3605,144,71,73,May-19,0,1,1
2606,user_2606,4350,833,587,246,May-19,0,1,1
2607,user_2607,4739,128,112,16,Jan-19,4,0,0
2608,user_2608,20642,516,228,288,May-19,0,1,1
2609,user_2609,3292,62,7,55,Apr-19,1,1,0
2610,user_2610,5480,151,93,58,Apr-19,1,1,0
2611,user_2611,8479,47,36,11,Apr-19,1,1,0
2612,user_2612,93,5,5,0,Apr-18,13,0,0
2613,user_2613,7806,293,242,51,May-19,0,1,1
2614,user_2614,7988,231,178,53,May-19,0,1,1
2615,user_2615,919,17,4,13,May-19,0,1,1
2616,user_2616,4418,131,84,47,May-19,0,1,1
2617,user_2617,42,8,2,6,May-19,0,0,1
2618,user_2618,3100,30,30,0,Sep-18,8,0,0
2619,user_2619,35,3,3,0,Jul-18,10,0,0
2620,user_2620,3935,90,37,53,Mar-19,2,0,0
2621,user_2621,37952,664,456,208,May-19,0,1,1
2622,user_2622,780,24,19,5,Apr-19,1,1,0
2623,user_2623,6088,138,75,63,May-19,0,1,1
2624,user_2624,44,5,5,0,Mar-18,14,0,0
2625,user_2625,2605,130,78,52,May-19,0,1,1
2626,user_2626,8981,429,235,194,May-19,0,1,1
2627,user_2627,303,6,6,0,May-18,12,0,0
2628,user_2628,41,4,4,0,Mar-18,14,0,0
2629,user_2629,616,25,14,11,Mar-19,2,0,0
2630,user_2630,2936,98,79,19,Mar-19,2,0,0
2631,user_2631,1006,32,21,11,Mar-19,2,0,0
2632,user_2632,13626,338,246,92,Apr-19,1,1,0
2633,user_2633,250,15,6,9,Apr-19,1,1,0
2634,user_2634,1393,35,34,1,Apr-19,1,1,0
2635,user_2635,2897,172,156,16,May-19,0,1,1
2636,user_2636,990,41,3,38,Apr-19,1,1,0
2637,user_2637,701,43,35,8,Mar-19,2,0,0
2638,user_2638,12296,147,99,48,May-19,0,1,1
2639,user_2639,5001,187,135,52,May-19,0,0,1
2640,user_2640,5022,126,93,33,May-19,0,1,1
2641,user_2641,7225,499,72,427,May-19,0,1,1
2642,user_2642,9412,178,155,23,Mar-19,2,0,0
2643,user_2643,3119,173,170,3,Mar-19,2,0,0
2644,user_2644,13535,596,111,485,Apr-19,1,1,0
2645,user_2645,4944,184,79,105,May-19,0,1,1
2646,user_2646,319,14,8,6,Apr-19,1,1,0
2647,user_2647,1642,139,75,64,May-19,0,1,1
2648,user_2648,370,52,24,28,Apr-19,1,1,0
2649,user_2649,2284,135,127,8,May-19,0,0,1
2650,user_2650,14,2,2,0,Mar-18,14,0,0
2651,user_2651,6705,330,261,69,Apr-19,1,1,0
2652,user_2652,2207,21,20,1,Apr-19,1,1,0
2653,user_2653,499,30,19,11,May-19,0,1,1
2654,user_2654,5885,242,173,69,May-19,0,1,1
2655,user_2655,1933,142,122,20,May-19,0,0,1
2656,user_2656,3204,69,69,0,Nov-18,6,0,0
2657,user_2657,5817,623,505,118,Mar-19,2,0,0
2658,user_2658,3695,90,78,12,Apr-19,1,1,0
2659,user_2659,21637,517,317,200,May-19,0,1,1
2660,user_2660,13800,501,312,189,May-19,0,1,1
2661,user_2661,7548,92,89,3,Mar-19,2,0,0
2662,user_2662,12075,113,89,24,May-19,0,0,1
2663,user_2663,8056,131,92,39,Jan-19,4,0,0
2664,user_2664,7734,215,143,72,May-19,0,1,1
2665,user_2665,1386,140,125,15,May-19,0,1,1
2666,user_2666,2522,43,0,43,May-19,0,1,1
2667,user_2667,6682,260,121,139,May-19,0,1,1
2668,user_2668,79989,336,161,175,May-19,0,1,1
2669,user_2669,10831,72,60,12,Apr-19,1,1,0
2670,user_2670,4408,58,24,34,Apr-19,1,1,0
2671,user_2671,3449,182,160,22,May-19,0,1,1
2672,user_2672,6532,210,107,103,May-19,0,1,1
2673,user_2673,12042,244,209,35,May-19,0,1,1
2674,user_2674,1358,216,115,101,May-19,0,1,1
2675,user_2675,3008,121,119,2,Feb-19,3,0,0
2676,user_2676,2388,164,43,121,May-19,0,1,1
2678,user_2678,280,9,9,0,Jun-18,11,0,0
2679,user_2679,7363,116,60,56,May-19,0,1,1
2680,user_2680,4335,103,48,55,Apr-19,1,1,0
2681,user_2681,254,4,4,0,May-18,12,0,0
2682,user_2682,805,25,19,6,Apr-19,1,1,0
2683,user_2683,5361,181,112,69,Apr-19,1,1,0
2684,user_2684,11337,24,24,0,Apr-18,13,0,0
2685,user_2685,25224,78,66,12,Apr-19,1,1,0
2686,user_2686,8789,143,134,9,May-19,0,0,1
2687,user_2687,12961,136,125,11,Mar-19,2,0,0
2688,user_2688,218,17,1,16,Mar-19,2,0,0
2689,user_2689,2343,110,33,77,May-19,0,1,1
2690,user_2690,9672,340,123,217,May-19,0,1,1
2691,user_2691,470,12,12,0,Nov-18,6,0,0
2692,user_2692,57,4,4,0,Mar-18,14,0,0
2693,user_2693,79061,211,153,58,May-19,0,1,1
2694,user_2694,12250,700,325,375,May-19,0,1,1
2695,user_2695,1927,163,107,56,May-19,0,1,1
2696,user_2696,5512,151,150,1,Jan-19,4,0,0
2697,user_2697,26146,450,418,32,May-19,0,0,1
2698,user_2698,9345,171,114,57,May-19,0,1,1
2699,user_2699,188,4,4,0,Jul-18,10,0,0
2700,user_2700,2075,95,77,18,Jan-19,4,0,0
2701,user_2701,2915,143,92,51,May-19,0,1,1
2702,user_2702,1780,27,27,0,Oct-18,7,0,0
2703,user_2703,1584,51,29,22,Jan-19,4,0,0
2704,user_2704,812,56,34,22,Apr-19,1,1,0
2705,user_2705,23019,334,132,202,May-19,0,1,1
2706,user_2706,14494,166,71,95,May-19,0,1,1
2707,user_2707,1505,47,12,35,Apr-19,1,1,0
2709,user_2709,3686,10,7,3,Feb-19,3,0,0
2710,user_2710,7713,218,183,35,Mar-19,2,0,0
2711,user_2711,723,88,88,0,Dec-18,5,0,0
2712,user_2712,36526,524,418,106,May-19,0,1,1
2713,user_2713,393,26,22,4,Mar-19,2,0,0
2714,user_2714,13906,238,145,93,May-19,0,1,1
2715,user_2715,384,38,22,16,May-19,0,0,1
2716,user_2716,2346,109,57,52,Apr-19,1,1,0
2717,user_2717,17401,835,450,385,May-19,0,1,1
2718,user_2718,2272,114,77,37,Apr-19,1,1,0
2719,user_2719,103844,119,109,10,May-19,0,1,1
2720,user_2720,15948,194,137,57,May-19,0,1,1
2721,user_2721,61828,1272,769,503,May-19,0,1,1
2722,user_2722,8,2,2,0,Mar-18,14,0,0
2723,user_2723,167,12,12,0,Sep-18,8,0,0
2724,user_2724,19398,428,222,206,May-19,0,1,1
2725,user_2725,52,3,3,0,Mar-18,14,0,0
2726,user_2726,9333,188,133,55,May-19,0,1,1
2727,user_2727,3749,87,48,39,May-19,0,1,1
2728,user_2728,18,3,0,3,Apr-19,1,1,0
2729,user_2729,50680,968,565,403,May-19,0,1,1
2730,user_2730,30456,679,398,281,May-19,0,1,1
2731,user_2731,9,2,2,0,Mar-18,14,0,0
2732,user_2732,4,2,2,0,Mar-18,14,0,0
2733,user_2733,4720,221,58,163,May-19,0,1,1
2734,user_2734,54,9,9,0,Sep-18,8,0,0
2735,user_2735,290,18,18,0,Aug-18,9,0,0
2736,user_2736,4,6,6,0,Mar-18,14,0,0
2737,user_2737,3014,54,37,17,Mar-19,2,0,0
2738,user_2738,1568,9,6,3,Feb-19,3,0,0
2739,user_2739,1271,47,20,27,Apr-19,1,1,0
2740,user_2740,45665,160,106,54,May-19,0,1,1
2741,user_2741,8317,143,130,13,Mar-19,2,0,0
2742,user_2742,9726,9,2,7,Mar-19,2,0,0
2743,user_2743,21,3,3,0,Aug-18,9,0,0
2744,user_2744,508,27,26,1,Feb-19,3,0,0
2745,user_2745,6440,119,91,28,May-19,0,1,1
2746,user_2746,1769,47,47,0,Sep-18,8,0,0
2747,user_2747,18053,95,0,95,Apr-19,1,1,0
2748,user_2748,43,2,2,0,Jun-18,11,0,0
2749,user_2749,8262,63,63,0,Dec-18,5,0,0
2750,user_2750,11846,210,188,22,Apr-19,1,1,0
2751,user_2751,6767,300,200,100,May-19,0,1,1
2752,user_2752,89926,2053,1298,755,May-19,0,1,1
2753,user_2753,825,28,22,6,Apr-19,1,1,0
2754,user_2754,6469,113,100,13,May-19,0,1,1
2755,user_2755,43,2,2,0,Mar-18,14,0,0
2756,user_2756,30,10,8,2,Apr-19,1,1,0
2757,user_2757,1018,16,14,2,Mar-19,2,0,0
2758,user_2758,13372,1006,651,355,May-19,0,1,1
2759,user_2759,3642,49,9,40,May-19,0,1,1
2760,user_2760,2018,12,12,0,Mar-18,14,0,0
2761,user_2761,9,3,3,0,Mar-18,14,0,0
2762,user_2762,6389,304,172,132,May-19,0,1,1
2763,user_2763,3639,76,59,17,May-19,0,1,1
2764,user_2764,2426,57,48,9,May-19,0,1,1
2765,user_2765,2471,7,7,0,Apr-18,13,0,0
2766,user_2766,4495,62,62,0,Nov-18,6,0,0
2767,user_2767,1340,31,31,0,Jun-18,11,0,0
2768,user_2768,11231,120,85,35,Mar-19,2,0,0
2769,user_2769,29352,100,86,14,May-19,0,1,1
2770,user_2770,6000,49,49,0,Dec-18,5,0,0
2771,user_2771,57024,1054,737,317,Apr-19,1,1,0
2772,user_2772,22803,366,116,250,May-19,0,1,1
2773,user_2773,6520,285,220,65,May-19,0,0,1
2774,user_2774,1748,54,38,16,May-19,0,1,1
2775,user_2775,4671,188,150,38,May-19,0,1,1
2776,user_2776,2885,64,36,28,May-19,0,1,1
2777,user_2777,1785,66,61,5,Mar-19,2,0,0
2778,user_2778,53524,720,519,201,May-19,0,1,1
2779,user_2779,5,6,4,2,Mar-19,2,0,0
2780,user_2780,18,3,3,0,Jul-18,10,0,0
2781,user_2781,25988,836,737,99,May-19,0,1,1
2782,user_2782,3308,103,61,42,May-19,0,1,1
2783,user_2783,3,3,3,0,Mar-18,14,0,0
2784,user_2784,3006,103,8,95,May-19,0,1,1
2785,user_2785,15959,35,25,10,Mar-19,2,0,0
2786,user_2786,12728,219,219,0,Sep-18,8,0,0
2787,user_2787,20747,190,138,52,May-19,0,1,1
2788,user_2788,20,4,4,0,Jul-18,10,0,0
2789,user_2789,23486,387,264,123,May-19,0,1,1
2790,user_2790,8328,104,65,39,May-19,0,1,1
2791,user_2791,34883,387,312,75,May-19,0,1,1
2792,user_2792,1001,31,25,6,May-19,0,1,1
2793,user_2793,363,3,3,0,Mar-18,14,0,0
2794,user_2794,1020,73,50,23,Apr-19,1,1,0
2795,user_2795,20119,134,120,14,Apr-19,1,1,0
2796,user_2796,1145,17,15,2,Feb-19,3,0,0
2797,user_2797,1431,28,28,0,Jun-18,11,0,0
2798,user_2798,461,12,12,0,Nov-18,6,0,0
2799,user_2799,5290,125,53,72,May-19,0,1,1
2800,user_2800,1930,37,37,0,Nov-18,6,0,0
2801,user_2801,10511,217,198,19,May-19,0,1,1
2802,user_2802,22370,38,38,0,May-18,12,0,0
2803,user_2803,1599,143,96,47,May-19,0,1,1
2804,user_2804,21940,840,695,145,May-19,0,1,1
2805,user_2805,244,24,9,15,May-19,0,1,1
2806,user_2806,670,43,24,19,Apr-19,1,1,0
2807,user_2807,9,5,5,0,May-18,12,0,0
2808,user_2808,5553,162,122,40,Apr-19,1,1,0
2809,user_2809,5617,178,101,77,May-19,0,1,1
2810,user_2810,90,13,13,0,Nov-18,6,0,0
2811,user_2811,9842,69,69,0,May-18,12,0,0
2812,user_2812,6208,497,385,112,May-19,0,1,1
2813,user_2813,10774,81,81,0,Jul-18,10,0,0
2814,user_2814,327,22,13,9,Mar-19,2,0,0
2815,user_2815,471,13,13,0,Dec-18,5,0,0
2816,user_2816,722,36,36,0,Jun-18,11,0,0
2817,user_2817,9,2,2,0,Mar-18,14,0,0
2818,user_2818,43284,278,210,68,May-19,0,1,1
2819,user_2819,7227,191,156,35,May-19,0,1,1
2820,user_2820,24177,57,50,7,May-19,0,1,1
2821,user_2821,1178,39,32,7,Mar-19,2,0,0
2822,user_2822,9,1,1,0,Mar-18,14,0,0
2823,user_2823,3715,82,80,2,Apr-19,1,1,0
2824,user_2824,21931,303,182,121,May-19,0,1,1
2825,user_2825,101,4,4,0,Apr-18,13,0,0
2826,user_2826,1434,95,81,14,May-19,0,1,1
2827,user_2827,4098,80,70,10,Mar-19,2,0,0
2828,user_2828,2303,151,92,59,Apr-19,1,1,0
2829,user_2829,17328,549,405,144,May-19,0,1,1
2830,user_2830,18904,172,121,51,May-19,0,1,1
2831,user_2831,757,18,18,0,May-18,12,0,0
2832,user_2832,1,3,2,1,Apr-19,1,1,0
2834,user_2834,65,6,6,0,Oct-18,7,0,0
2835,user_2835,1309,161,137,24,May-19,0,0,1
2836,user_2836,7740,10,10,0,Apr-18,13,0,0
2837,user_2837,158,8,8,0,Oct-18,7,0,0
2838,user_2838,20286,116,73,43,May-19,0,1,1
2839,user_2839,57121,1581,814,767,May-19,0,1,1
2840,user_2840,23954,518,78,440,May-19,0,1,1
2841,user_2841,16054,189,121,68,Apr-19,1,1,0
2842,user_2842,7329,197,147,50,Apr-19,1,1,0
2843,user_2843,6566,42,32,10,Apr-19,1,1,0
2844,user_2844,761,24,23,1,Mar-19,2,0,0
2845,user_2845,8533,68,63,5,Mar-19,2,0,0
2846,user_2846,3969,94,89,5,May-19,0,0,1
2847,user_2847,6534,378,345,33,Apr-19,1,1,0
2848,user_2848,2107,26,26,0,Sep-18,8,0,0
2849,user_2849,10749,163,151,12,Jan-19,4,0,0
2850,user_2850,8,3,3,0,May-18,12,0,0
2851,user_2851,3223,239,97,142,Apr-19,1,1,0
2852,user_2852,20,2,2,0,Jun-18,11,0,0
2853,user_2853,4722,289,139,150,May-19,0,1,1
2854,user_2854,481,47,38,9,Apr-19,1,1,0
2855,user_2855,1502,10,2,8,Apr-19,1,1,0
2856,user_2856,407,20,8,12,Mar-19,2,0,0
2857,user_2857,2710,204,164,40,May-19,0,1,1
2858,user_2858,3004,110,33,77,May-19,0,1,1
2859,user_2859,9052,139,106,33,Apr-19,1,1,0
2860,user_2860,4330,163,119,44,May-19,0,1,1
2861,user_2861,4111,317,248,69,Apr-19,1,1,0
2862,user_2862,16,3,2,1,Jan-19,4,0,0
2863,user_2863,21,3,3,0,Jun-18,11,0,0
2864,user_2864,43,8,8,0,Mar-18,14,0,0
2865,user_2865,5818,337,263,74,Apr-19,1,1,0
2866,user_2866,373,66,64,2,Feb-19,3,0,0
2867,user_2867,18489,241,241,0,Sep-18,8,0,0
2868,user_2868,6993,167,63,104,May-19,0,1,1
2869,user_2869,400,38,38,0,Oct-18,7,0,0
2870,user_2870,2203,36,31,5,Feb-19,3,0,0
2871,user_2871,10859,39,15,24,Apr-19,1,1,0
2872,user_2872,8720,172,130,42,May-19,0,1,1
2873,user_2873,15213,455,443,12,May-19,0,1,1
2874,user_2874,20491,172,143,29,May-19,0,1,1
2875,user_2875,15311,494,357,137,Apr-19,1,1,0
2876,user_2876,20,7,6,1,Jan-19,4,0,0
2877,user_2877,14561,160,160,0,Nov-18,6,0,0
2878,user_2878,24651,568,187,381,May-19,0,1,1
2879,user_2879,4780,232,127,105,May-19,0,1,1
2880,user_2880,9519,204,141,63,May-19,0,1,1
2881,user_2881,86557,1169,1044,125,Apr-19,1,1,0
2882,user_2882,13480,895,482,413,May-19,0,1,1
2883,user_2883,1821,51,45,6,Apr-19,1,1,0
2884,user_2884,3960,433,321,112,May-19,0,1,1
2885,user_2885,18,6,5,1,Mar-19,2,0,0
2886,user_2886,6502,428,301,127,May-19,0,1,1
2887,user_2887,327,65,57,8,Apr-19,1,1,0
2888,user_2888,15989,812,382,430,May-19,0,1,1
2889,user_2889,2505,61,56,5,Jan-19,4,0,0
2890,user_2890,22232,919,669,250,May-19,0,1,1
2891,user_2891,9,1,1,0,Mar-18,14,0,0
2892,user_2892,2785,193,164,29,May-19,0,0,1
2893,user_2893,15704,219,85,134,May-19,0,1,1
2894,user_2894,8771,156,95,61,May-19,0,0,1
2895,user_2895,4617,50,31,19,Apr-19,1,1,0
2896,user_2896,11727,234,234,0,Dec-18,5,0,0
2897,user_2897,192,9,9,0,Dec-18,5,0,0
2898,user_2898,11,2,2,0,Mar-18,14,0,0
2899,user_2899,6890,148,68,80,Apr-19,1,1,0
2900,user_2900,3717,48,48,0,Oct-18,7,0,0
2901,user_2901,3984,98,87,11,Apr-19,1,1,0
2902,user_2902,51513,532,387,145,May-19,0,1,1
2903,user_2903,1138,81,73,8,Mar-19,2,0,0
2904,user_2904,2,2,2,0,Mar-18,14,0,0
2905,user_2905,1935,182,84,98,May-19,0,1,1
2906,user_2906,9387,436,433,3,Apr-19,1,1,0
2907,user_2907,7912,330,16,314,May-19,0,1,1
2908,user_2908,5343,230,168,62,May-19,0,1,1
2909,user_2909,295,10,3,7,May-19,0,1,1
2910,user_2910,4780,128,119,9,Jan-19,4,0,0
2911,user_2911,171,14,14,0,Apr-18,13,0,0
2912,user_2912,83,7,7,0,Nov-18,6,0,0
2913,user_2913,2316,121,20,101,May-19,0,1,1
2914,user_2914,3635,352,275,77,May-19,0,1,1
2915,user_2915,11881,71,61,10,May-19,0,0,1
2916,user_2916,9,2,2,0,Mar-18,14,0,0
2917,user_2917,76,9,3,6,May-19,0,0,1
2918,user_2918,4347,255,200,55,May-19,0,1,1
2919,user_2919,385556,278,249,29,May-19,0,1,1
2920,user_2920,24673,285,150,135,May-19,0,1,1
2921,user_2921,3813,96,35,61,Apr-19,1,1,0
2922,user_2922,26426,263,236,27,May-19,0,1,1
2923,user_2923,18,4,4,0,Dec-18,5,0,0
2924,user_2924,2388,86,60,26,May-19,0,1,1
2925,user_2925,9886,559,285,274,May-19,0,1,1
2926,user_2926,2148,85,52,33,Apr-19,1,1,0
2927,user_2927,580,14,14,0,Jun-18,11,0,0
2928,user_2928,2555,33,15,18,Apr-19,1,1,0
2929,user_2929,5689,134,90,44,Mar-19,2,0,0
2930,user_2930,1662,41,28,13,Apr-19,1,1,0
2931,user_2931,2561,58,33,25,May-19,0,0,1
2932,user_2932,2328,58,45,13,Apr-19,1,1,0
2933,user_2933,5814,164,125,39,May-19,0,1,1
2934,user_2934,3736,123,123,0,Oct-18,7,0,0
2935,user_2935,1317,94,89,5,May-19,0,0,1
2936,user_2936,528685,609,341,268,May-19,0,1,1
2937,user_2937,37,8,8,0,Oct-18,7,0,0
2938,user_2938,4512,84,81,3,Mar-19,2,0,0
2939,user_2939,49,5,3,2,Jan-19,4,0,0
2940,user_2940,255,2,2,0,Mar-18,14,0,0
2941,user_2941,14813,98,63,35,Apr-19,1,1,0
2942,user_2942,694,8,8,0,Aug-18,9,0,0
2943,user_2943,6342,76,65,11,Apr-19,1,1,0
2944,user_2944,819,24,24,0,Sep-18,8,0,0
2945,user_2945,1356,29,29,0,Dec-18,5,0,0
2946,user_2946,7548,225,75,150,May-19,0,1,1
2947,user_2947,3917,19,19,0,May-18,12,0,0
2948,user_2948,103,81,50,31,Apr-19,1,1,0
2949,user_2949,302,8,5,3,Mar-19,2,0,0
2950,user_2950,4684,68,35,33,May-19,0,1,1
2951,user_2951,18,3,3,0,Mar-18,14,0,0
2952,user_2952,141,11,11,0,May-18,12,0,0
2953,user_2953,1,1,1,0,Mar-18,14,0,0
2954,user_2954,639,51,7,44,May-19,0,1,1
2955,user_2955,3779,69,47,22,Apr-19,1,1,0
2956,user_2956,58,6,6,0,Jul-18,10,0,0
2957,user_2957,6,3,1,2,Jan-19,4,0,0
2958,user_2958,1,1,1,0,Mar-18,14,0,0
2959,user_2959,7971,171,124,47,Mar-19,2,0,0
2960,user_2960,8841,159,137,22,Apr-19,1,1,0
2961,user_2961,11045,191,147,44,May-19,0,1,1
2962,user_2962,13195,303,192,111,May-19,0,1,1
2963,user_2963,6533,582,408,174,May-19,0,1,1
2964,user_2964,279,23,7,16,May-19,0,1,1
2965,user_2965,3375,52,52,0,Oct-18,7,0,0
2966,user_2966,17541,236,180,56,Apr-19,1,1,0
2967,user_2967,5937,41,41,0,Oct-18,7,0,0
2968,user_2968,17139,696,426,270,May-19,0,1,1
2969,user_2969,3361,112,98,14,Apr-19,1,1,0
2970,user_2970,6836,171,111,60,May-19,0,1,1
2971,user_2971,73763,1063,702,361,May-19,0,1,1
2972,user_2972,4164,131,97,34,May-19,0,1,1
2973,user_2973,33029,419,237,182,May-19,0,1,1
2974,user_2974,16861,272,39,233,Apr-19,1,1,0
2975,user_2975,38814,183,138,45,May-19,0,1,1
2976,user_2976,5092,9,9,0,Aug-18,9,0,0
2977,user_2977,589,75,41,34,May-19,0,1,1
2978,user_2978,9416,403,151,252,May-19,0,1,1
2979,user_2979,6038,73,57,16,May-19,0,1,1
2980,user_2980,704,33,31,2,Mar-19,2,0,0
2981,user_2981,354,6,6,0,Apr-18,13,0,0
2982,user_2982,9494,194,171,23,Apr-19,1,1,0
2983,user_2983,7146,81,73,8,Apr-19,1,1,0
2984,user_2984,5887,106,83,23,Mar-19,2,0,0
2985,user_2985,66,16,14,2,Feb-19,3,0,0
2986,user_2986,5420,137,105,32,Mar-19,2,0,0
2987,user_2987,26093,115,82,33,May-19,0,1,1
2988,user_2988,2495,38,33,5,Mar-19,2,0,0
2989,user_2989,1980,30,30,0,Dec-18,5,0,0
2990,user_2990,380,15,13,2,Apr-19,1,1,0
2991,user_2991,2879,179,72,107,May-19,0,1,1
2992,user_2992,2249,122,70,52,May-19,0,1,1
2993,user_2993,68,11,11,0,Aug-18,9,0,0
2994,user_2994,46313,482,416,66,May-19,0,1,1
2995,user_2995,16326,197,182,15,Apr-19,1,1,0
2996,user_2996,11,3,0,3,Apr-19,1,1,0
2998,user_2998,8647,125,121,4,May-19,0,1,1
2999,user_2999,2481,54,42,12,Jan-19,4,0,0
3000,user_3000,145,19,15,4,Feb-19,3,0,0
3001,user_3001,2849,122,113,9,May-19,0,1,1
3002,user_3002,2768,36,32,4,Apr-19,1,1,0
3003,user_3003,18,3,3,0,Aug-18,9,0,0
3004,user_3004,980,32,30,2,Jan-19,4,0,0
3005,user_3005,10245,115,43,72,May-19,0,1,1
3006,user_3006,2183,31,12,19,Mar-19,2,0,0
3007,user_3007,31816,871,709,162,May-19,0,1,1
3008,user_3008,21292,1088,769,319,May-19,0,1,1
3009,user_3009,455,16,16,0,May-18,12,0,0
3010,user_3010,7471,87,62,25,Apr-19,1,1,0
3011,user_3011,10849,250,135,115,May-19,0,1,1
3012,user_3012,5994,51,3,48,May-19,0,1,1
3013,user_3013,6941,173,151,22,May-19,0,0,1
3014,user_3014,4355,296,109,187,May-19,0,1,1
3015,user_3015,35397,491,325,166,May-19,0,1,1
3016,user_3016,60,3,3,0,Oct-18,7,0,0
3017,user_3017,29211,858,518,340,May-19,0,1,1
3018,user_3018,2697,377,312,65,May-19,0,1,1
3019,user_3019,21876,783,202,581,May-19,0,1,1
3020,user_3020,23,7,7,0,Jul-18,10,0,0
3021,user_3021,18847,69,69,0,Sep-18,8,0,0
3022,user_3022,3628,60,18,42,Apr-19,1,1,0
3023,user_3023,4456,30,14,16,May-19,0,1,1
3024,user_3024,26410,1267,341,926,May-19,0,1,1
3025,user_3025,14479,53,51,2,Apr-19,1,1,0
3026,user_3026,5923,101,84,17,Mar-19,2,0,0
3027,user_3027,4942,114,54,60,May-19,0,1,1
3028,user_3028,651,14,12,2,Apr-19,1,1,0
3029,user_3029,9,2,2,0,Mar-18,14,0,0
3030,user_3030,1978,88,36,52,May-19,0,1,1
3031,user_3031,7593,232,127,105,May-19,0,1,1
3032,user_3032,2131,44,27,17,Apr-19,1,1,0
3033,user_3033,2893,151,107,44,Apr-19,1,1,0
3034,user_3034,1714,35,35,0,Oct-18,7,0,0
3035,user_3035,69,15,1,14,Mar-19,2,0,0
3036,user_3036,570,28,26,2,Mar-19,2,0,0
3037,user_3037,1338,48,48,0,Dec-18,5,0,0
3038,user_3038,23891,239,62,177,May-19,0,1,1
3039,user_3039,2335,78,78,0,Jun-18,11,0,0
3040,user_3040,10438,340,210,130,Apr-19,1,1,0
3041,user_3041,2801,287,239,48,May-19,0,1,1
3042,user_3042,2268,9,9,0,Mar-18,14,0,0
3043,user_3043,285,13,13,0,Apr-18,13,0,0
3045,user_3045,90,7,3,4,Apr-19,1,1,0
3046,user_3046,657,15,15,0,Jun-18,11,0,0
3047,user_3047,8161,135,100,35,May-19,0,1,1
3048,user_3048,3823,226,172,54,Apr-19,1,1,0
3049,user_3049,5222,96,65,31,Mar-19,2,0,0
3050,user_3050,663,5,5,0,Nov-18,6,0,0
3051,user_3051,808,75,71,4,May-19,0,0,1
3052,user_3052,971,64,21,43,May-19,0,1,1
3053,user_3053,3192,98,81,17,May-19,0,1,1
3054,user_3054,112,8,3,5,Mar-19,2,0,0
3055,user_3055,13745,317,132,185,May-19,0,1,1
3056,user_3056,125351,205,170,35,May-19,0,1,1
3057,user_3057,340,61,19,42,Mar-19,2,0,0
3058,user_3058,1700,139,104,35,Apr-19,1,1,0
3059,user_3059,4568,56,53,3,Apr-19,1,1,0
3060,user_3060,6511,349,91,258,May-19,0,1,1
3061,user_3061,64,8,8,0,May-18,12,0,0
3062,user_3062,31385,1405,730,675,May-19,0,1,1
3063,user_3063,2765,383,208,175,May-19,0,1,1
3064,user_3064,18506,767,284,483,May-19,0,1,1
3065,user_3065,6240,121,38,83,May-19,0,1,1
3066,user_3066,5023,105,95,10,Apr-19,1,1,0
3067,user_3067,11,7,7,0,Apr-18,13,0,0
3068,user_3068,40075,869,377,492,May-19,0,1,1
3069,user_3069,2375,266,178,88,May-19,0,1,1
3070,user_3070,3054,38,38,0,Jul-18,10,0,0
3071,user_3071,96,17,6,11,Apr-19,1,1,0
3072,user_3072,9235,498,371,127,May-19,0,1,1
3073,user_3073,513,6,6,0,Mar-18,14,0,0
3074,user_3074,8119,82,47,35,May-19,0,1,1
3075,user_3075,26193,224,206,18,Apr-19,1,1,0
3076,user_3076,1072,53,53,0,Nov-18,6,0,0
3077,user_3077,1039,34,3,31,May-19,0,0,1
3078,user_3078,17411,694,261,433,May-19,0,1,1
3079,user_3079,431,16,15,1,Feb-19,3,0,0
3080,user_3080,4145,232,215,17,Apr-19,1,1,0
3081,user_3081,10089,221,174,47,May-19,0,1,1
3082,user_3082,400,53,25,28,May-19,0,1,1
3083,user_3083,4266,14,14,0,Dec-18,5,0,0
3084,user_3084,7230,126,84,42,May-19,0,1,1
3085,user_3085,12068,375,290,85,Apr-19,1,1,0
3086,user_3086,4463,139,122,17,Apr-19,1,1,0
3087,user_3087,23958,185,76,109,May-19,0,1,1
3088,user_3088,21,3,0,3,Mar-19,2,0,0
3089,user_3089,12902,314,262,52,May-19,0,1,1
3090,user_3090,4903,58,26,32,Apr-19,1,1,0
3091,user_3091,17133,142,108,34,Apr-19,1,1,0
3092,user_3092,86,3,3,0,Jun-18,11,0,0
3093,user_3093,21211,277,170,107,May-19,0,1,1
3094,user_3094,3945,268,173,95,May-19,0,1,1
3095,user_3095,307,23,23,0,May-18,12,0,0
3096,user_3096,1097,18,5,13,May-19,0,0,1
3097,user_3097,3428,218,99,119,May-19,0,1,1
3098,user_3098,2226,83,46,37,May-19,0,1,1
3099,user_3099,16681,452,369,83,May-19,0,1,1
3100,user_3100,7842,51,46,5,Apr-19,1,1,0
3101,user_3101,8285,92,42,50,May-19,0,1,1
3102,user_3102,3615,36,36,0,Aug-18,9,0,0
3103,user_3103,17849,322,190,132,May-19,0,1,1
3104,user_3104,5646,201,84,117,May-19,0,1,1
3105,user_3105,4030,42,42,0,Apr-18,13,0,0
3106,user_3106,6729,358,338,20,Apr-19,1,1,0
3107,user_3107,10777,336,41,295,May-19,0,1,1
3108,user_3108,1043,12,6,6,Feb-19,3,0,0
3109,user_3109,1933,23,22,1,Apr-19,1,1,0
3110,user_3110,1151,42,42,0,Jun-18,11,0,0
3111,user_3111,20973,130,46,84,May-19,0,1,1
3112,user_3112,10188,207,168,39,Mar-19,2,0,0
3113,user_3113,14933,558,426,132,May-19,0,1,1
3114,user_3114,12656,398,219,179,May-19,0,1,1
3115,user_3115,34988,486,351,135,May-19,0,1,1
3116,user_3116,3620,212,138,74,May-19,0,1,1
3117,user_3117,3968,241,211,30,May-19,0,0,1
3118,user_3118,14290,559,251,308,May-19,0,1,1
3119,user_3119,20176,606,197,409,May-19,0,1,1
3120,user_3120,3982,96,80,16,Mar-19,2,0,0
3121,user_3121,1170,82,80,2,May-19,0,0,1
3122,user_3122,6124,230,123,107,May-19,0,1,1
3123,user_3123,4858,57,44,13,May-19,0,1,1
3124,user_3124,16217,75,59,16,May-19,0,1,1
3125,user_3125,3464,88,59,29,Mar-19,2,0,0
3126,user_3126,8,4,4,0,Oct-18,7,0,0
3127,user_3127,3125,75,59,16,Apr-19,1,1,0
3128,user_3128,21,8,8,0,Nov-18,6,0,0
3129,user_3129,652,12,10,2,Jan-19,4,0,0
3130,user_3130,4188,171,98,73,May-19,0,1,1
3131,user_3131,743,47,27,20,Apr-19,1,1,0
3132,user_3132,6414,259,120,139,May-19,0,1,1
3133,user_3133,4425,120,95,25,Apr-19,1,1,0
3134,user_3134,11,2,2,0,Mar-18,14,0,0
3135,user_3135,26268,1305,720,585,May-19,0,1,1
3136,user_3136,8477,552,380,172,May-19,0,1,1
3137,user_3137,5800,95,95,0,Sep-18,8,0,0
3138,user_3138,83,7,7,0,Oct-18,7,0,0
3139,user_3139,37963,374,215,159,May-19,0,1,1
3140,user_3140,233,20,17,3,May-19,0,1,1
3141,user_3141,1345,31,31,0,Nov-18,6,0,0
3142,user_3142,4552,69,51,18,Mar-19,2,0,0
3143,user_3143,13542,202,195,7,May-19,0,1,1
3144,user_3144,4293,144,86,58,May-19,0,1,1
3145,user_3145,52,3,3,0,Jun-18,11,0,0
3146,user_3146,5122,62,58,4,May-19,0,1,1
3147,user_3147,2923,25,25,0,Aug-18,9,0,0
3148,user_3148,88,9,8,1,Apr-19,1,1,0
3149,user_3149,21,2,2,0,Mar-18,14,0,0
3150,user_3150,9,2,2,0,Mar-18,14,0,0
3151,user_3151,9499,60,27,33,May-19,0,1,1
3152,user_3152,10795,394,264,130,May-19,0,1,1
3153,user_3153,7230,291,178,113,May-19,0,1,1
3154,user_3154,976,24,11,13,May-19,0,0,1
3155,user_3155,5737,134,60,74,Apr-19,1,1,0
3156,user_3156,39795,51,22,29,Mar-19,2,0,0
3157,user_3157,57,8,8,0,Nov-18,6,0,0
3158,user_3158,950,10,9,1,Apr-19,1,1,0
3159,user_3159,43942,134,44,90,May-19,0,1,1
3160,user_3160,1821,46,27,19,Apr-19,1,1,0
3161,user_3161,5304,234,117,117,May-19,0,1,1
3162,user_3162,79,10,10,0,Apr-18,13,0,0
3163,user_3163,2444,48,23,25,May-19,0,1,1
3164,user_3164,2497,26,18,8,Apr-19,1,1,0
3165,user_3165,717,69,0,69,May-19,0,1,1
3166,user_3166,1240,51,51,0,Oct-18,7,0,0
3167,user_3167,2896,32,28,4,Jan-19,4,0,0
3168,user_3168,2339,49,16,33,Apr-19,1,1,0
3169,user_3169,1280,34,33,1,May-19,0,0,1
3170,user_3170,11662,194,115,79,May-19,0,1,1
3171,user_3171,2546,284,241,43,May-19,0,1,1
3172,user_3172,1093,12,12,0,Dec-18,5,0,0
3173,user_3173,291,7,7,0,Apr-18,13,0,0
3174,user_3174,23183,149,147,2,Apr-19,1,1,0
3175,user_3175,1723,48,47,1,Feb-19,3,0,0
3176,user_3176,862332,210,91,119,May-19,0,1,1
3177,user_3177,1592,46,40,6,Apr-19,1,1,0
3178,user_3178,14131,113,97,16,Feb-19,3,0,0
3179,user_3179,7729,264,258,6,Apr-19,1,1,0
3180,user_3180,2835,98,98,0,Oct-18,7,0,0
3181,user_3181,13708,281,230,51,Apr-19,1,1,0
3182,user_3182,730,26,21,5,Apr-19,1,1,0
3183,user_3183,66336,763,738,25,May-19,0,1,1
3184,user_3184,16995,396,350,46,May-19,0,1,1
3185,user_3185,8674,76,47,29,Apr-19,1,1,0
3186,user_3186,1237,41,35,6,Mar-19,2,0,0
3187,user_3187,5642,768,387,381,May-19,0,1,1
3188,user_3188,5913,449,196,253,May-19,0,1,1
3189,user_3189,31402,203,142,61,Apr-19,1,1,0
3191,user_3191,78318,588,308,280,May-19,0,1,1
3192,user_3192,9938,835,458,377,May-19,0,1,1
3193,user_3193,4440,89,71,18,Mar-19,2,0,0
3194,user_3194,3928,67,47,20,Feb-19,3,0,0
3195,user_3195,5191,140,121,19,May-19,0,1,1
3196,user_3196,3552,52,33,19,Mar-19,2,0,0
3197,user_3197,2277,73,73,0,Nov-18,6,0,0
3198,user_3198,18280,561,369,192,May-19,0,1,1
3200,user_3200,28117,945,520,425,May-19,0,1,1
3201,user_3201,5271,145,95,50,May-19,0,1,1
3202,user_3202,4500,304,44,260,May-19,0,1,1
3203,user_3203,11642,252,170,82,May-19,0,1,1
3204,user_3204,134076,1495,913,582,May-19,0,1,1
3205,user_3205,3634,120,72,48,May-19,0,1,1
3207,user_3207,178,27,16,11,Feb-19,3,0,0
3208,user_3208,86013,18,0,18,Apr-19,1,1,0
3209,user_3209,456,19,19,0,Apr-18,13,0,0
3210,user_3210,20,2,2,0,Dec-18,5,0,0
3211,user_3211,4024,45,35,10,May-19,0,1,1
3212,user_3212,2426,25,22,3,Apr-19,1,1,0
3213,user_3213,3622,16,15,1,Apr-19,1,1,0
3214,user_3214,31387,95,76,19,May-19,0,1,1
3215,user_3215,340,7,7,0,Oct-18,7,0,0
3216,user_3216,14099,65,30,35,Apr-19,1,1,0
3217,user_3217,11491,401,183,218,May-19,0,1,1
3219,user_3219,121,24,7,17,Apr-19,1,1,0
3220,user_3220,19,4,2,2,May-19,0,0,1
3221,user_3221,15963,174,121,53,May-19,0,1,1
3222,user_3222,8097,210,67,143,May-19,0,1,1
3223,user_3223,10414,186,166,20,May-19,0,1,1
3224,user_3224,107,5,2,3,Apr-19,1,1,0
3225,user_3225,7781,55,41,14,May-19,0,1,1
3226,user_3226,43,5,4,1,Jan-19,4,0,0
3227,user_3227,878302,664,0,664,May-19,0,1,1
3228,user_3228,4564,229,164,65,May-19,0,1,1
3229,user_3229,4746,270,211,59,May-19,0,1,1
3231,user_3231,56,3,3,0,Mar-18,14,0,0
3232,user_3232,15969,214,152,62,Apr-19,1,1,0
3233,user_3233,65527,1866,1171,695,May-19,0,1,1
3234,user_3234,36,6,6,0,Aug-18,9,0,0
3235,user_3235,2956,85,62,23,Apr-19,1,1,0
3236,user_3236,78071,248,152,96,May-19,0,1,1
3237,user_3237,12329,53,7,46,Feb-19,3,0,0
3238,user_3238,7521,30,7,23,May-19,0,1,1
3239,user_3239,2607,41,24,17,Mar-19,2,0,0
3240,user_3240,255,11,4,7,Apr-19,1,1,0
3241,user_3241,2116,102,74,28,May-19,0,1,1
3242,user_3242,12601,121,67,54,May-19,0,1,1
3243,user_3243,12676,88,28,60,May-19,0,1,1
3244,user_3244,9,1,1,0,Mar-18,14,0,0
3245,user_3245,3998,243,139,104,May-19,0,1,1
3246,user_3246,1284,85,63,22,May-19,0,1,1
3247,user_3247,632,34,34,0,Oct-18,7,0,0
3248,user_3248,17779,244,192,52,May-19,0,1,1
3249,user_3249,27,5,5,0,Apr-18,13,0,0
3250,user_3250,7949,486,147,339,May-19,0,1,1
3251,user_3251,7990,87,80,7,Apr-19,1,1,0
3252,user_3252,16511,1733,1250,483,May-19,0,1,1
3253,user_3253,58567,1079,743,336,May-19,0,1,1
3254,user_3254,40748,647,612,35,Feb-19,3,0,0
3255,user_3255,3225,106,58,48,May-19,0,1,1
3256,user_3256,45660,500,386,114,May-19,0,1,1
3257,user_3257,3406,65,53,12,Jan-19,4,0,0
3258,user_3258,3667,75,72,3,May-19,0,0,1
3259,user_3259,23,6,6,0,Sep-18,8,0,0
3260,user_3260,61,7,7,0,Apr-18,13,0,0
3261,user_3261,1252,26,26,0,Sep-18,8,0,0
3262,user_3262,3179,259,195,64,Apr-19,1,1,0
3263,user_3263,3844,56,40,16,May-19,0,1,1
3264,user_3264,795,23,14,9,Apr-19,1,1,0
3265,user_3265,21,5,5,0,Mar-18,14,0,0
3266,user_3266,111,13,4,9,May-19,0,0,1
3267,user_3267,11,4,4,0,Mar-18,14,0,0
3268,user_3268,7979,397,232,165,May-19,0,1,1
3269,user_3269,8,3,3,0,Mar-18,14,0,0
3270,user_3270,3389,185,49,136,Apr-19,1,1,0
3271,user_3271,28973,144,3,141,Apr-19,1,1,0
3272,user_3272,78478,769,404,365,May-19,0,1,1
3273,user_3273,7537,19,19,0,Jun-18,11,0,0
3274,user_3274,3837,110,52,58,Apr-19,1,1,0
3275,user_3275,3303,16,14,2,May-19,0,0,1
3276,user_3276,3291,88,68,20,Apr-19,1,1,0
3277,user_3277,7467,87,45,42,May-19,0,1,1
3278,user_3278,5151,185,140,45,May-19,0,1,1
3279,user_3279,747,11,2,9,Mar-19,2,0,0
3280,user_3280,84,13,13,0,Sep-18,8,0,0
3281,user_3281,225,17,17,0,Aug-18,9,0,0
3282,user_3282,183,8,8,0,Mar-18,14,0,0
3283,user_3283,12242,581,374,207,May-19,0,1,1
3284,user_3284,3703,97,56,41,May-19,0,0,1
3285,user_3285,74673,79,66,13,Mar-19,2,0,0
3286,user_3286,2333,114,96,18,Apr-19,1,1,0
3287,user_3287,63,15,10,5,May-19,0,1,1
3288,user_3288,37,5,0,5,May-19,0,0,1
3289,user_3289,2401,43,43,0,Jun-18,11,0,0
3290,user_3290,453,47,21,26,Apr-19,1,1,0
3291,user_3291,8259,542,387,155,May-19,0,1,1
3292,user_3292,1842,58,58,0,Jun-18,11,0,0
3293,user_3293,16553,1123,573,550,May-19,0,1,1
3294,user_3294,31910,857,370,487,May-19,0,1,1
3295,user_3295,7463,120,106,14,Mar-19,2,0,0
3296,user_3296,61196,2494,1010,1484,May-19,0,1,1
3297,user_3297,5567,225,173,52,Apr-19,1,1,0
3298,user_3298,932,70,24,46,May-19,0,1,1
3299,user_3299,2929,66,19,47,May-19,0,1,1
3300,user_3300,35405,376,189,187,May-19,0,1,1
3301,user_3301,5554,57,50,7,Mar-19,2,0,0
3302,user_3302,1094,31,25,6,Feb-19,3,0,0
3303,user_3303,6803,337,257,80,May-19,0,1,1
3304,user_3304,192,24,16,8,May-19,0,1,1
3305,user_3305,696,35,29,6,May-19,0,0,1
3306,user_3306,3672,124,98,26,May-19,0,1,1
3307,user_3307,3297,188,94,94,May-19,0,1,1
3308,user_3308,1360,24,22,2,Jan-19,4,0,0
3309,user_3309,2874,47,47,0,Aug-18,9,0,0
3310,user_3310,6657,91,55,36,Apr-19,1,1,0
3311,user_3311,3917,49,49,0,May-18,12,0,0
3312,user_3312,523,82,77,5,Jan-19,4,0,0
3313,user_3313,22448,250,148,102,May-19,0,1,1
3314,user_3314,668,26,21,5,Apr-19,1,1,0
3315,user_3315,16483,254,138,116,May-19,0,1,1
3316,user_3316,5945,129,95,34,May-19,0,1,1
3317,user_3317,2129,23,5,18,Apr-19,1,1,0
3318,user_3318,554,59,15,44,May-19,0,1,1
3319,user_3319,4114,50,35,15,Feb-19,3,0,0
3320,user_3320,349,20,18,2,Mar-19,2,0,0
3321,user_3321,111,30,4,26,Apr-19,1,1,0
3322,user_3322,19829,379,78,301,May-19,0,1,1
3323,user_3323,4405,74,62,12,Apr-19,1,1,0
3324,user_3324,490,32,20,12,Apr-19,1,1,0
3325,user_3325,10,1,1,0,Mar-18,14,0,0
3326,user_3326,23580,222,146,76,Mar-19,2,0,0
3327,user_3327,18528,186,186,0,Nov-18,6,0,0
3328,user_3328,1415,21,7,14,May-19,0,1,1
3329,user_3329,1514,37,35,2,Jan-19,4,0,0
3330,user_3330,118695,599,481,118,May-19,0,1,1
3331,user_3331,1489,28,25,3,Mar-19,2,0,0
3332,user_3332,1147,57,43,14,Apr-19,1,1,0
3333,user_3333,8698,184,143,41,May-19,0,1,1
3334,user_3334,3841,23,6,17,May-19,0,1,1
3335,user_3335,26101,345,326,19,Apr-19,1,1,0
3336,user_3336,10186,419,330,89,Mar-19,2,0,0
3337,user_3337,69162,896,429,467,May-19,0,1,1
3338,user_3338,2011,51,9,42,Apr-19,1,1,0
3339,user_3339,3,3,3,0,Jun-18,11,0,0
3340,user_3340,7680,255,187,68,May-19,0,1,1
3341,user_3341,1877,54,52,2,Mar-19,2,0,0
3342,user_3342,16738,595,398,197,May-19,0,1,1
3343,user_3343,1779,20,20,0,Jul-18,10,0,0
3344,user_3344,98,18,18,0,Mar-18,14,0,0
3345,user_3345,1877,28,14,14,Apr-19,1,1,0
3346,user_3346,2786,109,4,105,May-19,0,1,1
3347,user_3347,1492,38,13,25,Apr-19,1,1,0
3348,user_3348,10624,352,88,264,May-19,0,1,1
3349,user_3349,21,3,3,0,Mar-18,14,0,0
3350,user_3350,2192,50,5,45,Mar-19,2,0,0
3351,user_3351,1137,26,25,1,Jan-19,4,0,0
3352,user_3352,6761,176,138,38,Apr-19,1,1,0
3353,user_3353,479,36,30,6,May-19,0,0,1
3354,user_3354,30315,15,15,0,May-18,12,0,0
3355,user_3355,1653,51,47,4,Feb-19,3,0,0
3356,user_3356,7735,57,3,54,May-19,0,1,1
3357,user_3357,2009,308,71,237,May-19,0,1,1
3358,user_3358,24336,814,175,639,May-19,0,1,1
3359,user_3359,17922,795,615,180,Apr-19,1,1,0
3360,user_3360,20474,567,419,148,May-19,0,1,1
3361,user_3361,3547,153,108,45,May-19,0,1,1
3362,user_3362,763,37,3,34,May-19,0,1,1
3363,user_3363,1289,14,2,12,May-19,0,1,1
3364,user_3364,3732,92,9,83,May-19,0,1,1
3365,user_3365,8346,186,113,73,May-19,0,1,1
3366,user_3366,10,1,1,0,Mar-18,14,0,0
3367,user_3367,1509,75,61,14,May-19,0,1,1
3368,user_3368,91,3,3,0,Mar-18,14,0,0
3369,user_3369,7163,92,74,18,Apr-19,1,1,0
3370,user_3370,9244,153,99,54,May-19,0,1,1
3371,user_3371,3128,95,56,39,May-19,0,1,1
3372,user_3372,12888,467,328,139,May-19,0,1,1
3373,user_3373,4606,102,102,0,Nov-18,6,0,0
3374,user_3374,10832,588,293,295,May-19,0,1,1
3375,user_3375,62357,179,64,115,May-19,0,1,1
3376,user_3376,833,28,19,9,Mar-19,2,0,0
3377,user_3377,20509,526,281,245,May-19,0,1,1
3378,user_3378,114969,922,637,285,May-19,0,1,1
3379,user_3379,6097,181,147,34,May-19,0,1,1
3380,user_3380,12112,259,129,130,May-19,0,1,1
3381,user_3381,251,6,4,2,Mar-19,2,0,0
3382,user_3382,5270,80,65,15,Mar-19,2,0,0
3383,user_3383,4108,290,219,71,Apr-19,1,1,0
3384,user_3384,20137,643,603,40,May-19,0,1,1
3385,user_3385,94392,80,58,22,Apr-19,1,1,0
3386,user_3386,23581,735,299,436,May-19,0,1,1
3387,user_3387,222,68,67,1,Feb-19,3,0,0
3388,user_3388,3392,127,127,0,Oct-18,7,0,0
3389,user_3389,11703,854,422,432,May-19,0,1,1
3390,user_3390,240080,1675,770,905,May-19,0,1,1
3391,user_3391,2380,80,63,17,May-19,0,1,1
3392,user_3392,8386,214,40,174,May-19,0,1,1
3393,user_3393,17555,201,181,20,May-19,0,1,1
3394,user_3394,307,33,22,11,Apr-19,1,1,0
3395,user_3395,81887,49,26,23,Apr-19,1,1,0
3396,user_3396,5122,164,108,56,May-19,0,0,1
3397,user_3397,220622,396,199,197,May-19,0,1,1
3398,user_3398,1740,59,59,0,Jun-18,11,0,0
3399,user_3399,48,11,11,0,Mar-18,14,0,0
3400,user_3400,6,1,1,0,Nov-18,6,0,0
3401,user_3401,10107,148,118,30,May-19,0,1,1
3402,user_3402,80,5,5,0,Mar-18,14,0,0
3403,user_3403,2323,13,13,0,Jun-18,11,0,0
3404,user_3404,3284,58,36,22,Mar-19,2,0,0
3405,user_3405,2562,310,251,59,May-19,0,1,1
3406,user_3406,4064,143,82,61,Mar-19,2,0,0
3407,user_3407,75,2,2,0,Mar-18,14,0,0
3408,user_3408,821,39,26,13,May-19,0,0,1
3409,user_3409,131,23,13,10,May-19,0,1,1
3410,user_3410,791,36,33,3,May-19,0,1,1
3411,user_3411,1835,74,28,46,Apr-19,1,1,0
3412,user_3412,277,7,7,0,Mar-18,14,0,0
3413,user_3413,5336,75,75,0,Aug-18,9,0,0
3414,user_3414,6218,101,101,0,Dec-18,5,0,0
3415,user_3415,20611,567,557,10,Apr-19,1,1,0
3416,user_3416,6079,116,82,34,May-19,0,1,1
3417,user_3417,8882,202,151,51,Apr-19,1,1,0
3418,user_3418,584,39,36,3,Feb-19,3,0,0
3419,user_3419,17132,248,168,80,May-19,0,1,1
3420,user_3420,540,40,40,0,Sep-18,8,0,0
3421,user_3421,6365,105,54,51,Apr-19,1,1,0
3422,user_3422,94,10,10,0,Jun-18,11,0,0
3423,user_3423,2347,47,46,1,Feb-19,3,0,0
3424,user_3424,7835,441,223,218,May-19,0,1,1
3425,user_3425,5793,156,156,0,Dec-18,5,0,0
3426,user_3426,10100,49,25,24,May-19,0,0,1
3427,user_3427,1647,55,20,35,Apr-19,1,1,0
3428,user_3428,14637,202,130,72,May-19,0,1,1
3429,user_3429,3074,74,39,35,May-19,0,1,1
3430,user_3430,6884,142,56,86,Mar-19,2,0,0
3431,user_3431,3917,121,79,42,Feb-19,3,0,0
3432,user_3432,41,7,7,0,Apr-18,13,0,0
3433,user_3433,4212,195,117,78,May-19,0,1,1
3434,user_3434,1734,38,24,14,Feb-19,3,0,0
3435,user_3435,289401,107,89,18,May-19,0,1,1
3436,user_3436,8,4,4,0,Mar-18,14,0,0
3437,user_3437,3268,197,171,26,May-19,0,1,1
3438,user_3438,9,2,2,0,Mar-18,14,0,0
3439,user_3439,4343,106,105,1,May-19,0,0,1
3440,user_3440,1380,33,23,10,May-19,0,0,1
3441,user_3441,330,8,8,0,Aug-18,9,0,0
3442,user_3442,17055,147,147,0,Oct-18,7,0,0
3443,user_3443,73393,619,151,468,May-19,0,1,1
3444,user_3444,1131,27,25,2,Mar-19,2,0,0
3445,user_3445,856,15,3,12,Apr-19,1,1,0
3446,user_3446,828,20,20,0,May-18,12,0,0
3447,user_3447,4919,91,91,0,Dec-18,5,0,0
3448,user_3448,60,8,8,0,Mar-18,14,0,0
3449,user_3449,6,4,4,0,Jun-18,11,0,0
3450,user_3450,3429,144,100,44,Apr-19,1,1,0
3451,user_3451,10784,181,37,144,Apr-19,1,1,0
3452,user_3452,4,3,3,0,Mar-18,14,0,0
3453,user_3453,4405,3,3,0,Mar-18,14,0,0
3454,user_3454,373,8,8,0,Oct-18,7,0,0
3455,user_3455,620,19,6,13,May-19,0,1,1
3456,user_3456,10336,168,116,52,May-19,0,1,1
3457,user_3457,19,10,3,7,May-19,0,1,1
3458,user_3458,2595,34,34,0,Dec-18,5,0,0
3459,user_3459,1569,66,47,19,May-19,0,0,1
3460,user_3460,2694,137,130,7,Mar-19,2,0,0
3461,user_3461,2929,59,51,8,Mar-19,2,0,0
3462,user_3462,3520,96,49,47,Apr-19,1,1,0
3463,user_3463,4805,127,83,44,Apr-19,1,1,0
3464,user_3464,63,4,4,0,Mar-18,14,0,0
3465,user_3465,7658,52,17,35,May-19,0,1,1
3466,user_3466,521,24,24,0,Nov-18,6,0,0
3467,user_3467,1602,10,7,3,Apr-19,1,1,0
3468,user_3468,107,11,5,6,May-19,0,1,1
3469,user_3469,7852,162,93,69,May-19,0,1,1
3470,user_3470,80,7,7,0,Mar-18,14,0,0
3471,user_3471,1841,72,35,37,May-19,0,1,1
3472,user_3472,8315,177,77,100,Apr-19,1,1,0
3473,user_3473,3785,68,30,38,May-19,0,1,1
3474,user_3474,1532,44,13,31,May-19,0,1,1
3475,user_3475,3678,187,40,147,May-19,0,1,1
3476,user_3476,21,3,3,0,Mar-18,14,0,0
3477,user_3477,390,44,8,36,Jan-19,4,0,0
3478,user_3478,2994,117,84,33,May-19,0,1,1
3479,user_3479,37895,1328,950,378,May-19,0,1,1
3480,user_3480,7984,18,18,0,Dec-18,5,0,0
3481,user_3481,1846,26,10,16,Mar-19,2,0,0
3482,user_3482,3029,97,82,15,May-19,0,1,1
3483,user_3483,25593,338,107,231,May-19,0,1,1
3484,user_3484,905,216,145,71,May-19,0,1,1
3485,user_3485,14,4,4,0,Mar-18,14,0,0
3486,user_3486,3301,85,72,13,Apr-19,1,1,0
3487,user_3487,2527,16,16,0,Oct-18,7,0,0
3488,user_3488,28100,496,239,257,Apr-19,1,1,0
3489,user_3489,4026,101,79,22,May-19,0,1,1
3490,user_3490,19690,1004,627,377,May-19,0,1,1
3491,user_3491,224,62,27,35,May-19,0,1,1
3492,user_3492,34014,604,364,240,May-19,0,1,1
3493,user_3493,120,10,10,0,Sep-18,8,0,0
3494,user_3494,1689,55,54,1,Feb-19,3,0,0
3495,user_3495,2013,75,72,3,May-19,0,0,1
3496,user_3496,10281,600,316,284,May-19,0,1,1
3497,user_3497,152,3,3,0,Mar-18,14,0,0
3498,user_3498,4953,87,66,21,May-19,0,1,1
3500,user_3500,14801,225,200,25,Apr-19,1,1,0
3501,user_3501,2176,61,49,12,May-19,0,1,1
3502,user_3502,4,2,2,0,Mar-18,14,0,0
3503,user_3503,8444,182,179,3,Feb-19,3,0,0
3504,user_3504,6393,159,73,86,Apr-19,1,1,0
3505,user_3505,2840,88,32,56,Apr-19,1,1,0
3506,user_3506,3409,16,16,0,Oct-18,7,0,0
3507,user_3507,199,18,16,2,Feb-19,3,0,0
3508,user_3508,9459,148,139,9,Jan-19,4,0,0
3509,user_3509,7205,192,128,64,Apr-19,1,1,0
3510,user_3510,19,6,6,0,May-18,12,0,0
3511,user_3511,2682,89,49,40,May-19,0,1,1
3512,user_3512,1798,126,119,7,Mar-19,2,0,0
3513,user_3513,31745,252,130,122,May-19,0,1,1
3514,user_3514,4119,105,65,40,May-19,0,1,1
3515,user_3515,1531,42,6,36,May-19,0,1,1
3516,user_3516,1486,12,8,4,Mar-19,2,0,0
3517,user_3517,3590,180,177,3,Apr-19,1,1,0
3518,user_3518,2091,197,104,93,May-19,0,1,1
3519,user_3519,337,12,5,7,May-19,0,1,1
3520,user_3520,7786,114,62,52,May-19,0,1,1
3521,user_3521,9713,198,106,92,May-19,0,1,1
3522,user_3522,7159,202,116,86,May-19,0,0,1
3523,user_3523,10452,413,402,11,May-19,0,1,1
3524,user_3524,14200,41,36,5,Mar-19,2,0,0
3525,user_3525,8011,47,13,34,Apr-19,1,1,0
3526,user_3526,54,7,5,2,Feb-19,3,0,0
3527,user_3527,326,20,20,0,Mar-18,14,0,0
3528,user_3528,1088,23,11,12,May-19,0,1,1
3529,user_3529,2371,131,108,23,May-19,0,1,1
3530,user_3530,25781,131,58,73,Apr-19,1,1,0
3531,user_3531,22370,51,37,14,Apr-19,1,1,0
3532,user_3532,747798,39,22,17,May-19,0,1,1
3533,user_3533,26272,175,124,51,May-19,0,1,1
3534,user_3534,10656,63,62,1,Jan-19,4,0,0
3535,user_3535,5488,434,327,107,Apr-19,1,1,0
3537,user_3537,16228,89,69,20,Apr-19,1,1,0
3538,user_3538,5187,106,83,23,Mar-19,2,0,0
3539,user_3539,54361,1109,525,584,May-19,0,1,1
3540,user_3540,922,93,19,74,May-19,0,1,1
3541,user_3541,11211,358,238,120,May-19,0,1,1
3542,user_3542,8476,186,145,41,May-19,0,0,1
3543,user_3543,98226,113,74,39,May-19,0,0,1
3545,user_3545,33002,541,148,393,May-19,0,1,1
3546,user_3546,1499,21,21,0,Jun-18,11,0,0
3547,user_3547,2490,28,24,4,May-19,0,1,1
3548,user_3548,9802,18,11,7,Apr-19,1,1,0
3549,user_3549,3407,99,50,49,May-19,0,1,1
3550,user_3550,4755,179,96,83,May-19,0,1,1
3551,user_3551,1371,76,60,16,Apr-19,1,1,0
3552,user_3552,143,9,9,0,Jul-18,10,0,0
3553,user_3553,403,29,16,13,Apr-19,1,1,0
3554,user_3554,9185,407,352,55,May-19,0,1,1
3555,user_3555,15415,474,307,167,May-19,0,1,1
3556,user_3556,28,6,6,0,Mar-18,14,0,0
3557,user_3557,13601,268,142,126,May-19,0,1,1
3558,user_3558,1536,33,17,16,May-19,0,1,1
3559,user_3559,937,45,34,11,Apr-19,1,1,0
3560,user_3560,113125,205,122,83,May-19,0,1,1
3561,user_3561,9113,113,92,21,Mar-19,2,0,0
3562,user_3562,1300,36,16,20,May-19,0,1,1
3563,user_3563,113669,570,328,242,May-19,0,1,1
3564,user_3564,17109,48,17,31,Apr-19,1,1,0
3565,user_3565,9914,89,76,13,May-19,0,0,1
3566,user_3566,2422,52,52,0,Dec-18,5,0,0
3567,user_3567,6304,76,50,26,May-19,0,1,1
3569,user_3569,16267,863,577,286,May-19,0,1,1
3570,user_3570,41834,477,387,90,May-19,0,1,1
3571,user_3571,1345,168,100,68,May-19,0,1,1
3572,user_3572,540,65,48,17,Apr-19,1,1,0
3573,user_3573,7726,70,70,0,Nov-18,6,0,0
3574,user_3574,1663,95,89,6,Apr-19,1,1,0
3575,user_3575,2534,65,52,13,Mar-19,2,0,0
3576,user_3576,671,137,105,32,Mar-19,2,0,0
3577,user_3577,884,15,15,0,May-18,12,0,0
3578,user_3578,17333,1552,971,581,May-19,0,1,1
3579,user_3579,776,19,2,17,May-19,0,1,1
3580,user_3580,185,8,8,0,May-18,12,0,0
3582,user_3582,3948,109,36,73,May-19,0,1,1
3583,user_3583,610,3,3,0,Dec-18,5,0,0
3584,user_3584,2064,58,34,24,May-19,0,1,1
3585,user_3585,9,2,2,0,Mar-18,14,0,0
3586,user_3586,2124,63,21,42,May-19,0,1,1
3587,user_3587,17525,41,26,15,Apr-19,1,1,0
3588,user_3588,7025,393,265,128,May-19,0,1,1
3589,user_3589,2780,219,201,18,May-19,0,1,1
3590,user_3590,18,6,6,0,Sep-18,8,0,0
3591,user_3591,8417,149,82,67,May-19,0,1,1
3592,user_3592,20,3,3,0,Nov-18,6,0,0
3593,user_3593,58,17,10,7,Apr-19,1,1,0
3594,user_3594,4424,120,89,31,May-19,0,1,1
3595,user_3595,831,36,0,36,May-19,0,1,1
3596,user_3596,4666,312,212,100,Feb-19,3,0,0
3597,user_3597,19561,293,167,126,May-19,0,1,1
3598,user_3598,18,5,4,1,Jan-19,4,0,0
3599,user_3599,180,6,6,0,May-18,12,0,0
3600,user_3600,20235,8,5,3,Apr-19,1,1,0
3601,user_3601,8783,50,50,0,Sep-18,8,0,0
3602,user_3602,241,8,0,8,May-19,0,0,1
3603,user_3603,1075,99,58,41,May-19,0,1,1
3604,user_3604,4383,46,39,7,Jan-19,4,0,0
3605,user_3605,5622,122,116,6,Feb-19,3,0,0
3606,user_3606,11,2,2,0,Mar-18,14,0,0
3607,user_3607,12042,8,8,0,Mar-18,14,0,0
3608,user_3608,13026,64,64,0,Jul-18,10,0,0
3609,user_3609,654,79,79,0,Dec-18,5,0,0
3610,user_3610,4142,235,135,100,May-19,0,1,1
3611,user_3611,6613,218,169,49,May-19,0,1,1
3612,user_3612,1297,122,111,11,Mar-19,2,0,0
3613,user_3613,56,8,8,0,May-18,12,0,0
3614,user_3614,8033,210,123,87,May-19,0,1,1
3615,user_3615,1418,39,37,2,Apr-19,1,1,0
3616,user_3616,18,3,3,0,Mar-18,14,0,0
3617,user_3617,2251,123,116,7,Feb-19,3,0,0
3618,user_3618,5712,171,85,86,May-19,0,1,1
3619,user_3619,162,12,12,0,Nov-18,6,0,0
3620,user_3620,10891,347,180,167,May-19,0,1,1
3621,user_3621,1458,17,17,0,Oct-18,7,0,0
3622,user_3622,7952,203,152,51,May-19,0,0,1
3623,user_3623,383,42,41,1,Jan-19,4,0,0
3624,user_3624,24571,165,111,54,May-19,0,1,1
3625,user_3625,9808,200,156,44,May-19,0,1,1
3626,user_3626,545,41,3,38,May-19,0,1,1
3627,user_3627,603,14,14,0,Aug-18,9,0,0
3628,user_3628,20333,219,101,118,May-19,0,1,1
3629,user_3629,2684,34,13,21,May-19,0,1,1
3630,user_3630,21,3,3,0,Mar-18,14,0,0
3631,user_3631,6134,190,185,5,Apr-19,1,1,0
3632,user_3632,4565,42,42,0,Sep-18,8,0,0
3633,user_3633,2712,71,67,4,Mar-19,2,0,0
3634,user_3634,3718,176,130,46,Apr-19,1,1,0
3635,user_3635,820,36,30,6,May-19,0,1,1
3636,user_3636,785,82,18,64,May-19,0,1,1
3637,user_3637,1846,33,31,2,Feb-19,3,0,0
3638,user_3638,2527,22,22,0,Oct-18,7,0,0
3639,user_3639,4290,136,82,54,May-19,0,1,1
3640,user_3640,11109,193,178,15,May-19,0,0,1
3641,user_3641,299,29,29,0,Dec-18,5,0,0
3642,user_3642,3072,51,48,3,Apr-19,1,1,0
3643,user_3643,4000,43,28,15,Mar-19,2,0,0
3644,user_3644,1074,113,91,22,Apr-19,1,1,0
3645,user_3645,18,3,3,0,Jun-18,11,0,0
3646,user_3646,6252,108,63,45,Mar-19,2,0,0
3647,user_3647,212645,2598,1644,954,May-19,0,1,1
3648,user_3648,2804,47,14,33,Apr-19,1,1,0
3649,user_3649,34798,710,330,380,May-19,0,1,1
3650,user_3650,1166,105,87,18,May-19,0,1,1
3651,user_3651,3593,128,84,44,Apr-19,1,1,0
3652,user_3652,11452,85,61,24,May-19,0,1,1
3653,user_3653,7475,91,2,89,May-19,0,1,1
3654,user_3654,7302,306,138,168,May-19,0,1,1
3655,user_3655,152,19,19,0,Nov-18,6,0,0
3656,user_3656,7817,347,206,141,May-19,0,1,1
3657,user_3657,853,40,12,28,Apr-19,1,1,0
3658,user_3658,1716,131,99,32,May-19,0,1,1
3659,user_3659,648,17,17,0,Oct-18,7,0,0
3660,user_3660,20649,327,197,130,May-19,0,1,1
3661,user_3661,1796,191,155,36,Apr-19,1,1,0
3662,user_3662,8,2,2,0,Dec-18,5,0,0
3663,user_3663,1062,115,57,58,Apr-19,1,1,0
3664,user_3664,7610,90,20,70,Apr-19,1,1,0
3665,user_3665,6993,65,7,58,May-19,0,1,1
3666,user_3666,4648,163,137,26,May-19,0,1,1
3667,user_3667,77502,185,8,177,May-19,0,1,1
3668,user_3668,5369,146,119,27,Apr-19,1,1,0
3669,user_3669,1175,191,107,84,May-19,0,1,1
3670,user_3670,741,60,0,60,Apr-19,1,1,0
3671,user_3671,2535,27,27,0,Apr-18,13,0,0
3672,user_3672,42284,587,421,166,May-19,0,1,1
3673,user_3673,173080,438,230,208,May-19,0,1,1
3674,user_3674,6408,271,220,51,Mar-19,2,0,0
3675,user_3675,11,2,2,0,Mar-18,14,0,0
3676,user_3676,5069,264,166,98,May-19,0,1,1
3677,user_3677,2678,66,7,59,May-19,0,1,1
3678,user_3678,3770,189,181,8,Feb-19,3,0,0
3679,user_3679,1811,10,10,0,Jun-18,11,0,0
3680,user_3680,0,1,0,1,Jan-19,4,0,0
3681,user_3681,760,29,29,0,Dec-18,5,0,0
3682,user_3682,5591,129,101,28,Feb-19,3,0,0
3683,user_3683,2769,477,284,193,May-19,0,1,1
3684,user_3684,3097,53,22,31,Mar-19,2,0,0
3685,user_3685,9700,297,177,120,May-19,0,1,1
3686,user_3686,130,16,10,6,Apr-19,1,1,0
3687,user_3687,11079,49,42,7,Feb-19,3,0,0
3688,user_3688,2264,39,35,4,Jan-19,4,0,0
3689,user_3689,9274,168,68,100,May-19,0,1,1
3690,user_3690,11,2,2,0,Mar-18,14,0,0
3691,user_3691,1736,24,24,0,Dec-18,5,0,0
3692,user_3692,6871,142,132,10,Mar-19,2,0,0
3693,user_3693,18857,258,126,132,May-19,0,1,1
3694,user_3694,1267,187,85,102,May-19,0,1,1
3695,user_3695,647,49,49,0,Aug-18,9,0,0
3696,user_3696,2764,75,18,57,May-19,0,1,1
3697,user_3697,13699,186,116,70,Apr-19,1,1,0
3698,user_3698,16804,98,53,45,May-19,0,1,1
3699,user_3699,118,15,11,4,Apr-19,1,1,0
3700,user_3700,1848,25,25,0,May-18,12,0,0
3701,user_3701,2525,86,0,86,May-19,0,1,1
3702,user_3702,3702,252,217,35,May-19,0,1,1
3703,user_3703,89,7,6,1,Apr-19,1,1,0
3704,user_3704,902,47,0,47,May-19,0,1,1
3705,user_3705,39178,242,191,51,May-19,0,1,1
3706,user_3706,7242,226,139,87,May-19,0,1,1
3707,user_3707,7112,318,221,97,May-19,0,1,1
3708,user_3708,555,6,2,4,May-19,0,0,1
3709,user_3709,11058,454,244,210,May-19,0,1,1
3710,user_3710,48,7,0,7,Apr-19,1,1,0
3711,user_3711,257,65,44,21,Apr-19,1,1,0
3712,user_3712,3733,113,10,103,May-19,0,1,1
3713,user_3713,87,12,12,0,Oct-18,7,0,0
3714,user_3714,11878,72,72,0,Sep-18,8,0,0
3715,user_3715,587,31,16,15,May-19,0,1,1
3716,user_3716,770,10,10,0,Apr-18,13,0,0
3717,user_3717,55836,2523,1825,698,May-19,0,1,1
3718,user_3718,94,21,21,0,Sep-18,8,0,0
3719,user_3719,34,10,9,1,Feb-19,3,0,0
3720,user_3720,12902,484,308,176,May-19,0,1,1
3721,user_3721,44300,295,232,63,May-19,0,1,1
3722,user_3722,35425,1296,753,543,May-19,0,1,1
3723,user_3723,11083,216,173,43,May-19,0,1,1
3724,user_3724,348,21,18,3,Feb-19,3,0,0
3725,user_3725,1327,86,86,0,Aug-18,9,0,0
3726,user_3726,2565,45,39,6,Apr-19,1,1,0
3727,user_3727,8228,122,121,1,Jan-19,4,0,0
3728,user_3728,2951,83,50,33,Apr-19,1,1,0
3729,user_3729,1667,152,104,48,May-19,0,1,1
3730,user_3730,2006,38,38,0,Jun-18,11,0,0
3731,user_3731,24139,63,60,3,Feb-19,3,0,0
3732,user_3732,20555,339,338,1,Mar-19,2,0,0
3733,user_3733,30895,942,675,267,May-19,0,1,1
3734,user_3734,3530,74,45,29,May-19,0,1,1
3735,user_3735,9616,302,199,103,May-19,0,1,1
3736,user_3736,2926,102,78,24,May-19,0,1,1
3737,user_3737,2220,202,108,94,May-19,0,1,1
3738,user_3738,97,6,5,1,May-19,0,0,1
3739,user_3739,4918,308,79,229,May-19,0,1,1
3740,user_3740,7829,75,56,19,Mar-19,2,0,0
3741,user_3741,2690,45,31,14,May-19,0,1,1
3742,user_3742,2023,60,34,26,May-19,0,1,1
3743,user_3743,5627,58,56,2,May-19,0,0,1
3744,user_3744,24500,561,401,160,May-19,0,1,1
3745,user_3745,53542,776,463,313,May-19,0,1,1
3746,user_3746,2956,58,56,2,Jan-19,4,0,0
3747,user_3747,17548,260,131,129,May-19,0,1,1
3748,user_3748,1361,83,41,42,May-19,0,1,1
3749,user_3749,2145,149,127,22,Apr-19,1,1,0
3750,user_3750,2080,124,120,4,May-19,0,1,1
3751,user_3751,24146,147,137,10,Jan-19,4,0,0
3752,user_3752,7776,112,80,32,Apr-19,1,1,0
3753,user_3753,10403,182,61,121,May-19,0,1,1
3754,user_3754,12690,37,37,0,Jul-18,10,0,0
3755,user_3755,119,5,5,0,Dec-18,5,0,0
3756,user_3756,516,35,25,10,Apr-19,1,1,0
3757,user_3757,11298,141,79,62,May-19,0,1,1
3758,user_3758,2202,114,57,57,Apr-19,1,1,0
3759,user_3759,275,8,8,0,Aug-18,9,0,0
3760,user_3760,582,22,8,14,Mar-19,2,0,0
3761,user_3761,7556,63,63,0,May-18,12,0,0
3762,user_3762,43,4,4,0,Mar-18,14,0,0
3763,user_3763,10988,240,200,40,May-19,0,1,1
3764,user_3764,14743,684,405,279,May-19,0,1,1
3765,user_3765,13215,184,183,1,Feb-19,3,0,0
3766,user_3766,45,4,4,0,Apr-18,13,0,0
3767,user_3767,135,7,7,0,Apr-18,13,0,0
3768,user_3768,18792,242,194,48,Apr-19,1,1,0
3769,user_3769,13705,211,149,62,May-19,0,1,1
3770,user_3770,2925,145,108,37,May-19,0,1,1
3771,user_3771,946,33,17,16,Apr-19,1,1,0
3772,user_3772,23875,383,306,77,May-19,0,1,1
3773,user_3773,9739,511,343,168,May-19,0,1,1
3774,user_3774,9195,186,123,63,May-19,0,1,1
3775,user_3775,1490,60,34,26,May-19,0,1,1
3776,user_3776,16470,474,189,285,May-19,0,1,1
3777,user_3777,2987,10,10,0,Apr-18,13,0,0
3778,user_3778,104,22,22,0,Nov-18,6,0,0
3779,user_3779,34685,241,175,66,May-19,0,1,1
3780,user_3780,1370,83,26,57,May-19,0,1,1
3781,user_3781,6535,143,134,9,Feb-19,3,0,0
3782,user_3782,4847,121,90,31,Apr-19,1,1,0
3783,user_3783,2063,249,153,96,May-19,0,1,1
3784,user_3784,6105,470,279,191,May-19,0,1,1
3785,user_3785,2850,59,46,13,Apr-19,1,1,0
3786,user_3786,943,29,26,3,Feb-19,3,0,0
3787,user_3787,7102,32,9,23,Apr-19,1,1,0
3788,user_3788,6044,118,67,51,May-19,0,1,1
3789,user_3789,21,3,3,0,Mar-18,14,0,0
3790,user_3790,898,12,12,0,Nov-18,6,0,0
3791,user_3791,2195,43,2,41,Apr-19,1,1,0
3792,user_3792,25523,249,171,78,May-19,0,1,1
3793,user_3793,2964,30,29,1,Apr-19,1,1,0
3794,user_3794,2989,12,3,9,Feb-19,3,0,0
3795,user_3795,1751,100,59,41,Apr-19,1,1,0
3796,user_3796,30022,228,137,91,May-19,0,1,1
3797,user_3797,1103,13,13,0,Jul-18,10,0,0
3798,user_3798,480,11,8,3,Mar-19,2,0,0
3799,user_3799,2568,18,18,0,Jun-18,11,0,0
3800,user_3800,5450,221,140,81,May-19,0,1,1
3801,user_3801,20418,546,379,167,May-19,0,1,1
3802,user_3802,39,6,6,0,Sep-18,8,0,0
3803,user_3803,4847,45,40,5,Mar-19,2,0,0
3804,user_3804,22870,348,259,89,May-19,0,1,1
3805,user_3805,4217,417,276,141,May-19,0,1,1
3806,user_3806,18830,178,120,58,May-19,0,1,1
3807,user_3807,12642,76,65,11,Apr-19,1,1,0
3808,user_3808,14,3,3,0,Mar-18,14,0,0
3809,user_3809,11692,91,81,10,May-19,0,1,1
3810,user_3810,673,5,5,0,May-18,12,0,0
3811,user_3811,897,71,66,5,Apr-19,1,1,0
3812,user_3812,376,28,20,8,Apr-19,1,1,0
3813,user_3813,1336,97,53,44,Apr-19,1,1,0
3814,user_3814,195,13,13,0,Sep-18,8,0,0
3815,user_3815,55,16,12,4,Apr-19,1,1,0
3816,user_3816,3068,56,38,18,May-19,0,1,1
3817,user_3817,750,24,18,6,Feb-19,3,0,0
3818,user_3818,1460,55,55,0,Nov-18,6,0,0
3819,user_3819,18,4,4,0,May-18,12,0,0
3820,user_3820,9898,271,271,0,Nov-18,6,0,0
3821,user_3821,47460,19,19,0,Aug-18,9,0,0
3822,user_3822,178967,413,230,183,May-19,0,1,1
3823,user_3823,113,13,12,1,Apr-19,1,1,0
3824,user_3824,4170,128,80,48,May-19,0,1,1
3825,user_3825,56,3,3,0,Apr-18,13,0,0
3826,user_3826,8767,36,3,33,May-19,0,1,1
3827,user_3827,13678,976,628,348,Apr-19,1,1,0
3829,user_3829,13,2,2,0,Dec-18,5,0,0
3830,user_3830,758,37,8,29,May-19,0,1,1
3831,user_3831,1336,124,53,71,May-19,0,1,1
3832,user_3832,16,3,3,0,Jun-18,11,0,0
3833,user_3833,2378,27,27,0,May-18,12,0,0
3834,user_3834,4188,228,60,168,May-19,0,1,1
3835,user_3835,376,35,34,1,Apr-19,1,1,0
3836,user_3836,40850,567,275,292,May-19,0,1,1
3837,user_3837,126,26,24,2,Feb-19,3,0,0
3838,user_3838,133201,1238,478,760,May-19,0,1,1
3839,user_3839,14231,95,54,41,May-19,0,1,1
3840,user_3840,21097,65,65,0,Dec-18,5,0,0
3841,user_3841,5003,108,88,20,Apr-19,1,1,0
3842,user_3842,15593,780,202,578,May-19,0,1,1
3843,user_3843,22,5,5,0,Jul-18,10,0,0
3844,user_3844,2528,129,81,48,May-19,0,1,1
3845,user_3845,3011,51,40,11,May-19,0,1,1
3846,user_3846,4952,99,87,12,Apr-19,1,1,0
3847,user_3847,123,13,10,3,May-19,0,1,1
3848,user_3848,1077,19,19,0,Nov-18,6,0,0
3849,user_3849,2055,38,38,0,Sep-18,8,0,0
3850,user_3850,6721,84,29,55,May-19,0,1,1
3851,user_3851,33159,506,156,350,May-19,0,1,1
3852,user_3852,9,2,2,0,Apr-18,13,0,0
3853,user_3853,117,5,5,0,Apr-18,13,0,0
3854,user_3854,381,14,14,0,Dec-18,5,0,0
3855,user_3855,965,11,11,0,Jul-18,10,0,0
3856,user_3856,1615,28,16,12,May-19,0,1,1
3857,user_3857,14443,261,105,156,May-19,0,1,1
3858,user_3858,12649,216,113,103,May-19,0,1,1
3859,user_3859,19,9,0,9,May-19,0,1,1
3860,user_3860,12325,1207,805,402,May-19,0,1,1
3861,user_3861,1334,124,87,37,May-19,0,1,1
3862,user_3862,18,4,4,0,Nov-18,6,0,0
3863,user_3863,10771,116,57,59,May-19,0,1,1
3864,user_3864,2753,421,92,329,May-19,0,1,1
3865,user_3865,53,7,7,0,Apr-18,13,0,0
3866,user_3866,21000,1287,870,417,May-19,0,1,1
3867,user_3867,6292,60,52,8,Apr-19,1,1,0
3868,user_3868,3535,58,58,0,May-18,12,0,0
3869,user_3869,67,9,9,0,Jul-18,10,0,0
3870,user_3870,27,2,2,0,Apr-18,13,0,0
3871,user_3871,5695,170,47,123,May-19,0,1,1
3872,user_3872,23159,219,216,3,Mar-19,2,0,0
3873,user_3873,270,19,19,0,Oct-18,7,0,0
3875,user_3875,97,11,3,8,Apr-19,1,1,0
3876,user_3876,201,4,4,0,May-18,12,0,0
3877,user_3877,6803,194,100,94,May-19,0,1,1
3878,user_3878,13858,53,53,0,Oct-18,7,0,0
3879,user_3879,9333,220,165,55,May-19,0,1,1
3880,user_3880,12721,306,196,110,May-19,0,1,1
3881,user_3881,42,11,7,4,May-19,0,1,1
3882,user_3882,138843,1995,684,1311,May-19,0,1,1
3883,user_3883,834,39,12,27,Mar-19,2,0,0
3884,user_3884,3337,90,88,2,Mar-19,2,0,0
3885,user_3885,947,56,42,14,Apr-19,1,1,0
3886,user_3886,14589,295,112,183,May-19,0,1,1
3887,user_3887,213,19,17,2,Jan-19,4,0,0
3888,user_3888,19439,63,6,57,May-19,0,1,1
3889,user_3889,10876,129,69,60,May-19,0,1,1
3890,user_3890,9409,164,88,76,Mar-19,2,0,0
3891,user_3891,81720,436,231,205,May-19,0,1,1
3892,user_3892,314,33,31,2,May-19,0,0,1
3893,user_3893,4183,98,82,16,May-19,0,1,1
3894,user_3894,29,6,0,6,May-19,0,1,1
3895,user_3895,10246,136,119,17,May-19,0,1,1
3896,user_3896,443,43,22,21,May-19,0,1,1
3897,user_3897,21029,265,202,63,May-19,0,1,1
3898,user_3898,40460,247,199,48,May-19,0,1,1
3899,user_3899,140205,1801,1070,731,May-19,0,1,1
3900,user_3900,2074,36,36,0,Nov-18,6,0,0
3901,user_3901,26,4,4,0,Jul-18,10,0,0
3902,user_3902,373,25,24,1,May-19,0,0,1
3903,user_3903,965,46,34,12,Mar-19,2,0,0
3904,user_3904,29192,722,548,174,May-19,0,1,1
3905,user_3905,3384,122,90,32,May-19,0,1,1
3906,user_3906,1774,74,36,38,May-19,0,1,1
3907,user_3907,6507,69,20,49,May-19,0,1,1
3908,user_3908,31953,560,318,242,May-19,0,1,1
3909,user_3909,5683,42,18,24,Apr-19,1,1,0
3910,user_3910,1507,41,27,14,Jan-19,4,0,0
3911,user_3911,9262,198,179,19,May-19,0,1,1
3912,user_3912,7218,128,89,39,May-19,0,1,1
3913,user_3913,71,7,6,1,Mar-19,2,0,0
3914,user_3914,4813,124,81,43,Apr-19,1,1,0
3915,user_3915,7872,160,101,59,May-19,0,1,1
3916,user_3916,1382,75,60,15,May-19,0,1,1
3917,user_3917,3751,55,25,30,May-19,0,1,1
3918,user_3918,206770,1479,861,618,May-19,0,1,1
3919,user_3919,1932,54,54,0,Jun-18,11,0,0
3920,user_3920,5154,101,72,29,May-19,0,0,1
3921,user_3921,4641,43,37,6,Apr-19,1,1,0
3923,user_3923,861,37,26,11,May-19,0,1,1
3924,user_3924,2039,48,48,0,Jun-18,11,0,0
3925,user_3925,7632,46,21,25,May-19,0,1,1
3926,user_3926,476,26,26,0,May-18,12,0,0
3927,user_3927,2155,43,35,8,Apr-19,1,1,0
3928,user_3928,28,3,3,0,Aug-18,9,0,0
3929,user_3929,12191,100,15,85,Jan-19,4,0,0
3930,user_3930,1967,212,151,61,May-19,0,1,1
3931,user_3931,3704,71,71,0,Oct-18,7,0,0
3932,user_3932,88778,800,531,269,May-19,0,1,1
3933,user_3933,107,5,5,0,May-18,12,0,0
3934,user_3934,3034,130,87,43,May-19,0,1,1
3935,user_3935,4680,241,239,2,Feb-19,3,0,0
3936,user_3936,2139,130,102,28,May-19,0,1,1
3937,user_3937,12910,401,237,164,May-19,0,1,1
3938,user_3938,1600,68,31,37,May-19,0,1,1
3939,user_3939,313,30,30,0,Jul-18,10,0,0
3940,user_3940,85,35,34,1,Apr-19,1,1,0
3941,user_3941,8371,198,173,25,Apr-19,1,1,0
3942,user_3942,10156,327,327,0,Aug-18,9,0,0
3943,user_3943,7252,255,156,99,May-19,0,1,1
3944,user_3944,1516,42,42,0,Nov-18,6,0,0
3945,user_3945,4864,106,106,0,Nov-18,6,0,0
3946,user_3946,2554,131,44,87,Apr-19,1,1,0
3947,user_3947,603,19,15,4,Feb-19,3,0,0
3948,user_3948,15370,259,214,45,Apr-19,1,1,0
3949,user_3949,4149,185,101,84,May-19,0,1,1
3950,user_3950,1552,79,0,79,Mar-19,2,0,0
3951,user_3951,955,12,12,0,May-18,12,0,0
3952,user_3952,5598,183,159,24,Apr-19,1,1,0
3953,user_3953,22,7,0,7,Feb-19,3,0,0
3954,user_3954,9392,99,57,42,May-19,0,1,1
3955,user_3955,1880,389,222,167,May-19,0,1,1
3956,user_3956,11489,266,194,72,May-19,0,1,1
3957,user_3957,550,14,14,0,Nov-18,6,0,0
3958,user_3958,854249,48,2,46,Mar-19,2,0,0
3959,user_3959,42239,198,117,81,Apr-19,1,1,0
3960,user_3960,2433,111,95,16,Apr-19,1,1,0
3961,user_3961,141,3,3,0,Apr-18,13,0,0
3962,user_3962,1784,233,156,77,May-19,0,1,1
3963,user_3963,10143,308,248,60,May-19,0,1,1
3964,user_3964,18466,1590,1159,431,May-19,0,1,1
3965,user_3965,1852,31,31,0,Aug-18,9,0,0
3966,user_3966,5790,55,44,11,Feb-19,3,0,0
3967,user_3967,2852,184,136,48,May-19,0,1,1
3968,user_3968,94,22,13,9,Feb-19,3,0,0
3969,user_3969,23407,462,210,252,May-19,0,1,1
3970,user_3970,19764,1206,801,405,May-19,0,1,1
3971,user_3971,13164,180,160,20,Apr-19,1,1,0
3972,user_3972,21,3,3,0,Aug-18,9,0,0
3973,user_3973,990,10,10,0,Apr-18,13,0,0
3974,user_3974,4025,149,82,67,May-19,0,1,1
3975,user_3975,2516,83,72,11,Jan-19,4,0,0
3976,user_3976,13988,1023,571,452,May-19,0,1,1
3977,user_3977,10432,310,276,34,Apr-19,1,1,0
3978,user_3978,36747,81,54,27,May-19,0,1,1
3979,user_3979,1024,14,14,0,May-18,12,0,0
3980,user_3980,12021,64,43,21,Apr-19,1,1,0
3981,user_3981,1188,28,22,6,May-19,0,0,1
3982,user_3982,401,11,11,0,May-18,12,0,0
3983,user_3983,2464,24,24,0,Jun-18,11,0,0
3984,user_3984,1036,29,23,6,Apr-19,1,1,0
3985,user_3985,19,3,3,0,Jun-18,11,0,0
3986,user_3986,362,74,51,23,May-19,0,1,1
3987,user_3987,13005,424,259,165,May-19,0,1,1
3988,user_3988,2161,31,25,6,May-19,0,1,1
3989,user_3989,11594,130,130,0,Nov-18,6,0,0
3990,user_3990,2861,252,0,252,May-19,0,1,1
3991,user_3991,16051,61,42,19,May-19,0,1,1
3992,user_3992,2725,65,60,5,Apr-19,1,1,0
3993,user_3993,14,3,3,0,Apr-18,13,0,0
3994,user_3994,1742,38,27,11,May-19,0,1,1
3995,user_3995,2060,31,31,0,Aug-18,9,0,0
3996,user_3996,26290,152,47,105,May-19,0,1,1
3997,user_3997,164,25,2,23,Apr-19,1,1,0
3998,user_3998,36014,150,133,17,Apr-19,1,1,0
3999,user_3999,4032,456,348,108,May-19,0,1,1
4000,user_4000,3809,216,128,88,May-19,0,1,1
4001,user_4001,3753,79,30,49,May-19,0,1,1
4002,user_4002,6459,448,243,205,May-19,0,1,1
4003,user_4003,3648,241,238,3,Mar-19,2,0,0
4004,user_4004,3284,38,32,6,Mar-19,2,0,0
4005,user_4005,24,6,6,0,Jul-18,10,0,0
4006,user_4006,3899,91,64,27,May-19,0,1,1
4007,user_4007,2293,222,109,113,May-19,0,1,1
4008,user_4008,0,1,1,0,Apr-18,13,0,0
4009,user_4009,56534,707,432,275,May-19,0,1,1
4010,user_4010,129,11,8,3,Mar-19,2,0,0
4011,user_4011,5092,318,200,118,May-19,0,1,1
4012,user_4012,760,146,98,48,May-19,0,1,1
4013,user_4013,1035,116,55,61,May-19,0,1,1
4014,user_4014,5053,92,87,5,Jan-19,4,0,0
4015,user_4015,557,16,16,0,Nov-18,6,0,0
4016,user_4016,7612,154,154,0,Nov-18,6,0,0
4017,user_4017,19892,209,197,12,Apr-19,1,1,0
4018,user_4018,78,6,6,0,May-18,12,0,0
4019,user_4019,1652,30,5,25,May-19,0,1,1
4020,user_4020,15187,16,14,2,Mar-19,2,0,0
4021,user_4021,81,6,6,0,Apr-18,13,0,0
4022,user_4022,11891,192,121,71,May-19,0,1,1
4023,user_4023,4369,96,96,0,Dec-18,5,0,0
4024,user_4024,3686,65,63,2,Apr-19,1,1,0
4025,user_4025,53435,173,98,75,May-19,0,1,1
4026,user_4026,2005,28,28,0,Jun-18,11,0,0
4027,user_4027,2658,23,23,0,Jun-18,11,0,0
4028,user_4028,1515,36,20,16,Mar-19,2,0,0
4029,user_4029,54631,45,34,11,Apr-19,1,1,0
4030,user_4030,4276,128,93,35,May-19,0,1,1
4031,user_4031,14251,754,496,258,May-19,0,1,1
4032,user_4032,6825,189,108,81,Apr-19,1,1,0
4033,user_4033,16,3,3,0,Apr-18,13,0,0
4034,user_4034,1371,63,58,5,Feb-19,3,0,0
4035,user_4035,3534,72,52,20,May-19,0,0,1
4036,user_4036,9259,83,64,19,Mar-19,2,0,0
4037,user_4037,1926,36,35,1,Mar-19,2,0,0
4038,user_4038,3348,240,208,32,Apr-19,1,1,0
4039,user_4039,4731,104,98,6,May-19,0,0,1
4040,user_4040,10392,235,106,129,May-19,0,1,1
4041,user_4041,4456,27,19,8,Apr-19,1,1,0
4042,user_4042,3859,87,55,32,May-19,0,1,1
4043,user_4043,5499,117,93,24,Feb-19,3,0,0
4044,user_4044,982,17,17,0,Sep-18,8,0,0
4045,user_4045,2291,5,3,2,Mar-19,2,0,0
4046,user_4046,48169,1173,769,404,May-19,0,1,1
4047,user_4047,8709,57,44,13,May-19,0,1,1
4048,user_4048,14685,237,90,147,May-19,0,1,1
4049,user_4049,3341,55,4,51,Apr-19,1,1,0
4050,user_4050,1021,55,36,19,Apr-19,1,1,0
4051,user_4051,56532,249,117,132,May-19,0,1,1
4052,user_4052,2607,89,47,42,May-19,0,1,1
4053,user_4053,1430,11,11,0,May-18,12,0,0
4054,user_4054,5967,155,21,134,May-19,0,1,1
4055,user_4055,2,2,2,0,Apr-18,13,0,0
4056,user_4056,2609,43,43,0,May-18,12,0,0
4057,user_4057,9689,78,78,0,Nov-18,6,0,0
4058,user_4058,20,4,4,0,Aug-18,9,0,0
4059,user_4059,150,5,0,5,Apr-19,1,1,0
4060,user_4060,18086,249,107,142,May-19,0,1,1
4061,user_4061,10257,314,148,166,May-19,0,1,1
4062,user_4062,1987,77,4,73,May-19,0,1,1
4063,user_4063,8988,168,87,81,May-19,0,1,1
4064,user_4064,31,6,6,0,Jun-18,11,0,0
4065,user_4065,9900,95,94,1,Mar-19,2,0,0
4066,user_4066,3544,58,53,5,May-19,0,0,1
4067,user_4067,23865,17,16,1,Apr-19,1,1,0
4068,user_4068,11119,190,117,73,May-19,0,1,1
4069,user_4069,17762,57,57,0,May-18,12,0,0
4070,user_4070,148565,351,331,20,Apr-19,1,1,0
4071,user_4071,92,8,1,7,May-19,0,0,1
4072,user_4072,2112,54,34,20,Apr-19,1,1,0
4073,user_4073,139,17,5,12,May-19,0,1,1
4074,user_4074,3890,16,15,1,Jan-19,4,0,0
4075,user_4075,1951,77,55,22,May-19,0,1,1
4076,user_4076,3919,251,197,54,Apr-19,1,1,0
4077,user_4077,27149,169,112,57,May-19,0,1,1
4078,user_4078,857,37,12,25,Mar-19,2,0,0
4079,user_4079,2283,20,19,1,Mar-19,2,0,0
4080,user_4080,3914,110,86,24,Apr-19,1,1,0
4081,user_4081,3492,44,38,6,Apr-19,1,1,0
4082,user_4082,17744,376,160,216,May-19,0,1,1
4083,user_4083,11588,246,166,80,May-19,0,1,1
4084,user_4084,6765,164,143,21,Mar-19,2,0,0
4085,user_4085,38880,1625,926,699,May-19,0,1,1
4086,user_4086,2794,138,105,33,May-19,0,1,1
4087,user_4087,11213,287,80,207,May-19,0,1,1
4088,user_4088,5466,334,296,38,May-19,0,1,1
4089,user_4089,1656,45,12,33,May-19,0,1,1
4090,user_4090,2327,53,53,0,May-18,12,0,0
4091,user_4091,3824,96,96,0,Jul-18,10,0,0
4092,user_4092,3538,96,26,70,Apr-19,1,1,0
4093,user_4093,78,5,3,2,Mar-19,2,0,0
4094,user_4094,345,10,10,0,Sep-18,8,0,0
4095,user_4095,7818,625,397,228,May-19,0,1,1
4096,user_4096,10889,32,32,0,Oct-18,7,0,0
4097,user_4097,5078,90,79,11,Apr-19,1,1,0
4098,user_4098,9027,286,157,129,May-19,0,1,1
4099,user_4099,17039,305,295,10,Mar-19,2,0,0
4100,user_4100,3832,114,30,84,May-19,0,1,1
4101,user_4101,583,25,25,0,Oct-18,7,0,0
4102,user_4102,3,1,0,1,Mar-19,2,0,0
4103,user_4103,890,8,8,0,Apr-18,13,0,0
4104,user_4104,24713,508,275,233,May-19,0,1,1
4105,user_4105,24,5,5,0,Apr-18,13,0,0
4106,user_4106,1124,117,79,38,May-19,0,1,1
4107,user_4107,1472,111,64,47,Apr-19,1,1,0
4108,user_4108,12114,208,139,69,May-19,0,1,1
4109,user_4109,15364,361,347,14,Apr-19,1,1,0
4110,user_4110,451,33,23,10,Feb-19,3,0,0
4111,user_4111,3599,166,86,80,May-19,0,1,1
4112,user_4112,2564,7,3,4,Apr-19,1,1,0
4113,user_4113,4042,274,244,30,May-19,0,0,1
4114,user_4114,5340,180,150,30,Mar-19,2,0,0
4115,user_4115,9,2,2,0,May-18,12,0,0
4116,user_4116,33675,917,350,567,May-19,0,1,1
4117,user_4117,29,14,13,1,Jan-19,4,0,0
4118,user_4118,2810,104,87,17,May-19,0,1,1
4119,user_4119,1627,60,59,1,Mar-19,2,0,0
4120,user_4120,199,1,1,0,Apr-18,13,0,0
4121,user_4121,17955,530,375,155,May-19,0,1,1
4122,user_4122,29,6,3,3,May-19,0,0,1
4123,user_4123,23,10,0,10,May-19,0,1,1
4124,user_4124,2617,74,53,21,May-19,0,1,1
4125,user_4125,21,3,3,0,May-18,12,0,0
4126,user_4126,2796,44,16,28,Apr-19,1,1,0
4127,user_4127,1476,33,26,7,Mar-19,2,0,0
4128,user_4128,3654,123,111,12,Mar-19,2,0,0
4129,user_4129,6048,84,80,4,Apr-19,1,1,0
4130,user_4130,170,1,1,0,May-18,12,0,0
4131,user_4131,137,4,4,0,Jul-18,10,0,0
4132,user_4132,6516,183,122,61,May-19,0,1,1
4133,user_4133,6245,351,258,93,May-19,0,1,1
4134,user_4134,2114,89,62,27,Apr-19,1,1,0
4135,user_4135,2,2,2,0,Apr-18,13,0,0
4136,user_4136,9538,104,76,28,May-19,0,1,1
4137,user_4137,5529,145,109,36,Apr-19,1,1,0
4138,user_4138,23,10,10,0,Dec-18,5,0,0
4139,user_4139,957,13,13,0,Sep-18,8,0,0
4140,user_4140,16108,1100,649,451,May-19,0,1,1
4141,user_4141,2077,38,18,20,May-19,0,1,1
4142,user_4142,5995,658,518,140,May-19,0,1,1
4143,user_4143,11369,143,141,2,Apr-19,1,1,0
4144,user_4144,8513,89,61,28,Jan-19,4,0,0
4145,user_4145,3444,45,42,3,Mar-19,2,0,0
4146,user_4146,9,2,2,0,Apr-18,13,0,0
4147,user_4147,1382,30,30,0,Dec-18,5,0,0
4148,user_4148,21982,361,212,149,May-19,0,1,1
4149,user_4149,189,21,17,4,Mar-19,2,0,0
4150,user_4150,360,18,18,0,Nov-18,6,0,0
4151,user_4151,6388,97,76,21,May-19,0,1,1
4152,user_4152,1825,103,74,29,May-19,0,1,1
4153,user_4153,4808,288,216,72,May-19,0,1,1
4154,user_4154,10825,166,90,76,Mar-19,2,0,0
4155,user_4155,3044,67,52,15,Apr-19,1,1,0
4156,user_4156,2616,81,3,78,May-19,0,1,1
4157,user_4157,7999,306,212,94,May-19,0,1,1
4158,user_4158,2736,55,30,25,May-19,0,1,1
4159,user_4159,16980,669,432,237,May-19,0,1,1
4160,user_4160,25,6,5,1,Mar-19,2,0,0
4161,user_4161,16,3,3,0,May-18,12,0,0
4162,user_4162,729,37,36,1,Apr-19,1,1,0
4163,user_4163,927,76,43,33,Apr-19,1,1,0
4164,user_4164,27217,642,485,157,May-19,0,1,1
4165,user_4165,4147,231,218,13,Mar-19,2,0,0
4166,user_4166,4396,103,85,18,Apr-19,1,1,0
4167,user_4167,1607,45,16,29,May-19,0,1,1
4169,user_4169,3289,110,97,13,May-19,0,1,1
4170,user_4170,13120,209,182,27,Apr-19,1,1,0
4172,user_4172,7599,118,116,2,May-19,0,0,1
4173,user_4173,16262,120,117,3,Apr-19,1,1,0
4174,user_4174,37,5,0,5,May-19,0,0,1
4175,user_4175,703,48,45,3,Feb-19,3,0,0
4176,user_4176,5592,106,93,13,May-19,0,0,1
4177,user_4177,11951,681,476,205,May-19,0,1,1
4178,user_4178,2767,55,52,3,Apr-19,1,1,0
4179,user_4179,757,48,40,8,May-19,0,1,1
4180,user_4180,113,11,7,4,Feb-19,3,0,0
4181,user_4181,5406,57,2,55,May-19,0,1,1
4182,user_4182,4465,93,93,0,Oct-18,7,0,0
4183,user_4183,22310,796,488,308,May-19,0,1,1
4184,user_4184,5873,109,47,62,May-19,0,1,1
4185,user_4185,16286,242,132,110,May-19,0,1,1
4186,user_4186,3637,127,92,35,Apr-19,1,1,0
4187,user_4187,1624,126,16,110,May-19,0,1,1
4188,user_4188,12946,720,412,308,May-19,0,1,1
4189,user_4189,9209,125,85,40,May-19,0,1,1
4190,user_4190,103,12,12,0,May-18,12,0,0
4191,user_4191,485,9,3,6,Mar-19,2,0,0
4192,user_4192,69,4,4,0,Apr-18,13,0,0
4193,user_4193,12362,238,189,49,May-19,0,1,1
4194,user_4194,6036,183,121,62,May-19,0,1,1
4195,user_4195,5474,117,74,43,Apr-19,1,1,0
4196,user_4196,3063,110,104,6,Mar-19,2,0,0
4197,user_4197,5996,211,182,29,Mar-19,2,0,0
4198,user_4198,2347,290,198,92,Apr-19,1,1,0
4199,user_4199,5131,140,47,93,May-19,0,1,1
4200,user_4200,930,66,62,4,Apr-19,1,1,0
4201,user_4201,1712,30,23,7,Feb-19,3,0,0
4202,user_4202,11,2,2,0,Jun-18,11,0,0
4203,user_4203,11,2,2,0,Apr-18,13,0,0
4204,user_4204,6949,177,177,0,Oct-18,7,0,0
4205,user_4205,35,4,4,0,Apr-18,13,0,0
4206,user_4206,529,10,10,0,Sep-18,8,0,0
4207,user_4207,5842,719,440,279,May-19,0,1,1
4208,user_4208,6880,120,88,32,Apr-19,1,1,0
4209,user_4209,196,2,2,0,May-18,12,0,0
4210,user_4210,1444,39,19,20,May-19,0,1,1
4211,user_4211,18242,32,10,22,Apr-19,1,1,0
4212,user_4212,9,2,2,0,Jun-18,11,0,0
4213,user_4213,43941,131,44,87,May-19,0,1,1
4214,user_4214,474,38,19,19,May-19,0,0,1
4215,user_4215,1563,61,61,0,Sep-18,8,0,0
4217,user_4217,14659,72,21,51,May-19,0,1,1
4218,user_4218,2307,83,83,0,Nov-18,6,0,0
4219,user_4219,13369,99,73,26,Feb-19,3,0,0
4220,user_4220,4720,452,319,133,May-19,0,1,1
4221,user_4221,13298,211,98,113,May-19,0,1,1
4222,user_4222,12235,99,68,31,Apr-19,1,1,0
4223,user_4223,368,11,11,0,Apr-18,13,0,0
4224,user_4224,671,18,14,4,Apr-19,1,1,0
4225,user_4225,3901,59,59,0,Dec-18,5,0,0
4226,user_4226,52297,420,316,104,May-19,0,1,1
4227,user_4227,7616,95,39,56,Apr-19,1,1,0
4228,user_4228,26,4,4,0,Nov-18,6,0,0
4229,user_4229,18581,40,40,0,Dec-18,5,0,0
4230,user_4230,710,37,8,29,May-19,0,1,1
4232,user_4232,14205,180,51,129,May-19,0,1,1
4233,user_4233,1559,44,43,1,Mar-19,2,0,0
4234,user_4234,13262,487,300,187,May-19,0,1,1
4235,user_4235,1648,75,75,0,Dec-18,5,0,0
4236,user_4236,9154,65,58,7,Jan-19,4,0,0
4237,user_4237,4345,123,104,19,Apr-19,1,1,0
4238,user_4238,949,90,72,18,Mar-19,2,0,0
4239,user_4239,2739,39,21,18,Mar-19,2,0,0
4240,user_4240,46,6,1,5,Feb-19,3,0,0
4241,user_4241,6448,48,42,6,Mar-19,2,0,0
4242,user_4242,20,5,5,0,Apr-18,13,0,0
4243,user_4243,81873,3381,2283,1098,May-19,0,1,1
4244,user_4244,212,62,62,0,Dec-18,5,0,0
4245,user_4245,20698,425,267,158,May-19,0,1,1
4246,user_4246,13552,63,44,19,Apr-19,1,1,0
4247,user_4247,73324,72,47,25,May-19,0,1,1
4248,user_4248,15925,242,227,15,Mar-19,2,0,0
4249,user_4249,11561,170,66,104,Apr-19,1,1,0
4250,user_4250,27,2,0,2,Apr-19,1,1,0
4251,user_4251,3522,235,81,154,May-19,0,1,1
4252,user_4252,81,5,5,0,Apr-18,13,0,0
4253,user_4253,9268,407,245,162,May-19,0,1,1
4254,user_4254,23987,1217,1023,194,May-19,0,1,1
4255,user_4255,1282,63,63,0,Nov-18,6,0,0
4256,user_4256,7114,51,39,12,May-19,0,0,1
4257,user_4257,1161,16,13,3,May-19,0,0,1
4258,user_4258,650,62,40,22,Feb-19,3,0,0
4259,user_4259,49151,302,260,42,May-19,0,1,1
4260,user_4260,11788,1058,567,491,May-19,0,1,1
4261,user_4261,104,16,9,7,May-19,0,1,1
4262,user_4262,10981,154,53,101,Apr-19,1,1,0
4263,user_4263,1539,47,43,4,Apr-19,1,1,0
4264,user_4264,67697,1942,1142,800,May-19,0,1,1
4265,user_4265,21,4,4,0,May-18,12,0,0
4266,user_4266,1546,116,58,58,Mar-19,2,0,0
4267,user_4267,27114,2101,1187,914,May-19,0,1,1
4268,user_4268,69212,1153,682,471,May-19,0,1,1
4269,user_4269,21242,557,327,230,May-19,0,1,1
4270,user_4270,2438,109,81,28,May-19,0,1,1
4271,user_4271,4556,100,97,3,Jan-19,4,0,0
4272,user_4272,165,28,27,1,Mar-19,2,0,0
4273,user_4273,7483,179,83,96,May-19,0,1,1
4274,user_4274,340078,147,90,57,May-19,0,1,1
4275,user_4275,159631,25,1,24,Apr-19,1,1,0
4276,user_4276,18844,874,498,376,May-19,0,1,1
4277,user_4277,2,10,10,0,May-18,12,0,0
4278,user_4278,4616,52,52,0,Sep-18,8,0,0
4279,user_4279,754,38,38,0,Aug-18,9,0,0
4280,user_4280,10486,354,119,235,May-19,0,1,1
4281,user_4281,3464,191,0,191,May-19,0,1,1
4282,user_4282,5609,96,75,21,Mar-19,2,0,0
4283,user_4283,130,8,8,0,Jun-18,11,0,0
4284,user_4284,11326,188,188,0,Nov-18,6,0,0
4285,user_4285,399,11,8,3,Mar-19,2,0,0
4286,user_4286,14552,25,23,2,Jan-19,4,0,0
4287,user_4287,939,45,45,0,Jul-18,10,0,0
4288,user_4288,1080,30,2,28,Apr-19,1,1,0
4289,user_4289,861,118,96,22,Apr-19,1,1,0
4290,user_4290,1642,30,20,10,Apr-19,1,1,0
4291,user_4291,34,11,8,3,Feb-19,3,0,0
4292,user_4292,3947,12,12,0,Jul-18,10,0,0
4293,user_4293,18240,312,208,104,May-19,0,1,1
4295,user_4295,6346,95,95,0,Aug-18,9,0,0
4296,user_4296,122358,468,260,208,May-19,0,1,1
4297,user_4297,7457,66,49,17,Apr-19,1,1,0
4298,user_4298,16207,193,117,76,May-19,0,1,1
4299,user_4299,13916,225,170,55,May-19,0,1,1
4300,user_4300,3348,70,70,0,Dec-18,5,0,0
4301,user_4301,78793,272,150,122,May-19,0,1,1
4302,user_4302,3689,817,537,280,May-19,0,1,1
4303,user_4303,6668,120,115,5,Apr-19,1,1,0
4304,user_4304,3169,89,68,21,Mar-19,2,0,0
4305,user_4305,131626,716,126,590,May-19,0,1,1
4306,user_4306,13392,285,46,239,May-19,0,1,1
4307,user_4307,575,8,5,3,Jan-19,4,0,0
4308,user_4308,1251,13,13,0,Apr-18,13,0,0
4309,user_4309,40729,198,100,98,May-19,0,1,1
4310,user_4310,10357,1336,833,503,May-19,0,1,1
4311,user_4311,28807,2520,1452,1068,May-19,0,1,1
4312,user_4312,4594,67,67,0,Aug-18,9,0,0
4313,user_4313,41,4,4,0,Apr-18,13,0,0
4314,user_4314,4360,58,57,1,May-19,0,0,1
4315,user_4315,22,2,2,0,Apr-18,13,0,0
4316,user_4316,3392,93,80,13,Apr-19,1,1,0
4317,user_4317,100,20,0,20,May-19,0,1,1
4318,user_4318,5550,61,47,14,May-19,0,1,1
4319,user_4319,14513,213,95,118,May-19,0,1,1
4320,user_4320,3973,33,33,0,Aug-18,9,0,0
4321,user_4321,189,14,12,2,Mar-19,2,0,0
4322,user_4322,8566,277,259,18,Mar-19,2,0,0
4323,user_4323,1288,43,43,0,Aug-18,9,0,0
4324,user_4324,360,6,4,2,May-19,0,1,1
4325,user_4325,255,15,15,0,Aug-18,9,0,0
4326,user_4326,154,3,3,0,Apr-18,13,0,0
4327,user_4327,1839,59,53,6,Apr-19,1,1,0
4328,user_4328,1720,47,47,0,Oct-18,7,0,0
4329,user_4329,26481,184,90,94,May-19,0,1,1
4330,user_4330,2583,117,97,20,Apr-19,1,1,0
4331,user_4331,858,13,12,1,Mar-19,2,0,0
4332,user_4332,3490,118,118,0,Sep-18,8,0,0
4333,user_4333,10371,268,123,145,May-19,0,1,1
4334,user_4334,3817,217,206,11,May-19,0,1,1
4335,user_4335,26465,918,483,435,May-19,0,1,1
4336,user_4336,14804,128,110,18,May-19,0,1,1
4337,user_4337,5229,91,91,0,Nov-18,6,0,0
4338,user_4338,3090,190,184,6,May-19,0,1,1
4339,user_4339,24782,1174,439,735,May-19,0,1,1
4340,user_4340,196,21,21,0,Jul-18,10,0,0
4341,user_4341,1599,182,88,94,May-19,0,1,1
4342,user_4342,7310,209,198,11,Jan-19,4,0,0
4343,user_4343,7237,44,42,2,May-19,0,0,1
4344,user_4344,5,2,2,0,Apr-18,13,0,0
4345,user_4345,2784,68,24,44,Mar-19,2,0,0
4346,user_4346,4129,26,26,0,Oct-18,7,0,0
4347,user_4347,13811,53,33,20,May-19,0,1,1
4348,user_4348,3977,348,247,101,Apr-19,1,1,0
4349,user_4349,2019,35,3,32,Mar-19,2,0,0
4350,user_4350,3049,126,104,22,May-19,0,1,1
4351,user_4351,13937,253,198,55,May-19,0,1,1
4352,user_4352,2978,104,91,13,May-19,0,1,1
4353,user_4353,13837,367,22,345,May-19,0,1,1
4354,user_4354,184,22,16,6,Apr-19,1,1,0
4355,user_4355,12,5,3,2,Mar-19,2,0,0
4356,user_4356,4035,50,38,12,Apr-19,1,1,0
4357,user_4357,4593,186,78,108,May-19,0,1,1
4358,user_4358,10792,109,37,72,May-19,0,1,1
4359,user_4359,9443,316,212,104,May-19,0,1,1
4360,user_4360,4256,74,47,27,Apr-19,1,1,0
4361,user_4361,114332,365,218,147,May-19,0,1,1
4362,user_4362,722,37,37,0,Dec-18,5,0,0
4363,user_4363,10175,273,88,185,May-19,0,1,1
4364,user_4364,92707,579,490,89,May-19,0,1,1
4365,user_4365,3797,81,52,29,May-19,0,1,1
4366,user_4366,52251,340,195,145,May-19,0,1,1
4367,user_4367,5727,205,142,63,May-19,0,1,1
4368,user_4368,4886,208,204,4,Jan-19,4,0,0
4369,user_4369,7,4,4,0,Apr-18,13,0,0
4370,user_4370,7209,209,111,98,May-19,0,1,1
4371,user_4371,479,29,16,13,Mar-19,2,0,0
4372,user_4372,53428,2261,1617,644,May-19,0,1,1
4373,user_4373,12426,408,180,228,May-19,0,1,1
4374,user_4374,382,15,15,0,Oct-18,7,0,0
4376,user_4376,45,30,29,1,Jan-19,4,0,0
4377,user_4377,9858,283,107,176,May-19,0,1,1
4378,user_4378,7980,106,79,27,Apr-19,1,1,0
4379,user_4379,8696,156,140,16,May-19,0,1,1
4380,user_4380,1602,119,106,13,Mar-19,2,0,0
4381,user_4381,721,15,0,15,Mar-19,2,0,0
4382,user_4382,5426,173,137,36,May-19,0,1,1
4383,user_4383,8126,67,14,53,Apr-19,1,1,0
4384,user_4384,10048,302,97,205,Apr-19,1,1,0
4385,user_4385,682,21,6,15,Apr-19,1,1,0
4386,user_4386,292,7,6,1,Feb-19,3,0,0
4387,user_4387,40058,662,362,300,May-19,0,1,1
4388,user_4388,1302,122,103,19,May-19,0,1,1
4389,user_4389,19,4,4,0,May-18,12,0,0
4390,user_4390,1119,28,24,4,Apr-19,1,1,0
4391,user_4391,8416,100,72,28,May-19,0,1,1
4392,user_4392,16431,1194,631,563,May-19,0,1,1
4394,user_4394,19035,468,257,211,May-19,0,1,1
4395,user_4395,15990,333,238,95,May-19,0,1,1
4396,user_4396,45199,790,515,275,May-19,0,1,1
4397,user_4397,3128,57,35,22,May-19,0,1,1
4398,user_4398,1,1,1,0,Oct-18,7,0,0
4399,user_4399,26410,620,453,167,May-19,0,1,1
4400,user_4400,1606,41,30,11,Feb-19,3,0,0
4401,user_4401,10047,125,120,5,May-19,0,1,1
4402,user_4402,944,12,12,0,Dec-18,5,0,0
4403,user_4403,11823,130,87,43,Apr-19,1,1,0
4404,user_4404,3715,84,84,0,Dec-18,5,0,0
4405,user_4405,30,11,7,4,Apr-19,1,1,0
4406,user_4406,4166,125,74,51,Mar-19,2,0,0
4407,user_4407,40990,244,114,130,May-19,0,1,1
4409,user_4409,2145,167,109,58,May-19,0,1,1
4410,user_4410,20,10,9,1,Mar-19,2,0,0
4411,user_4411,208,34,29,5,Apr-19,1,1,0
4412,user_4412,9324,169,104,65,Apr-19,1,1,0
4413,user_4413,24,4,3,1,Jan-19,4,0,0
4414,user_4414,1514,49,49,0,Aug-18,9,0,0
4415,user_4415,1393,9,9,0,May-18,12,0,0
4416,user_4416,469,18,18,0,Dec-18,5,0,0
4417,user_4417,1310,70,51,19,Apr-19,1,1,0
4418,user_4418,1330,51,28,23,Apr-19,1,1,0
4419,user_4419,31091,57,39,18,May-19,0,1,1
4420,user_4420,9918,448,285,163,May-19,0,1,1
4421,user_4421,5456,22,17,5,Apr-19,1,1,0
4422,user_4422,3941,167,111,56,May-19,0,1,1
4423,user_4423,1335,195,195,0,Dec-18,5,0,0
4424,user_4424,4807,292,238,54,Apr-19,1,1,0
4425,user_4425,490,80,28,52,May-19,0,1,1
4426,user_4426,9462,223,217,6,Mar-19,2,0,0
4427,user_4427,4764,76,60,16,May-19,0,1,1
4428,user_4428,11812,159,104,55,May-19,0,1,1
4429,user_4429,4944,117,33,84,May-19,0,1,1
4430,user_4430,1696,79,79,0,Sep-18,8,0,0
4431,user_4431,0,1,1,0,Apr-18,13,0,0
4432,user_4432,2134,227,62,165,May-19,0,1,1
4433,user_4433,5639,102,97,5,May-19,0,1,1
4434,user_4434,552,40,33,7,Apr-19,1,1,0
4435,user_4435,1045,44,36,8,Apr-19,1,1,0
4436,user_4436,16031,415,218,197,May-19,0,1,1
4437,user_4437,24,5,5,0,May-18,12,0,0
4438,user_4438,1823,61,35,26,May-19,0,1,1
4439,user_4439,2254,67,33,34,Apr-19,1,1,0
4440,user_4440,18,6,6,0,Apr-18,13,0,0
4441,user_4441,5657,136,75,61,May-19,0,1,1
4442,user_4442,10080,369,174,195,May-19,0,1,1
4443,user_4443,6934,141,104,37,May-19,0,1,1
4444,user_4444,40630,656,379,277,May-19,0,1,1
4445,user_4445,44556,510,186,324,May-19,0,1,1
4446,user_4446,3,3,2,1,Mar-19,2,0,0
4447,user_4447,789,17,17,0,Dec-18,5,0,0
4448,user_4448,33215,187,165,22,May-19,0,1,1
4449,user_4449,1688,56,56,0,Oct-18,7,0,0
4450,user_4450,3645,104,69,35,Apr-19,1,1,0
4451,user_4451,16605,325,230,95,May-19,0,1,1
4452,user_4452,36226,464,192,272,May-19,0,1,1
4453,user_4453,2241,25,20,5,Apr-19,1,1,0
4454,user_4454,2435,59,35,24,May-19,0,0,1
4455,user_4455,10995,235,204,31,May-19,0,1,1
4456,user_4456,8356,105,83,22,May-19,0,1,1
4457,user_4457,476,15,9,6,Jan-19,4,0,0
4458,user_4458,102,23,23,0,Dec-18,5,0,0
4459,user_4459,5788,126,102,24,May-19,0,1,1
4460,user_4460,4227,59,52,7,Apr-19,1,1,0
4461,user_4461,9,2,2,0,Apr-18,13,0,0
4462,user_4462,6689,119,83,36,May-19,0,1,1
4463,user_4463,20207,256,224,32,May-19,0,0,1
4464,user_4464,3065,21,19,2,Apr-19,1,1,0
4465,user_4465,20,9,0,9,Apr-19,1,1,0
4466,user_4466,19037,243,124,119,May-19,0,1,1
4467,user_4467,10,1,0,1,Jan-19,4,0,0
4468,user_4468,863717,123,103,20,May-19,0,1,1
4469,user_4469,32640,175,84,91,May-19,0,1,1
4470,user_4470,486957,314,244,70,May-19,0,1,1
4471,user_4471,4612,76,61,15,Apr-19,1,1,0
4472,user_4472,16873,217,142,75,Feb-19,3,0,0
4473,user_4473,4559,70,69,1,Jan-19,4,0,0
4474,user_4474,11230,137,79,58,May-19,0,1,1
4475,user_4475,9733,3,3,0,Apr-18,13,0,0
4476,user_4476,54,8,8,0,Sep-18,8,0,0
4477,user_4477,14149,279,152,127,May-19,0,1,1
4478,user_4478,11058,263,256,7,May-19,0,0,1
4479,user_4479,1265,7,7,0,Jul-18,10,0,0
4480,user_4480,7988,171,129,42,Apr-19,1,1,0
4481,user_4481,2346,58,30,28,Apr-19,1,1,0
4482,user_4482,661,24,16,8,May-19,0,1,1
4483,user_4483,15865,75,30,45,May-19,0,1,1
4484,user_4484,17,2,2,0,Jul-18,10,0,0
4485,user_4485,7913,112,98,14,May-19,0,1,1
4486,user_4486,20405,185,177,8,May-19,0,0,1
4487,user_4487,12474,90,79,11,Mar-19,2,0,0
4488,user_4488,722,20,19,1,Feb-19,3,0,0
4489,user_4489,6263,85,81,4,Mar-19,2,0,0
4490,user_4490,6460,765,461,304,May-19,0,1,1
4491,user_4491,5749,551,242,309,May-19,0,1,1
4492,user_4492,1926,73,46,27,May-19,0,1,1
4493,user_4493,260,6,6,0,Oct-18,7,0,0
4494,user_4494,3519,66,41,25,May-19,0,1,1
4495,user_4495,86802,1359,488,871,May-19,0,1,1
4496,user_4496,8986,118,115,3,Jan-19,4,0,0
4497,user_4497,27272,547,349,198,Apr-19,1,1,0
4498,user_4498,1393,32,24,8,Apr-19,1,1,0
4499,user_4499,11553,108,86,22,May-19,0,1,1
4500,user_4500,27,3,3,0,Apr-18,13,0,0
4501,user_4501,2826,85,59,26,May-19,0,1,1
4502,user_4502,5982,160,103,57,Apr-19,1,1,0
4503,user_4503,106205,558,405,153,May-19,0,1,1
4504,user_4504,2849,70,39,31,May-19,0,1,1
4505,user_4505,22024,251,153,98,May-19,0,1,1
4506,user_4506,2162,137,128,9,Feb-19,3,0,0
4507,user_4507,10329,443,221,222,May-19,0,1,1
4508,user_4508,1501,87,87,0,Sep-18,8,0,0
4509,user_4509,211149,181,98,83,May-19,0,1,1
4510,user_4510,9699,86,67,19,Jan-19,4,0,0
4511,user_4511,8432,13,13,0,Nov-18,6,0,0
4513,user_4513,101,3,3,0,Apr-18,13,0,0
4514,user_4514,167,31,19,12,Apr-19,1,1,0
4515,user_4515,672,26,23,3,Feb-19,3,0,0
4516,user_4516,7083,109,79,30,Mar-19,2,0,0
4517,user_4517,1123,32,32,0,Oct-18,7,0,0
4519,user_4519,9728,75,55,20,May-19,0,1,1
4520,user_4520,13211,236,112,124,May-19,0,1,1
4521,user_4521,957,54,44,10,May-19,0,1,1
4522,user_4522,102,14,11,3,May-19,0,0,1
4523,user_4523,4242,10,8,2,Apr-19,1,1,0
4524,user_4524,152,5,5,0,Aug-18,9,0,0
4525,user_4525,1182,36,36,0,Nov-18,6,0,0
4526,user_4526,49490,945,522,423,May-19,0,1,1
4527,user_4527,5529,111,71,40,Apr-19,1,1,0
4528,user_4528,8,2,1,1,Jan-19,4,0,0
4529,user_4529,6856,104,93,11,Apr-19,1,1,0
4530,user_4530,18321,1237,402,835,May-19,0,1,1
4531,user_4531,27,3,3,0,Dec-18,5,0,0
4532,user_4532,2277,45,20,25,Mar-19,2,0,0
4533,user_4533,55248,1047,519,528,May-19,0,1,1
4535,user_4535,820,29,29,0,Oct-18,7,0,0
4536,user_4536,449,115,15,100,May-19,0,1,1
4537,user_4537,45380,1191,798,393,May-19,0,1,1
4538,user_4538,2334,90,87,3,Mar-19,2,0,0
4539,user_4539,14869,342,242,100,May-19,0,1,1
4540,user_4540,601,4,4,0,Apr-18,13,0,0
4541,user_4541,58067,2686,1882,804,May-19,0,1,1
4542,user_4542,559,20,15,5,May-19,0,0,1
4544,user_4544,468,45,17,28,Apr-19,1,1,0
4545,user_4545,41,3,0,3,May-19,0,0,1
4546,user_4546,597,22,22,0,Aug-18,9,0,0
4547,user_4547,1104,45,45,0,Aug-18,9,0,0
4548,user_4548,9081,577,285,292,May-19,0,1,1
4549,user_4549,1008,29,22,7,Apr-19,1,1,0
4550,user_4550,3502,69,57,12,May-19,0,0,1
4551,user_4551,21,3,3,0,Apr-18,13,0,0
4552,user_4552,7430,90,90,0,Oct-18,7,0,0
4553,user_4553,4159,19,17,2,Apr-19,1,1,0
4554,user_4554,6960,240,128,112,May-19,0,1,1
4555,user_4555,629,81,76,5,Mar-19,2,0,0
4556,user_4556,8174,160,90,70,May-19,0,1,1
4557,user_4557,9054,302,172,130,May-19,0,1,1
4558,user_4558,201,3,3,0,Aug-18,9,0,0
4559,user_4559,15,2,0,2,Apr-19,1,1,0
4560,user_4560,15009,94,45,49,May-19,0,1,1
4561,user_4561,4340,11,11,0,Aug-18,9,0,0
4562,user_4562,7412,84,84,0,Oct-18,7,0,0
4563,user_4563,3639,97,56,41,Apr-19,1,1,0
4564,user_4564,2955,179,153,26,May-19,0,1,1
4566,user_4566,6292,113,75,38,Mar-19,2,0,0
4568,user_4568,14984,428,61,367,May-19,0,1,1
4569,user_4569,5468,24,2,22,Apr-19,1,1,0
4570,user_4570,2695,120,66,54,May-19,0,1,1
4571,user_4571,1797,35,14,21,Apr-19,1,1,0
4572,user_4572,4666,54,41,13,Apr-19,1,1,0
4573,user_4573,16266,694,359,335,May-19,0,1,1
4574,user_4574,6529,183,163,20,Apr-19,1,1,0
4575,user_4575,46698,350,163,187,May-19,0,1,1
4576,user_4576,8126,230,150,80,Apr-19,1,1,0
4577,user_4577,7807,65,4,61,Apr-19,1,1,0
4578,user_4578,26481,745,569,176,May-19,0,1,1
4579,user_4579,21326,30,0,30,May-19,0,1,1
4580,user_4580,49353,1545,653,892,May-19,0,1,1
4581,user_4581,1307,42,35,7,May-19,0,1,1
4582,user_4582,194,16,12,4,May-19,0,1,1
4583,user_4583,2599,107,107,0,Sep-18,8,0,0
4584,user_4584,111,4,3,1,Apr-19,1,1,0
4585,user_4585,5910,230,164,66,May-19,0,1,1
4586,user_4586,302,17,9,8,Apr-19,1,1,0
4587,user_4587,13238,130,84,46,May-19,0,1,1
4588,user_4588,699,27,24,3,May-19,0,0,1
4589,user_4589,9,2,0,2,Mar-19,2,0,0
4590,user_4590,790,9,1,8,Feb-19,3,0,0
4591,user_4591,12777,232,159,73,May-19,0,1,1
4592,user_4592,24262,274,105,169,May-19,0,1,1
4593,user_4593,21385,707,542,165,May-19,0,1,1
4594,user_4594,13462,776,370,406,May-19,0,1,1
4595,user_4595,10381,290,242,48,May-19,0,1,1
4596,user_4596,63,8,5,3,Apr-19,1,1,0
4597,user_4597,2289,85,80,5,May-19,0,1,1
4598,user_4598,304,9,9,0,Aug-18,9,0,0
4599,user_4599,1041,16,16,0,Nov-18,6,0,0
4600,user_4600,15076,348,220,128,May-19,0,1,1
4601,user_4601,5653,370,279,91,May-19,0,1,1
4602,user_4602,51303,1249,662,587,May-19,0,1,1
4603,user_4603,76882,182,164,18,Apr-19,1,1,0
4604,user_4604,68523,424,236,188,May-19,0,1,1
4605,user_4605,6953,330,199,131,May-19,0,1,1
4606,user_4606,3372,56,56,0,Oct-18,7,0,0
4607,user_4607,4599,143,126,17,Apr-19,1,1,0
4608,user_4608,32445,1340,1130,210,May-19,0,1,1
4609,user_4609,4007,146,19,127,May-19,0,1,1
4610,user_4610,14790,34,31,3,Mar-19,2,0,0
4611,user_4611,15021,73,41,32,Apr-19,1,1,0
4612,user_4612,17077,182,84,98,May-19,0,1,1
4613,user_4613,7901,96,58,38,Apr-19,1,1,0
4614,user_4614,2444,31,18,13,May-19,0,1,1
4615,user_4615,3469,117,115,2,Mar-19,2,0,0
4616,user_4616,17118,292,221,71,May-19,0,1,1
4617,user_4617,3485,63,55,8,May-19,0,0,1
4618,user_4618,26156,283,216,67,May-19,0,1,1
4619,user_4619,71250,510,273,237,May-19,0,1,1
4620,user_4620,7107,11,11,0,Oct-18,7,0,0
4621,user_4621,246,10,10,0,Jul-18,10,0,0
4622,user_4622,11,7,7,0,Sep-18,8,0,0
4623,user_4623,14,3,3,0,May-18,12,0,0
4624,user_4624,1081,18,18,0,Jul-18,10,0,0
4625,user_4625,428,8,8,0,Apr-18,13,0,0
4626,user_4626,12108,112,62,50,Apr-19,1,1,0
4627,user_4627,85,13,13,0,Aug-18,9,0,0
4628,user_4628,2582,36,33,3,Feb-19,3,0,0
4629,user_4629,3394,61,43,18,Apr-19,1,1,0
4630,user_4630,907,78,54,24,May-19,0,1,1
4631,user_4631,2480,39,35,4,Apr-19,1,1,0
4632,user_4632,1535,125,119,6,Mar-19,2,0,0
4633,user_4633,545,44,13,31,May-19,0,1,1
4634,user_4634,21,2,2,0,Apr-18,13,0,0
4635,user_4635,28366,544,387,157,May-19,0,1,1
4636,user_4636,11491,208,128,80,May-19,0,1,1
4637,user_4637,282,15,10,5,Apr-19,1,1,0
4638,user_4638,471,30,25,5,Mar-19,2,0,0
4639,user_4639,422,39,38,1,Jan-19,4,0,0
4640,user_4640,2336,73,69,4,May-19,0,1,1
4641,user_4641,23915,190,122,68,May-19,0,1,1
4642,user_4642,1264,41,5,36,Mar-19,2,0,0
4643,user_4643,21476,424,248,176,May-19,0,1,1
4644,user_4644,30178,754,500,254,May-19,0,1,1
4645,user_4645,16216,114,104,10,May-19,0,1,1
4646,user_4646,201,10,2,8,Mar-19,2,0,0
4647,user_4647,14,3,3,0,Apr-18,13,0,0
4648,user_4648,121605,2749,1869,880,May-19,0,1,1
4650,user_4650,33410,262,208,54,May-19,0,1,1
4651,user_4651,2114,66,66,0,Aug-18,9,0,0
4652,user_4652,11316,396,281,115,May-19,0,1,1
4653,user_4653,24262,55,44,11,Apr-19,1,1,0
4654,user_4654,9639,222,133,89,May-19,0,1,1
4655,user_4655,5213,263,206,57,May-19,0,1,1
4656,user_4656,1420,106,104,2,Jan-19,4,0,0
4657,user_4657,12026,213,119,94,May-19,0,1,1
4658,user_4658,217,12,7,5,May-19,0,0,1
4659,user_4659,143,4,2,2,Jan-19,4,0,0
4660,user_4660,3255,37,33,4,May-19,0,1,1
4661,user_4661,18672,460,317,143,May-19,0,1,1
4662,user_4662,799,10,10,0,Jun-18,11,0,0
4663,user_4663,8144,75,21,54,Mar-19,2,0,0
4664,user_4664,20617,389,216,173,May-19,0,1,1
4665,user_4665,21129,504,317,187,May-19,0,1,1
4666,user_4666,328,11,11,0,Sep-18,8,0,0
4667,user_4667,29903,527,355,172,May-19,0,1,1
4668,user_4668,4316,76,63,13,Mar-19,2,0,0
4669,user_4669,83693,250,187,63,May-19,0,1,1
4670,user_4670,221,7,0,7,Apr-19,1,1,0
4671,user_4671,13,7,3,4,Apr-19,1,1,0
4672,user_4672,1267,15,5,10,Feb-19,3,0,0
4673,user_4673,8894,155,155,0,Jul-18,10,0,0
4674,user_4674,410,25,18,7,May-19,0,0,1
4675,user_4675,4706,67,56,11,May-19,0,1,1
4676,user_4676,14409,449,372,77,May-19,0,1,1
4677,user_4677,5123,157,119,38,May-19,0,1,1
4678,user_4678,3805,164,25,139,Apr-19,1,1,0
4679,user_4679,2294,54,16,38,Apr-19,1,1,0
4680,user_4680,95547,348,237,111,May-19,0,1,1
4681,user_4681,3820,136,48,88,May-19,0,1,1
4682,user_4682,24041,460,246,214,May-19,0,1,1
4683,user_4683,782,18,18,0,Nov-18,6,0,0
4684,user_4684,689,16,13,3,Feb-19,3,0,0
4685,user_4685,105,28,21,7,May-19,0,0,1
4686,user_4686,20475,65,46,19,Apr-19,1,1,0
4687,user_4687,7865,293,34,259,May-19,0,1,1
4688,user_4688,66,11,11,0,Nov-18,6,0,0
4689,user_4689,3902,65,38,27,May-19,0,1,1
4690,user_4690,1212,16,4,12,Feb-19,3,0,0
4691,user_4691,2584,56,21,35,Apr-19,1,1,0
4692,user_4692,8285,279,195,84,May-19,0,1,1
4693,user_4693,274,7,7,0,Jun-18,11,0,0
4694,user_4694,1454,169,103,66,May-19,0,1,1
4695,user_4695,2978,110,101,9,May-19,0,1,1
4696,user_4696,5509,84,66,18,Mar-19,2,0,0
4697,user_4697,3249,60,29,31,Apr-19,1,1,0
4698,user_4698,8600,134,134,0,Dec-18,5,0,0
4699,user_4699,80,10,10,0,Jun-18,11,0,0
4700,user_4700,542,42,0,42,May-19,0,1,1
4701,user_4701,3714,269,175,94,May-19,0,1,1
4702,user_4702,8160,55,46,9,Mar-19,2,0,0
4703,user_4703,7782,340,282,58,Apr-19,1,1,0
4704,user_4704,26,3,3,0,Apr-18,13,0,0
4705,user_4705,626,98,95,3,Jan-19,4,0,0
4706,user_4706,484,32,21,11,Apr-19,1,1,0
4707,user_4707,32539,220,162,58,May-19,0,1,1
4708,user_4708,4537,367,244,123,May-19,0,1,1
4709,user_4709,1823,53,53,0,Nov-18,6,0,0
4710,user_4710,4580,83,81,2,Apr-19,1,1,0
4711,user_4711,464,17,15,2,May-19,0,0,1
4712,user_4712,31284,433,285,148,May-19,0,1,1
4713,user_4713,444,46,30,16,May-19,0,1,1
4714,user_4714,43835,703,595,108,May-19,0,1,1
4715,user_4715,23089,1916,1082,834,May-19,0,1,1
4716,user_4716,6136,173,134,39,May-19,0,0,1
4717,user_4717,18527,405,334,71,Apr-19,1,1,0
4718,user_4718,5,1,1,0,Apr-18,13,0,0
4719,user_4719,21,4,4,0,Jun-18,11,0,0
4720,user_4720,9327,291,227,64,Feb-19,3,0,0
4721,user_4721,2817,41,38,3,Mar-19,2,0,0
4722,user_4722,12305,476,311,165,May-19,0,1,1
4723,user_4723,3902,45,39,6,May-19,0,0,1
4724,user_4724,458,11,11,0,May-18,12,0,0
4725,user_4725,6623,163,108,55,May-19,0,0,1
4726,user_4726,2788,38,20,18,Mar-19,2,0,0
4727,user_4727,14720,180,20,160,May-19,0,1,1
4728,user_4728,23103,144,119,25,May-19,0,1,1
4729,user_4729,21,4,4,0,May-18,12,0,0
4730,user_4730,1232,21,20,1,Feb-19,3,0,0
4731,user_4731,1010,28,27,1,Mar-19,2,0,0
4732,user_4732,7852,102,31,71,Feb-19,3,0,0
4733,user_4733,2756,82,22,60,Apr-19,1,1,0
4734,user_4734,26,3,3,0,Apr-18,13,0,0
4735,user_4735,3538,61,34,27,May-19,0,1,1
4736,user_4736,2245,39,15,24,Mar-19,2,0,0
4737,user_4737,403,13,4,9,Apr-19,1,1,0
4738,user_4738,4964,96,42,54,May-19,0,1,1
4739,user_4739,12496,209,203,6,Apr-19,1,1,0
4740,user_4740,1095,30,30,0,Sep-18,8,0,0
4741,user_4741,2487,79,74,5,May-19,0,0,1
4742,user_4742,6370,51,23,28,May-19,0,1,1
4743,user_4743,36746,144,104,40,Apr-19,1,1,0
4744,user_4744,8351,649,116,533,May-19,0,1,1
4745,user_4745,3607,50,18,32,May-19,0,1,1
4746,user_4746,5129,162,77,85,Apr-19,1,1,0
4747,user_4747,1428,88,46,42,May-19,0,1,1
4748,user_4748,16,3,3,0,Apr-18,13,0,0
4749,user_4749,278,14,14,0,Apr-18,13,0,0
4750,user_4750,2591,84,84,0,Nov-18,6,0,0
4751,user_4751,5198,105,96,9,May-19,0,0,1
4752,user_4752,38543,715,415,300,May-19,0,1,1
4753,user_4753,49,10,10,0,Dec-18,5,0,0
4754,user_4754,5017,80,73,7,Jan-19,4,0,0
4755,user_4755,3671,134,89,45,Apr-19,1,1,0
4756,user_4756,830,19,6,13,May-19,0,1,1
4757,user_4757,1705,67,41,26,Apr-19,1,1,0
4758,user_4758,1811,74,43,31,Mar-19,2,0,0
4759,user_4759,246,4,4,0,Apr-18,13,0,0
4760,user_4760,25,11,11,0,Oct-18,7,0,0
4761,user_4761,7429,209,152,57,May-19,0,1,1
4762,user_4762,8131,521,3,518,May-19,0,1,1
4763,user_4763,5211,137,84,53,Apr-19,1,1,0
4764,user_4764,3246,74,30,44,May-19,0,1,1
4765,user_4765,54191,313,199,114,May-19,0,1,1
4766,user_4766,2693,43,30,13,May-19,0,1,1
4768,user_4768,60,4,4,0,May-18,12,0,0
4769,user_4769,23956,387,253,134,May-19,0,1,1
4770,user_4770,4,3,3,0,Jun-18,11,0,0
4771,user_4771,18196,387,368,19,Feb-19,3,0,0
4772,user_4772,2003,53,51,2,Mar-19,2,0,0
4773,user_4773,71078,181,122,59,May-19,0,1,1
4774,user_4774,93,15,0,15,May-19,0,0,1
4775,user_4775,46328,238,147,91,May-19,0,1,1
4776,user_4776,15605,38,30,8,Mar-19,2,0,0
4777,user_4777,166,25,18,7,May-19,0,1,1
4778,user_4778,3387,133,54,79,May-19,0,1,1
4779,user_4779,7468,129,127,2,May-19,0,1,1
4780,user_4780,7368,322,219,103,May-19,0,1,1
4781,user_4781,50446,546,279,267,May-19,0,1,1
4782,user_4782,3106,148,85,63,May-19,0,1,1
4783,user_4783,664,23,7,16,May-19,0,1,1
4784,user_4784,2703,39,32,7,Apr-19,1,1,0
4785,user_4785,17712,636,629,7,Feb-19,3,0,0
4786,user_4786,2467,34,33,1,Apr-19,1,1,0
4787,user_4787,205,1,0,1,Apr-19,1,1,0
4788,user_4788,28147,645,349,296,May-19,0,1,1
4789,user_4789,275,6,5,1,Apr-19,1,1,0
4790,user_4790,7365,147,91,56,May-19,0,1,1
4791,user_4791,1757,177,167,10,Jan-19,4,0,0
4792,user_4792,3652,84,84,0,Jun-18,11,0,0
4793,user_4793,110284,97,75,22,May-19,0,1,1
4794,user_4794,12956,2,2,0,May-18,12,0,0
4795,user_4795,5371,68,66,2,Mar-19,2,0,0
4796,user_4796,9007,372,77,295,May-19,0,1,1
4797,user_4797,9,2,0,2,Apr-19,1,1,0
4798,user_4798,46603,1086,662,424,May-19,0,1,1
4799,user_4799,2195,87,54,33,May-19,0,1,1
4800,user_4800,2414,71,68,3,Apr-19,1,1,0
4801,user_4801,4041,78,69,9,Apr-19,1,1,0
4802,user_4802,4402,102,82,20,Apr-19,1,1,0
4803,user_4803,12111,843,567,276,May-19,0,1,1
4804,user_4804,50472,288,182,106,May-19,0,1,1
4805,user_4805,1217,5,5,0,Apr-18,13,0,0
4806,user_4806,21,3,3,0,Sep-18,8,0,0
4807,user_4807,6611,191,166,25,Apr-19,1,1,0
4808,user_4808,5927,94,94,0,Nov-18,6,0,0
4809,user_4809,3130,61,57,4,Feb-19,3,0,0
4810,user_4810,1843,16,1,15,Apr-19,1,1,0
4811,user_4811,198,16,16,0,May-18,12,0,0
4812,user_4812,237,54,24,30,Apr-19,1,1,0
4813,user_4813,7825,125,108,17,May-19,0,1,1
4814,user_4814,5705,77,49,28,Mar-19,2,0,0
4816,user_4816,10,1,1,0,Apr-18,13,0,0
4817,user_4817,76,15,15,0,Aug-18,9,0,0
4818,user_4818,4453,72,72,0,Dec-18,5,0,0
4819,user_4819,72186,213,111,102,May-19,0,1,1
4820,user_4820,23047,507,183,324,May-19,0,1,1
4821,user_4821,4480,185,113,72,May-19,0,1,1
4822,user_4822,4457,25,25,0,Dec-18,5,0,0
4823,user_4823,4117,143,108,35,Mar-19,2,0,0
4824,user_4824,1291,156,64,92,May-19,0,1,1
4825,user_4825,26975,388,193,195,May-19,0,1,1
4826,user_4826,41867,83,65,18,Apr-19,1,1,0
4827,user_4827,88835,1668,983,685,May-19,0,1,1
4828,user_4828,5403,99,40,59,May-19,0,1,1
4829,user_4829,397,100,95,5,Mar-19,2,0,0
4830,user_4830,28,10,9,1,Apr-19,1,1,0
4831,user_4831,5301,79,61,18,Apr-19,1,1,0
4832,user_4832,326,17,15,2,Apr-19,1,1,0
4833,user_4833,8364,139,125,14,Mar-19,2,0,0
4834,user_4834,96,12,12,0,Sep-18,8,0,0
4835,user_4835,31,6,6,0,May-18,12,0,0
4836,user_4836,67201,262,170,92,May-19,0,1,1
4837,user_4837,544,26,26,0,May-18,12,0,0
4838,user_4838,10353,844,749,95,May-19,0,1,1
4839,user_4839,2098,374,244,130,May-19,0,1,1
4840,user_4840,3294,55,53,2,Mar-19,2,0,0
4841,user_4841,4876,65,56,9,Apr-19,1,1,0
4842,user_4842,4936,52,47,5,Mar-19,2,0,0
4843,user_4843,29866,195,136,59,May-19,0,1,1
4844,user_4844,75,2,2,0,Apr-18,13,0,0
4845,user_4845,5071,88,47,41,May-19,0,1,1
4846,user_4846,3481,22,22,0,Oct-18,7,0,0
4847,user_4847,15457,193,97,96,May-19,0,1,1
4848,user_4848,34637,644,418,226,May-19,0,1,1
4849,user_4849,127121,241,95,146,May-19,0,1,1
4850,user_4850,32797,555,361,194,May-19,0,1,1
4851,user_4851,8971,121,81,40,Apr-19,1,1,0
4852,user_4852,1925,24,24,0,Sep-18,8,0,0
4853,user_4853,32433,172,65,107,May-19,0,1,1
4854,user_4854,52853,508,427,81,May-19,0,1,1
4855,user_4855,1811,28,28,0,Jul-18,10,0,0
4856,user_4856,25060,551,328,223,May-19,0,1,1
4857,user_4857,6569,31,13,18,May-19,0,1,1
4858,user_4858,62,27,27,0,Sep-18,8,0,0
4859,user_4859,103,9,9,0,Oct-18,7,0,0
4860,user_4860,30882,68,62,6,Apr-19,1,1,0
4861,user_4861,32772,80,37,43,Apr-19,1,1,0
4862,user_4862,69,4,4,0,May-18,12,0,0
4863,user_4863,5050,408,228,180,May-19,0,1,1
4864,user_4864,38903,73,40,33,May-19,0,1,1
4865,user_4865,1573,11,11,0,Aug-18,9,0,0
4866,user_4866,21669,923,659,264,May-19,0,1,1
4867,user_4867,25266,323,172,151,May-19,0,1,1
4868,user_4868,5055,120,43,77,May-19,0,1,1
4869,user_4869,11829,632,541,91,May-19,0,1,1
4870,user_4870,5902,200,196,4,Jan-19,4,0,0
4871,user_4871,6073,99,65,34,Apr-19,1,1,0
4873,user_4873,2870,40,20,20,Apr-19,1,1,0
4874,user_4874,86,2,0,2,Mar-19,2,0,0
4875,user_4875,1421,21,21,0,Jun-18,11,0,0
4876,user_4876,2555,245,136,109,May-19,0,1,1
4877,user_4877,14,3,3,0,Apr-18,13,0,0
4878,user_4878,7464,317,273,44,May-19,0,1,1
4879,user_4879,709,37,32,5,Mar-19,2,0,0
4880,user_4880,1067,63,59,4,Mar-19,2,0,0
4881,user_4881,8672,68,52,16,May-19,0,1,1
4882,user_4882,6517,211,211,0,Dec-18,5,0,0
4883,user_4883,6180,407,351,56,May-19,0,1,1
4884,user_4884,19363,281,250,31,May-19,0,1,1
4885,user_4885,358,8,8,0,May-18,12,0,0
4886,user_4886,1845,113,88,25,Apr-19,1,1,0
4887,user_4887,3484,144,144,0,Dec-18,5,0,0
4888,user_4888,245,18,2,16,May-19,0,1,1
4889,user_4889,2397,122,121,1,May-19,0,0,1
4890,user_4890,121,6,6,0,Oct-18,7,0,0
4891,user_4891,4424,130,80,50,Apr-19,1,1,0
4892,user_4892,8728,136,99,37,May-19,0,1,1
4893,user_4893,5072,327,251,76,May-19,0,1,1
4895,user_4895,832,35,21,14,May-19,0,1,1
4896,user_4896,5344,268,153,115,May-19,0,1,1
4897,user_4897,127,18,15,3,May-19,0,0,1
4898,user_4898,266,11,0,11,May-19,0,1,1
4899,user_4899,2033,91,14,77,May-19,0,1,1
4900,user_4900,19,13,9,4,Apr-19,1,1,0
4901,user_4901,10,1,1,0,Jun-18,11,0,0
4902,user_4902,6195,134,133,1,Apr-19,1,1,0
4903,user_4903,9350,320,305,15,May-19,0,1,1
4904,user_4904,642,41,24,17,Feb-19,3,0,0
4905,user_4905,14170,288,174,114,May-19,0,1,1
4906,user_4906,52,3,3,0,May-18,12,0,0
4907,user_4907,2062,157,61,96,May-19,0,1,1
4908,user_4908,5374,116,74,42,May-19,0,1,1
4909,user_4909,17386,433,279,154,May-19,0,1,1
4910,user_4910,1863,51,51,0,Aug-18,9,0,0
4911,user_4911,3087,98,2,96,May-19,0,1,1
4912,user_4912,105,23,22,1,Feb-19,3,0,0
4913,user_4913,445,64,36,28,May-19,0,1,1
4914,user_4914,46,6,3,3,Apr-19,1,1,0
4915,user_4915,3796,94,48,46,May-19,0,1,1
4916,user_4916,13956,225,182,43,May-19,0,1,1
4917,user_4917,97,6,6,0,May-18,12,0,0
4918,user_4918,3559,136,136,0,Dec-18,5,0,0
4919,user_4919,5599,118,0,118,May-19,0,1,1
4920,user_4920,6664,301,1,300,May-19,0,1,1
4921,user_4921,16398,477,300,177,May-19,0,1,1
4922,user_4922,138,21,18,3,Apr-19,1,1,0
4923,user_4923,4535,725,375,350,May-19,0,1,1
4924,user_4924,7853,63,29,34,May-19,0,1,1
4925,user_4925,7598,104,64,40,Apr-19,1,1,0
4926,user_4926,9,12,1,11,Feb-19,3,0,0
4927,user_4927,3040,116,113,3,Mar-19,2,0,0
4928,user_4928,9799,32,29,3,May-19,0,0,1
4929,user_4929,2595,179,99,80,May-19,0,1,1
4930,user_4930,255,12,12,0,Jun-18,11,0,0
4931,user_4931,66250,68,45,23,Apr-19,1,1,0
4932,user_4932,4758,54,14,40,May-19,0,1,1
4933,user_4933,64550,826,606,220,May-19,0,1,1
4934,user_4934,1363,7,7,0,Aug-18,9,0,0
4935,user_4935,17713,277,194,83,May-19,0,1,1
4936,user_4936,1316,67,54,13,May-19,0,0,1
4937,user_4937,5,1,1,0,Apr-18,13,0,0
4938,user_4938,51,8,8,0,Oct-18,7,0,0
4939,user_4939,6172,389,294,95,May-19,0,1,1
4940,user_4940,19,3,3,0,Apr-18,13,0,0
4941,user_4941,17081,923,604,319,May-19,0,1,1
4942,user_4942,8642,148,87,61,May-19,0,1,1
4943,user_4943,72349,1280,640,640,May-19,0,1,1
4944,user_4944,789,47,23,24,Apr-19,1,1,0
4945,user_4945,51712,195,136,59,May-19,0,1,1
4946,user_4946,519,102,54,48,May-19,0,1,1
4947,user_4947,140,6,6,0,Oct-18,7,0,0
4948,user_4948,22856,1079,815,264,May-19,0,1,1
4949,user_4949,39544,226,168,58,May-19,0,1,1
4950,user_4950,23977,171,91,80,May-19,0,1,1
4951,user_4951,9098,257,168,89,May-19,0,1,1
4952,user_4952,1850,25,17,8,May-19,0,1,1
4953,user_4953,24320,1245,873,372,May-19,0,1,1
4954,user_4954,9,2,2,0,Apr-18,13,0,0
4956,user_4956,507,14,14,0,Nov-18,6,0,0
4957,user_4957,991,15,15,0,May-18,12,0,0
4958,user_4958,23,4,4,0,May-18,12,0,0
4959,user_4959,1999,267,68,199,May-19,0,1,1
4960,user_4960,25772,124,121,3,Jan-19,4,0,0
4961,user_4961,36740,67,46,21,May-19,0,1,1
4962,user_4962,10,6,6,0,May-18,12,0,0
4963,user_4963,1501,17,17,0,Jun-18,11,0,0
4964,user_4964,28002,365,275,90,May-19,0,1,1
4965,user_4965,2193,71,18,53,May-19,0,1,1
4966,user_4966,20009,752,394,358,May-19,0,1,1
4967,user_4967,15011,161,127,34,May-19,0,1,1
4968,user_4968,544,33,33,0,Jun-18,11,0,0
4969,user_4969,350,38,38,0,Dec-18,5,0,0
4970,user_4970,18003,480,252,228,May-19,0,1,1
4971,user_4971,3855,43,34,9,May-19,0,0,1
4972,user_4972,10,1,1,0,May-18,12,0,0
4973,user_4973,315,6,6,0,Jul-18,10,0,0
4974,user_4974,5276,214,187,27,Apr-19,1,1,0
4975,user_4975,729,24,0,24,May-19,0,1,1
4976,user_4976,15830,342,185,157,May-19,0,1,1
4977,user_4977,5798,75,53,22,May-19,0,1,1
4978,user_4978,2902,100,66,34,May-19,0,1,1
4979,user_4979,5282,59,42,17,Apr-19,1,1,0
4980,user_4980,2,2,1,1,Jan-19,4,0,0
4982,user_4982,13721,553,321,232,May-19,0,1,1
4983,user_4983,606,32,24,8,Apr-19,1,1,0
4984,user_4984,9947,110,110,0,Nov-18,6,0,0
4985,user_4985,8646,125,116,9,Apr-19,1,1,0
4986,user_4986,11264,400,271,129,Apr-19,1,1,0
4987,user_4987,1531,72,53,19,May-19,0,1,1
4988,user_4988,18298,153,105,48,May-19,0,1,1
4989,user_4989,11232,123,90,33,Apr-19,1,1,0
4990,user_4990,17315,85,18,67,Apr-19,1,1,0
4991,user_4991,8346,98,54,44,Mar-19,2,0,0
4992,user_4992,3880,92,92,0,Nov-18,6,0,0
4993,user_4993,11009,183,78,105,May-19,0,1,1
4994,user_4994,21392,33,23,10,Apr-19,1,1,0
4995,user_4995,1444,82,78,4,Jan-19,4,0,0
4996,user_4996,9247,143,85,58,May-19,0,1,1
4998,user_4998,211,10,10,0,Dec-18,5,0,0
4999,user_4999,16818,1226,452,774,May-19,0,1,1
5000,user_5000,47070,180,90,90,May-19,0,1,1
5001,user_5001,6122,290,219,71,Apr-19,1,1,0
5002,user_5002,93536,1155,698,457,May-19,0,1,1
5003,user_5003,2057,113,106,7,May-19,0,0,1
5004,user_5004,1001,42,33,9,Mar-19,2,0,0
5005,user_5005,1967,12,12,0,Nov-18,6,0,0
5006,user_5006,19927,222,221,1,Feb-19,3,0,0
5007,user_5007,1010,38,38,0,Sep-18,8,0,0
5008,user_5008,72,5,5,0,Nov-18,6,0,0
5009,user_5009,1303,23,19,4,Mar-19,2,0,0
5010,user_5010,1531,103,21,82,May-19,0,1,1
5011,user_5011,18,3,2,1,May-19,0,0,1
5012,user_5012,49789,733,716,17,May-19,0,1,1
5013,user_5013,205,13,13,0,Apr-18,13,0,0
5014,user_5014,3454,19,19,0,Sep-18,8,0,0
5015,user_5015,66803,610,340,270,May-19,0,1,1
5016,user_5016,32728,627,364,263,May-19,0,1,1
5017,user_5017,36947,358,218,140,May-19,0,1,1
5018,user_5018,2468,96,72,24,Mar-19,2,0,0
5019,user_5019,8531,761,450,311,May-19,0,1,1
5020,user_5020,181,17,12,5,Apr-19,1,1,0
5021,user_5021,3046,59,51,8,Apr-19,1,1,0
5022,user_5022,2266,113,54,59,May-19,0,1,1
5023,user_5023,24383,405,146,259,May-19,0,1,1
5024,user_5024,2958,53,47,6,Apr-19,1,1,0
5025,user_5025,101,5,5,0,Sep-18,8,0,0
5026,user_5026,1053,41,39,2,Apr-19,1,1,0
5027,user_5027,731,38,38,0,Jul-18,10,0,0
5028,user_5028,3569,20,20,0,Oct-18,7,0,0
5029,user_5029,25246,282,92,190,May-19,0,1,1
5030,user_5030,9028,413,198,215,May-19,0,1,1
5031,user_5031,2300,48,29,19,May-19,0,1,1
5032,user_5032,1782,48,32,16,Apr-19,1,1,0
5033,user_5033,5103,44,43,1,Apr-19,1,1,0
5034,user_5034,1911,12,12,0,Aug-18,9,0,0
5035,user_5035,370,3,3,0,May-18,12,0,0
5036,user_5036,4062,73,31,42,Apr-19,1,1,0
5037,user_5037,149,39,30,9,Apr-19,1,1,0
5038,user_5038,5449,124,124,0,Oct-18,7,0,0
5039,user_5039,1785,19,11,8,May-19,0,1,1
5040,user_5040,39548,728,536,192,May-19,0,1,1
5041,user_5041,13836,268,135,133,May-19,0,1,1
5042,user_5042,6605,137,89,48,May-19,0,1,1
5043,user_5043,845,17,0,17,Apr-19,1,1,0
5044,user_5044,41,9,9,0,Nov-18,6,0,0
5045,user_5045,4637,77,77,0,Aug-18,9,0,0
5046,user_5046,198,26,26,0,Aug-18,9,0,0
5047,user_5047,2035,67,25,42,May-19,0,1,1
5048,user_5048,13170,422,312,110,May-19,0,0,1
5049,user_5049,8822,169,52,117,Apr-19,1,1,0
5050,user_5050,5005,64,54,10,Apr-19,1,1,0
5051,user_5051,26,3,3,0,May-18,12,0,0
5052,user_5052,15922,244,205,39,Mar-19,2,0,0
5053,user_5053,1809,56,31,25,May-19,0,1,1
5054,user_5054,6006,262,120,142,May-19,0,1,1
5055,user_5055,5585,81,81,0,Aug-18,9,0,0
5056,user_5056,13391,411,251,160,May-19,0,1,1
5057,user_5057,10046,185,82,103,May-19,0,1,1
5058,user_5058,23001,635,281,354,May-19,0,1,1
5059,user_5059,7761,73,46,27,Mar-19,2,0,0
5060,user_5060,1784,108,82,26,May-19,0,1,1
5061,user_5061,1303,44,39,5,Jan-19,4,0,0
5062,user_5062,2586,100,41,59,May-19,0,1,1
5063,user_5063,8001,131,95,36,May-19,0,1,1
5064,user_5064,4373,182,118,64,May-19,0,1,1
5065,user_5065,12132,220,170,50,May-19,0,1,1
5066,user_5066,22168,483,355,128,May-19,0,1,1
5067,user_5067,2101,236,193,43,May-19,0,1,1
5068,user_5068,3129,57,43,14,Mar-19,2,0,0
5069,user_5069,565,11,11,0,Dec-18,5,0,0
5070,user_5070,62034,225,110,115,Apr-19,1,1,0
5071,user_5071,3793,65,65,0,Dec-18,5,0,0
5072,user_5072,18,3,2,1,Jan-19,4,0,0
5073,user_5073,2771,16,16,0,Sep-18,8,0,0
5074,user_5074,1077,47,47,0,Dec-18,5,0,0
5075,user_5075,12727,49,15,34,Mar-19,2,0,0
5076,user_5076,2558,64,63,1,Jan-19,4,0,0
5077,user_5077,8902,100,38,62,May-19,0,1,1
5078,user_5078,12322,684,639,45,Apr-19,1,1,0
5079,user_5079,1039,75,59,16,Feb-19,3,0,0
5080,user_5080,681,26,26,0,Nov-18,6,0,0
5081,user_5081,1463,24,16,8,Feb-19,3,0,0
5082,user_5082,36,5,5,0,May-18,12,0,0
5083,user_5083,75,13,13,0,Jun-18,11,0,0
5084,user_5084,10229,229,86,143,May-19,0,1,1
5085,user_5085,34,6,6,0,Jul-18,10,0,0
5086,user_5086,7512,107,98,9,Apr-19,1,1,0
5087,user_5087,152,12,9,3,May-19,0,0,1
5088,user_5088,9,2,0,2,Mar-19,2,0,0
5089,user_5089,498,48,48,0,Jul-18,10,0,0
5090,user_5090,1047,45,41,4,Mar-19,2,0,0
5091,user_5091,14444,880,495,385,May-19,0,1,1
5092,user_5092,93121,75,73,2,Apr-19,1,1,0
5093,user_5093,20248,295,188,107,May-19,0,1,1
5094,user_5094,1121,62,32,30,May-19,0,1,1
5095,user_5095,23517,444,242,202,Apr-19,1,1,0
5097,user_5097,6040,218,53,165,May-19,0,1,1
5098,user_5098,136,11,11,0,Jul-18,10,0,0
5099,user_5099,11988,55,21,34,Apr-19,1,1,0
5100,user_5100,10291,42,2,40,Apr-19,1,1,0
5101,user_5101,23486,89,55,34,Apr-19,1,1,0
5102,user_5102,13559,150,49,101,Mar-19,2,0,0
5103,user_5103,11139,431,200,231,May-19,0,1,1
5104,user_5104,435,20,17,3,Mar-19,2,0,0
5105,user_5105,11784,53,31,22,May-19,0,1,1
5106,user_5106,17207,526,383,143,Apr-19,1,1,0
5108,user_5108,28838,633,369,264,May-19,0,1,1
5109,user_5109,1439,70,69,1,Mar-19,2,0,0
5110,user_5110,28,6,5,1,Apr-19,1,1,0
5111,user_5111,6236,283,219,64,Apr-19,1,1,0
5112,user_5112,45,4,2,2,Jan-19,4,0,0
5113,user_5113,2216,139,50,89,May-19,0,1,1
5114,user_5114,4819,111,63,48,May-19,0,1,1
5115,user_5115,431,33,30,3,Mar-19,2,0,0
5117,user_5117,2149,77,70,7,May-19,0,0,1
5118,user_5118,3448,261,131,130,May-19,0,1,1
5119,user_5119,34787,231,200,31,May-19,0,1,1
5120,user_5120,137454,793,107,686,May-19,0,1,1
5121,user_5121,5712,155,53,102,May-19,0,1,1
5122,user_5122,7659,209,112,97,May-19,0,1,1
5123,user_5123,311019,199,54,145,May-19,0,1,1
5124,user_5124,3144,344,300,44,May-19,0,1,1
5125,user_5125,16,3,3,0,May-18,12,0,0
5126,user_5126,21,3,3,0,Sep-18,8,0,0
5127,user_5127,651,30,18,12,Mar-19,2,0,0
5128,user_5128,1950,48,24,24,May-19,0,1,1
5129,user_5129,40,3,3,0,Oct-18,7,0,0
5130,user_5130,1185,14,14,0,Jun-18,11,0,0
5131,user_5131,1018,9,9,0,Aug-18,9,0,0
5132,user_5132,35229,103,70,33,Apr-19,1,1,0
5134,user_5134,1565,68,59,9,Mar-19,2,0,0
5135,user_5135,28976,205,108,97,May-19,0,1,1
5136,user_5136,3041,80,3,77,May-19,0,1,1
5137,user_5137,13,3,3,0,May-18,12,0,0
5138,user_5138,589,17,15,2,May-19,0,0,1
5139,user_5139,863,50,49,1,Mar-19,2,0,0
5140,user_5140,4662,200,129,71,May-19,0,1,1
5141,user_5141,54419,859,433,426,May-19,0,1,1
5142,user_5142,19014,59,37,22,Apr-19,1,1,0
5143,user_5143,242,13,13,0,Jul-18,10,0,0
5144,user_5144,30693,671,388,283,May-19,0,1,1
5145,user_5145,3000,21,12,9,Mar-19,2,0,0
5146,user_5146,11632,249,213,36,May-19,0,1,1
5147,user_5147,30204,78,78,0,Aug-18,9,0,0
5148,user_5148,32405,151,79,72,May-19,0,1,1
5149,user_5149,1639,36,22,14,May-19,0,0,1
5150,user_5150,10684,688,525,163,May-19,0,1,1
5151,user_5151,15707,26,21,5,Feb-19,3,0,0
5152,user_5152,18,2,2,0,Nov-18,6,0,0
5153,user_5153,2263,73,25,48,May-19,0,1,1
5154,user_5154,523,17,5,12,May-19,0,0,1
5155,user_5155,2661,69,43,26,May-19,0,1,1
5156,user_5156,4351,129,51,78,May-19,0,1,1
5157,user_5157,2883,20,15,5,Mar-19,2,0,0
5158,user_5158,18972,134,120,14,Apr-19,1,1,0
5159,user_5159,12540,60,51,9,Apr-19,1,1,0
5160,user_5160,168,22,6,16,Feb-19,3,0,0
5161,user_5161,14071,67,35,32,Apr-19,1,1,0
5162,user_5162,9,2,2,0,May-18,12,0,0
5163,user_5163,827,21,13,8,Mar-19,2,0,0
5164,user_5164,179,14,14,0,Nov-18,6,0,0
5165,user_5165,3813,30,19,11,Feb-19,3,0,0
5167,user_5167,19211,367,126,241,May-19,0,1,1
5168,user_5168,1046,35,32,3,May-19,0,0,1
5169,user_5169,24,5,4,1,Jan-19,4,0,0
5170,user_5170,6399,136,10,126,May-19,0,1,1
5171,user_5171,269,29,4,25,May-19,0,1,1
5172,user_5172,6956,95,54,41,Apr-19,1,1,0
5173,user_5173,1085,30,8,22,May-19,0,1,1
5174,user_5174,194,20,20,0,Sep-18,8,0,0
5175,user_5175,6450,360,148,212,May-19,0,1,1
5176,user_5176,22098,728,302,426,May-19,0,1,1
5177,user_5177,407,3,3,0,May-18,12,0,0
5178,user_5178,7833,144,58,86,May-19,0,1,1
5179,user_5179,19,4,4,0,Aug-18,9,0,0
5180,user_5180,10983,565,110,455,May-19,0,1,1
5181,user_5181,5304,82,73,9,Apr-19,1,1,0
5182,user_5182,9925,651,285,366,May-19,0,1,1
5183,user_5183,2879,14,14,0,Jul-18,10,0,0
5184,user_5184,18,3,2,1,May-19,0,0,1
5185,user_5185,1256,125,46,79,May-19,0,1,1
5186,user_5186,1498,63,61,2,May-19,0,0,1
5187,user_5187,4072,98,45,53,May-19,0,1,1
5188,user_5188,11315,422,422,0,Nov-18,6,0,0
5189,user_5189,23068,247,17,230,May-19,0,1,1
5190,user_5190,140,19,3,16,Mar-19,2,0,0
5191,user_5191,1805,81,49,32,May-19,0,1,1
5192,user_5192,16,3,3,0,May-18,12,0,0
5193,user_5193,6893,112,58,54,May-19,0,1,1
5194,user_5194,977,33,7,26,May-19,0,1,1
5195,user_5195,781,6,6,0,May-18,12,0,0
5196,user_5196,42873,329,188,141,May-19,0,1,1
5197,user_5197,13557,261,261,0,Dec-18,5,0,0
5198,user_5198,132,19,19,0,Nov-18,6,0,0
5199,user_5199,43,4,4,0,Oct-18,7,0,0
5200,user_5200,66,9,8,1,Apr-19,1,1,0
5201,user_5201,2889,100,67,33,May-19,0,1,1
5202,user_5202,308,4,0,4,Apr-19,1,1,0
5203,user_5203,2843,72,41,31,Mar-19,2,0,0
5204,user_5204,2866,60,40,20,May-19,0,1,1
5205,user_5205,6975,110,88,22,Apr-19,1,1,0
5206,user_5206,526,12,12,0,Jun-18,11,0,0
5207,user_5207,1818,81,60,21,Apr-19,1,1,0
5208,user_5208,21983,842,362,480,May-19,0,1,1
5209,user_5209,1226,39,14,25,Mar-19,2,0,0
5210,user_5210,1847,54,42,12,Mar-19,2,0,0
5211,user_5211,54,21,16,5,Apr-19,1,1,0
5212,user_5212,29103,434,273,161,May-19,0,1,1
5213,user_5213,416,17,15,2,Mar-19,2,0,0
5214,user_5214,8126,264,14,250,May-19,0,1,1
5215,user_5215,1967,2,2,0,May-18,12,0,0
5216,user_5216,150,14,6,8,Apr-19,1,1,0
5217,user_5217,99414,2224,2092,132,May-19,0,1,1
5218,user_5218,4832,107,98,9,May-19,0,1,1
5219,user_5219,2038,110,50,60,May-19,0,1,1
5220,user_5220,47,18,16,2,Feb-19,3,0,0
5221,user_5221,13202,444,249,195,May-19,0,1,1
5222,user_5222,24577,87,87,0,Dec-18,5,0,0
5223,user_5223,11681,155,93,62,Apr-19,1,1,0
5224,user_5224,55297,461,277,184,May-19,0,1,1
5225,user_5225,10178,259,205,54,May-19,0,1,1
5226,user_5226,1453,22,22,0,Jun-18,11,0,0
5227,user_5227,2110,107,27,80,May-19,0,1,1
5228,user_5228,1274,29,28,1,Mar-19,2,0,0
5229,user_5229,6172,49,37,12,Jan-19,4,0,0
5230,user_5230,724,166,120,46,Apr-19,1,1,0
5231,user_5231,1820,55,55,0,Nov-18,6,0,0
5232,user_5232,130,16,11,5,Mar-19,2,0,0
5233,user_5233,6634,99,62,37,May-19,0,1,1
5234,user_5234,5737,82,52,30,May-19,0,1,1
5235,user_5235,11337,121,95,26,May-19,0,0,1
5236,user_5236,1507,34,0,34,Mar-19,2,0,0
5237,user_5237,21,4,4,0,May-18,12,0,0
5238,user_5238,1936,86,86,0,Aug-18,9,0,0
5239,user_5239,73876,426,272,154,May-19,0,1,1
5240,user_5240,782,28,28,0,Jun-18,11,0,0
5241,user_5241,624,33,33,0,Nov-18,6,0,0
5242,user_5242,130,17,15,2,Apr-19,1,1,0
5243,user_5243,6488,84,81,3,May-19,0,0,1
5244,user_5244,404,12,12,0,Aug-18,9,0,0
5245,user_5245,764,29,28,1,Mar-19,2,0,0
5246,user_5246,345,5,5,0,Jun-18,11,0,0
5247,user_5247,3841,50,35,15,Apr-19,1,1,0
5248,user_5248,14565,23,20,3,Apr-19,1,1,0
5249,user_5249,201,3,3,0,May-18,12,0,0
5250,user_5250,11878,665,397,268,May-19,0,1,1
5251,user_5251,163951,284,164,120,May-19,0,1,1
5252,user_5252,26421,155,83,72,May-19,0,1,1
5253,user_5253,1942,64,41,23,Mar-19,2,0,0
5254,user_5254,2563,54,52,2,Mar-19,2,0,0
5255,user_5255,697,12,12,0,Jul-18,10,0,0
5256,user_5256,7670,280,176,104,May-19,0,1,1
5257,user_5257,1,1,1,0,Jun-18,11,0,0
5258,user_5258,6438,119,93,26,May-19,0,1,1
5259,user_5259,31941,153,93,60,May-19,0,1,1
5260,user_5260,5090,96,66,30,May-19,0,0,1
5261,user_5261,2789,95,4,91,Apr-19,1,1,0
5262,user_5262,8031,185,143,42,Apr-19,1,1,0
5263,user_5263,2175,36,25,11,Mar-19,2,0,0
5264,user_5264,30561,724,436,288,May-19,0,1,1
5265,user_5265,12734,146,70,76,May-19,0,1,1
5266,user_5266,40,2,0,2,Feb-19,3,0,0
5267,user_5267,62,8,8,0,Jul-18,10,0,0
5268,user_5268,10641,483,258,225,May-19,0,1,1
5269,user_5269,719,21,12,9,Feb-19,3,0,0
5270,user_5270,4134,78,54,24,May-19,0,1,1
5271,user_5271,24514,530,415,115,Apr-19,1,1,0
5272,user_5272,13915,403,232,171,Apr-19,1,1,0
5274,user_5274,6011,108,102,6,Apr-19,1,1,0
5276,user_5276,100,5,5,0,Jun-18,11,0,0
5277,user_5277,15887,516,165,351,May-19,0,1,1
5278,user_5278,9168,302,93,209,May-19,0,1,1
5279,user_5279,322,16,9,7,Apr-19,1,1,0
5281,user_5281,5704,126,83,43,May-19,0,1,1
5282,user_5282,5429,39,22,17,Mar-19,2,0,0
5283,user_5283,35,3,3,0,May-18,12,0,0
5284,user_5284,14,2,2,0,May-18,12,0,0
5285,user_5285,684,8,3,5,May-19,0,1,1
5286,user_5286,14,3,3,0,May-18,12,0,0
5287,user_5287,1179,50,50,0,Jul-18,10,0,0
5288,user_5288,91,11,11,0,Sep-18,8,0,0
5289,user_5289,1843,37,4,33,Apr-19,1,1,0
5290,user_5290,6126,159,2,157,May-19,0,1,1
5291,user_5291,20,4,4,0,May-18,12,0,0
5292,user_5292,33473,520,366,154,May-19,0,1,1
5293,user_5293,5964,398,244,154,May-19,0,1,1
5294,user_5294,2368,142,58,84,May-19,0,1,1
5295,user_5295,10463,173,15,158,Mar-19,2,0,0
5296,user_5296,3054,56,37,19,Jan-19,4,0,0
5297,user_5297,4864,150,118,32,May-19,0,1,1
5298,user_5298,674,37,37,0,Aug-18,9,0,0
5299,user_5299,8699,191,98,93,May-19,0,1,1
5300,user_5300,3710,58,41,17,Mar-19,2,0,0
5301,user_5301,2373,149,144,5,Feb-19,3,0,0
5302,user_5302,23931,225,211,14,Mar-19,2,0,0
5303,user_5303,55,8,7,1,May-19,0,0,1
5304,user_5304,6357,221,182,39,Apr-19,1,1,0
5305,user_5305,6369,165,111,54,May-19,0,1,1
5306,user_5306,13516,248,217,31,May-19,0,1,1
5307,user_5307,5198,396,117,279,May-19,0,1,1
5308,user_5308,9608,170,126,44,Apr-19,1,1,0
5309,user_5309,32,5,5,0,Aug-18,9,0,0
5310,user_5310,1565,72,60,12,May-19,0,1,1
5311,user_5311,1448,204,127,77,Apr-19,1,1,0
5312,user_5312,43,2,2,0,May-18,12,0,0
5313,user_5313,44403,388,34,354,May-19,0,1,1
5314,user_5314,7505,377,263,114,May-19,0,1,1
5315,user_5315,8218,128,122,6,May-19,0,1,1
5316,user_5316,17199,419,225,194,May-19,0,1,1
5317,user_5317,4431,77,66,11,Apr-19,1,1,0
5318,user_5318,11,2,2,0,May-18,12,0,0
5319,user_5319,79,7,6,1,Mar-19,2,0,0
5320,user_5320,98,12,12,0,Dec-18,5,0,0
5321,user_5321,809,57,56,1,Apr-19,1,1,0
5322,user_5322,14750,174,160,14,Feb-19,3,0,0
5323,user_5323,5642,232,205,27,Apr-19,1,1,0
5324,user_5324,44993,498,441,57,May-19,0,1,1
5325,user_5325,13561,177,101,76,May-19,0,1,1
5326,user_5326,1873,28,24,4,May-19,0,1,1
5327,user_5327,1129,34,22,12,May-19,0,1,1
5328,user_5328,6702,156,92,64,Apr-19,1,1,0
5329,user_5329,101,30,18,12,May-19,0,1,1
5330,user_5330,1390,116,84,32,Apr-19,1,1,0
5331,user_5331,23518,721,278,443,May-19,0,1,1
5333,user_5333,10046,253,173,80,May-19,0,1,1
5334,user_5334,25,4,4,0,May-18,12,0,0
5335,user_5335,51,9,5,4,Feb-19,3,0,0
5336,user_5336,2698,103,78,25,Apr-19,1,1,0
5337,user_5337,11569,382,324,58,May-19,0,1,1
5338,user_5338,6877,164,147,17,Mar-19,2,0,0
5339,user_5339,41080,1441,847,594,May-19,0,1,1
5341,user_5341,2568,153,52,101,May-19,0,1,1
5342,user_5342,98560,49,31,18,May-19,0,1,1
5343,user_5343,6303,203,129,74,May-19,0,1,1
5344,user_5344,2860,53,31,22,May-19,0,1,1
5345,user_5345,8988,198,22,176,Apr-19,1,1,0
5346,user_5346,12271,191,53,138,Mar-19,2,0,0
5347,user_5347,1014,53,39,14,May-19,0,0,1
5348,user_5348,5252,198,177,21,Mar-19,2,0,0
5349,user_5349,61937,1509,713,796,May-19,0,1,1
5350,user_5350,2181,78,56,22,Mar-19,2,0,0
5351,user_5351,1378,46,22,24,Apr-19,1,1,0
5352,user_5352,691,48,27,21,May-19,0,1,1
5353,user_5353,6244,58,24,34,May-19,0,1,1
5354,user_5354,16736,237,133,104,Apr-19,1,1,0
5355,user_5355,4097,191,111,80,May-19,0,1,1
5356,user_5356,2248,65,65,0,Nov-18,6,0,0
5357,user_5357,5094,280,237,43,May-19,0,1,1
5358,user_5358,46080,60,39,21,May-19,0,1,1
5359,user_5359,9229,274,29,245,May-19,0,1,1
5360,user_5360,7027,147,147,0,Aug-18,9,0,0
5361,user_5361,58,9,3,6,Mar-19,2,0,0
5362,user_5362,10075,190,97,93,May-19,0,1,1
5363,user_5363,18163,311,43,268,May-19,0,1,1
5364,user_5364,33,6,6,0,Sep-18,8,0,0
5365,user_5365,2701,76,76,0,Jun-18,11,0,0
5366,user_5366,6895,94,60,34,Apr-19,1,1,0
5367,user_5367,5525,78,10,68,May-19,0,1,1
5368,user_5368,2294,66,48,18,May-19,0,1,1
5369,user_5369,584,17,17,0,Aug-18,9,0,0
5370,user_5370,580,29,21,8,Apr-19,1,1,0
5371,user_5371,35762,123,84,39,May-19,0,1,1
5372,user_5372,2912,72,30,42,Apr-19,1,1,0
5373,user_5373,2361,27,23,4,Mar-19,2,0,0
5374,user_5374,3280,128,46,82,May-19,0,1,1
5375,user_5375,175,18,4,14,May-19,0,0,1
5376,user_5376,10674,227,89,138,May-19,0,1,1
5377,user_5377,6748,52,52,0,Dec-18,5,0,0
5378,user_5378,12870,259,196,63,May-19,0,1,1
5379,user_5379,5000,222,145,77,May-19,0,1,1
5380,user_5380,2406,115,110,5,Apr-19,1,1,0
5381,user_5381,158,9,9,0,May-18,12,0,0
5382,user_5382,258,32,25,7,Apr-19,1,1,0
5383,user_5383,204,7,7,0,May-18,12,0,0
5384,user_5384,28315,295,89,206,May-19,0,0,1
5385,user_5385,10968,223,113,110,May-19,0,1,1
5386,user_5386,35828,61,53,8,Apr-19,1,1,0
5387,user_5387,25239,211,103,108,May-19,0,1,1
5388,user_5388,1921,97,68,29,May-19,0,1,1
5389,user_5389,2180,126,81,45,Apr-19,1,1,0
5390,user_5390,22,2,2,0,May-18,12,0,0
5391,user_5391,123,6,6,0,Jun-18,11,0,0
5392,user_5392,282,34,24,10,Feb-19,3,0,0
5393,user_5393,46212,274,72,202,May-19,0,1,1
5394,user_5394,1440,30,12,18,May-19,0,0,1
5395,user_5395,8377,212,107,105,May-19,0,1,1
5397,user_5397,77,6,6,0,Sep-18,8,0,0
5398,user_5398,70,1,1,0,May-18,12,0,0
5399,user_5399,422,6,0,6,May-19,0,0,1
5400,user_5400,5477,282,156,126,May-19,0,1,1
5401,user_5401,33004,942,532,410,May-19,0,1,1
5402,user_5402,4900,98,74,24,Mar-19,2,0,0
5403,user_5403,19140,221,183,38,May-19,0,1,1
5404,user_5404,3668,101,50,51,May-19,0,1,1
5405,user_5405,2230,176,167,9,Mar-19,2,0,0
5406,user_5406,15790,498,405,93,May-19,0,1,1
5407,user_5407,4276,49,49,0,Dec-18,5,0,0
5408,user_5408,8142,102,70,32,Mar-19,2,0,0
5409,user_5409,256,41,35,6,Apr-19,1,1,0
5410,user_5410,9278,77,57,20,May-19,0,1,1
5411,user_5411,2106,51,51,0,Sep-18,8,0,0
5412,user_5412,14,3,3,0,May-18,12,0,0
5413,user_5413,2325,99,42,57,May-19,0,1,1
5414,user_5414,42294,81,69,12,Apr-19,1,1,0
5415,user_5415,4744,75,60,15,May-19,0,1,1
5416,user_5416,11,2,2,0,May-18,12,0,0
5417,user_5417,75216,284,162,122,Apr-19,1,1,0
5418,user_5418,21,6,6,0,Nov-18,6,0,0
5419,user_5419,5645,357,293,64,May-19,0,1,1
5420,user_5420,528,36,29,7,Apr-19,1,1,0
5422,user_5422,55449,73,56,17,Apr-19,1,1,0
5423,user_5423,1418,64,47,17,Apr-19,1,1,0
5424,user_5424,117,17,16,1,Mar-19,2,0,0
5425,user_5425,550,31,6,25,May-19,0,1,1
5426,user_5426,2347,91,21,70,Apr-19,1,1,0
5427,user_5427,737,13,12,1,May-19,0,0,1
5428,user_5428,5988,124,58,66,May-19,0,1,1
5429,user_5429,7204,95,51,44,May-19,0,1,1
5430,user_5430,2352,39,19,20,May-19,0,1,1
5431,user_5431,1683,211,170,41,May-19,0,1,1
5432,user_5432,69,5,5,0,May-18,12,0,0
5433,user_5433,1580,29,25,4,Mar-19,2,0,0
5435,user_5435,4001,38,36,2,Mar-19,2,0,0
5436,user_5436,5865,86,75,11,Feb-19,3,0,0
5437,user_5437,2513,271,140,131,May-19,0,1,1
5438,user_5438,30587,576,403,173,May-19,0,1,1
5439,user_5439,2016,37,26,11,May-19,0,0,1
5440,user_5440,14,3,0,3,Apr-19,1,1,0
5441,user_5441,2510,148,108,40,May-19,0,1,1
5442,user_5442,20385,484,168,316,May-19,0,1,1
5443,user_5443,113,3,3,0,May-18,12,0,0
5444,user_5444,845,45,23,22,Apr-19,1,1,0
5445,user_5445,88,4,4,0,May-18,12,0,0
5446,user_5446,5558,77,28,49,Apr-19,1,1,0
5447,user_5447,5451,121,79,42,Mar-19,2,0,0
5448,user_5448,22106,1262,718,544,May-19,0,1,1
5449,user_5449,5827,112,88,24,Mar-19,2,0,0
5450,user_5450,7543,196,24,172,May-19,0,1,1
5451,user_5451,718,79,79,0,Oct-18,7,0,0
5452,user_5452,40179,156,95,61,May-19,0,1,1
5453,user_5453,5721,103,103,0,Dec-18,5,0,0
5454,user_5454,528,12,12,0,Sep-18,8,0,0
5455,user_5455,13731,583,382,201,Apr-19,1,1,0
5456,user_5456,54218,179,162,17,Apr-19,1,1,0
5457,user_5457,1720,34,33,1,Feb-19,3,0,0
5458,user_5458,3670,46,16,30,May-19,0,1,1
5459,user_5459,19832,48,44,4,Mar-19,2,0,0
5460,user_5460,2318,44,9,35,May-19,0,1,1
5461,user_5461,6402,101,44,57,Mar-19,2,0,0
5462,user_5462,7201,192,116,76,May-19,0,1,1
5463,user_5463,3044,358,335,23,May-19,0,1,1
5464,user_5464,311,29,29,0,Nov-18,6,0,0
5465,user_5465,8518,130,130,0,Oct-18,7,0,0
5466,user_5466,1870,129,73,56,May-19,0,1,1
5467,user_5467,10245,155,80,75,May-19,0,1,1
5468,user_5468,5246,304,182,122,May-19,0,1,1
5469,user_5469,6300,189,144,45,May-19,0,1,1
5470,user_5470,326,5,5,0,Jun-18,11,0,0
5471,user_5471,232,8,3,5,Apr-19,1,1,0
5472,user_5472,28155,343,194,149,May-19,0,1,1
5473,user_5473,2600,123,41,82,Apr-19,1,1,0
5474,user_5474,5334,156,149,7,Feb-19,3,0,0
5475,user_5475,10795,50,35,15,Apr-19,1,1,0
5476,user_5476,183,6,6,0,Jun-18,11,0,0
5477,user_5477,55,15,5,10,Feb-19,3,0,0
5478,user_5478,8693,27,23,4,May-19,0,0,1
5479,user_5479,873,9,9,0,Jun-18,11,0,0
5480,user_5480,8560,99,19,80,May-19,0,1,1
5481,user_5481,6716,135,73,62,May-19,0,1,1
5482,user_5482,1468,44,39,5,May-19,0,0,1
5483,user_5483,3991,106,29,77,May-19,0,1,1
5484,user_5484,33883,179,139,40,May-19,0,1,1
5485,user_5485,51136,539,401,138,Apr-19,1,1,0
5486,user_5486,25644,47,45,2,May-19,0,0,1
5487,user_5487,52831,1872,1041,831,May-19,0,1,1
5488,user_5488,2151,50,50,0,Jul-18,10,0,0
5490,user_5490,23,14,11,3,Apr-19,1,1,0
5491,user_5491,31403,144,83,61,May-19,0,1,1
5492,user_5492,1008,66,50,16,Apr-19,1,1,0
5493,user_5493,3514,52,23,29,Apr-19,1,1,0
5494,user_5494,12510,691,448,243,May-19,0,1,1
5495,user_5495,143,13,13,0,Sep-18,8,0,0
5496,user_5496,6325,141,91,50,May-19,0,1,1
5497,user_5497,4923,225,199,26,May-19,0,1,1
5498,user_5498,1280,21,8,13,Mar-19,2,0,0
5499,user_5499,6534,370,356,14,Apr-19,1,1,0
5500,user_5500,1508,41,18,23,Apr-19,1,1,0
5501,user_5501,60,2,2,0,Dec-18,5,0,0
5502,user_5502,571,209,121,88,May-19,0,1,1
5504,user_5504,23,7,7,0,Oct-18,7,0,0
5505,user_5505,3884,137,109,28,May-19,0,1,1
5506,user_5506,15411,347,185,162,May-19,0,1,1
5507,user_5507,9,1,1,0,Nov-18,6,0,0
5508,user_5508,983,61,23,38,May-19,0,1,1
5509,user_5509,3164,171,80,91,May-19,0,1,1
5510,user_5510,20319,214,203,11,Feb-19,3,0,0
5511,user_5511,661,28,13,15,May-19,0,1,1
5512,user_5512,4064,107,92,15,Apr-19,1,1,0
5513,user_5513,93,21,9,12,May-19,0,1,1
5514,user_5514,1240,333,222,111,Apr-19,1,1,0
5515,user_5515,21016,108,53,55,May-19,0,1,1
5516,user_5516,649,31,30,1,Mar-19,2,0,0
5517,user_5517,1063,33,26,7,Apr-19,1,1,0
5518,user_5518,1874,14,9,5,Apr-19,1,1,0
5519,user_5519,1017,29,23,6,Apr-19,1,1,0
5520,user_5520,2089,40,40,0,Dec-18,5,0,0
5521,user_5521,1396,68,68,0,Aug-18,9,0,0
5522,user_5522,7494,170,89,81,Mar-19,2,0,0
5523,user_5523,3442,106,67,39,Apr-19,1,1,0
5524,user_5524,694,41,16,25,May-19,0,1,1
5525,user_5525,748,20,18,2,Mar-19,2,0,0
5526,user_5526,1353,34,32,2,May-19,0,0,1
5527,user_5527,740,15,15,0,Dec-18,5,0,0
5528,user_5528,5647,76,73,3,May-19,0,0,1
5529,user_5529,2239,25,23,2,Jan-19,4,0,0
5530,user_5530,1326,65,36,29,May-19,0,1,1
5531,user_5531,1516,36,32,4,May-19,0,0,1
5532,user_5532,908,127,11,116,May-19,0,1,1
5533,user_5533,15832,332,33,299,May-19,0,1,1
5534,user_5534,21,4,4,0,Jul-18,10,0,0
5535,user_5535,9610,90,90,0,Sep-18,8,0,0
5536,user_5536,7046,289,49,240,May-19,0,1,1
5537,user_5537,1448,62,54,8,May-19,0,1,1
5538,user_5538,32389,369,251,118,May-19,0,1,1
5539,user_5539,7889,124,85,39,Apr-19,1,1,0
5540,user_5540,476,14,8,6,Apr-19,1,1,0
5541,user_5541,20219,811,476,335,May-19,0,1,1
5542,user_5542,576,20,20,0,Nov-18,6,0,0
5543,user_5543,7165,111,76,35,Apr-19,1,1,0
5544,user_5544,3373,136,80,56,May-19,0,1,1
5545,user_5545,22466,271,231,40,May-19,0,1,1
5546,user_5546,10046,18,17,1,May-19,0,0,1
5547,user_5547,16806,719,551,168,May-19,0,1,1
5548,user_5548,17818,327,280,47,May-19,0,1,1
5549,user_5549,2060,61,61,0,Nov-18,6,0,0
5550,user_5550,15,4,4,0,May-18,12,0,0
5551,user_5551,18,3,3,0,May-18,12,0,0
5552,user_5552,5140,298,224,74,May-19,0,1,1
5553,user_5553,1647,16,16,0,Aug-18,9,0,0
5554,user_5554,12086,908,661,247,May-19,0,1,1
5555,user_5555,1856,81,49,32,May-19,0,1,1
5556,user_5556,19888,157,131,26,May-19,0,1,1
5557,user_5557,9,2,2,0,Oct-18,7,0,0
5558,user_5558,6629,187,180,7,Feb-19,3,0,0
5559,user_5559,125,23,23,0,Dec-18,5,0,0
5560,user_5560,3825,175,116,59,May-19,0,1,1
5561,user_5561,1805,28,19,9,Apr-19,1,1,0
5562,user_5562,10116,130,45,85,May-19,0,1,1
5563,user_5563,4,2,2,0,May-18,12,0,0
5564,user_5564,10553,458,289,169,May-19,0,1,1
5565,user_5565,5863,552,214,338,May-19,0,1,1
5566,user_5566,434,21,19,2,Apr-19,1,1,0
5567,user_5567,38212,1565,612,953,May-19,0,1,1
5568,user_5568,10300,268,231,37,May-19,0,1,1
5569,user_5569,2333,58,31,27,Apr-19,1,1,0
5570,user_5570,7253,193,127,66,Apr-19,1,1,0
5571,user_5571,3804,77,61,16,Jan-19,4,0,0
5572,user_5572,21,6,6,0,Jun-18,11,0,0
5573,user_5573,187,40,18,22,May-19,0,1,1
5574,user_5574,2596,34,6,28,May-19,0,1,1
5575,user_5575,14541,434,308,126,May-19,0,1,1
5576,user_5576,3320,120,57,63,May-19,0,1,1
5577,user_5577,2323,275,273,2,Jan-19,4,0,0
5578,user_5578,60,11,11,0,Jun-18,11,0,0
5579,user_5579,42,7,7,0,Jul-18,10,0,0
5580,user_5580,789,46,28,18,May-19,0,1,1
5581,user_5581,14,3,3,0,May-18,12,0,0
5582,user_5582,11,2,2,0,May-18,12,0,0
5584,user_5584,10531,354,249,105,May-19,0,1,1
5585,user_5585,4844,179,56,123,May-19,0,1,1
5586,user_5586,15781,258,218,40,May-19,0,1,1
5587,user_5587,754,5,1,4,Mar-19,2,0,0
5588,user_5588,378,25,17,8,Mar-19,2,0,0
5589,user_5589,10367,99,35,64,May-19,0,1,1
5590,user_5590,47649,701,479,222,May-19,0,1,1
5591,user_5591,22319,151,96,55,May-19,0,1,1
5592,user_5592,8555,299,299,0,Sep-18,8,0,0
5593,user_5593,16907,338,148,190,May-19,0,1,1
5594,user_5594,3141,142,70,72,May-19,0,1,1
5595,user_5595,14,3,3,0,May-18,12,0,0
5596,user_5596,13839,186,117,69,May-19,0,1,1
5597,user_5597,187915,284,198,86,May-19,0,1,1
5598,user_5598,27061,948,421,527,May-19,0,1,1
5599,user_5599,1021,3,1,2,Apr-19,1,1,0
5600,user_5600,194,4,4,0,May-18,12,0,0
5601,user_5601,2485,94,75,19,May-19,0,1,1
5602,user_5602,47401,255,3,252,May-19,0,1,1
5603,user_5603,2249,141,78,63,Apr-19,1,1,0
5604,user_5604,5004,113,113,0,Oct-18,7,0,0
5605,user_5605,30,5,5,0,Dec-18,5,0,0
5606,user_5606,402,38,20,18,May-19,0,1,1
5607,user_5607,10607,116,53,63,May-19,0,1,1
5608,user_5608,2300,184,49,135,May-19,0,1,1
5609,user_5609,15,6,6,0,Sep-18,8,0,0
5610,user_5610,19234,1035,755,280,May-19,0,1,1
5611,user_5611,950,14,13,1,Mar-19,2,0,0
5612,user_5612,30,4,4,0,Jun-18,11,0,0
5613,user_5613,904,35,35,0,Nov-18,6,0,0
5614,user_5614,29929,419,311,108,May-19,0,0,1
5615,user_5615,1872,74,58,16,Mar-19,2,0,0
5617,user_5617,1260,76,56,20,May-19,0,1,1
5618,user_5618,1468,17,4,13,Apr-19,1,1,0
5619,user_5619,8561,241,141,100,May-19,0,1,1
5621,user_5621,15351,162,92,70,May-19,0,1,1
5622,user_5622,28959,254,213,41,May-19,0,1,1
5623,user_5623,591,6,6,0,Jul-18,10,0,0
5624,user_5624,19566,160,99,61,May-19,0,1,1
5625,user_5625,143,14,3,11,May-19,0,0,1
5626,user_5626,1181,59,55,4,May-19,0,1,1
5627,user_5627,1446,17,15,2,Mar-19,2,0,0
5628,user_5628,31382,167,113,54,May-19,0,1,1
5629,user_5629,6754,46,16,30,May-19,0,1,1
5630,user_5630,6065,244,155,89,May-19,0,1,1
5631,user_5631,34074,115,51,64,May-19,0,1,1
5632,user_5632,2223,53,53,0,Oct-18,7,0,0
5633,user_5633,1580,25,25,0,Dec-18,5,0,0
5634,user_5634,2629,62,54,8,Apr-19,1,1,0
5635,user_5635,106468,1939,1170,769,May-19,0,1,1
5636,user_5636,2096,67,67,0,Dec-18,5,0,0
5637,user_5637,121,16,14,2,Feb-19,3,0,0
5638,user_5638,14678,173,114,59,May-19,0,1,1
5639,user_5639,4728,205,171,34,Apr-19,1,1,0
5640,user_5640,4103,73,73,0,Aug-18,9,0,0
5641,user_5641,12,2,2,0,Jun-18,11,0,0
5642,user_5642,14,3,0,3,Jan-19,4,0,0
5643,user_5643,6054,179,97,82,May-19,0,1,1
5644,user_5644,13276,323,229,94,May-19,0,1,1
5645,user_5645,6294,89,43,46,Apr-19,1,1,0
5646,user_5646,1904,59,56,3,Apr-19,1,1,0
5647,user_5647,5086,164,103,61,May-19,0,1,1
5648,user_5648,2287,26,22,4,Mar-19,2,0,0
5649,user_5649,508,44,35,9,May-19,0,1,1
5650,user_5650,40933,159,84,75,May-19,0,1,1
5651,user_5651,22460,359,341,18,May-19,0,1,1
5652,user_5652,3614,32,32,0,Nov-18,6,0,0
5653,user_5653,22946,648,108,540,May-19,0,1,1
5655,user_5655,2050,163,61,102,May-19,0,1,1
5656,user_5656,772,5,5,0,May-18,12,0,0
5657,user_5657,7672,437,252,185,May-19,0,1,1
5658,user_5658,1801,35,35,0,Aug-18,9,0,0
5659,user_5659,12,3,3,0,May-18,12,0,0
5660,user_5660,1065,36,28,8,Jan-19,4,0,0
5661,user_5661,483,16,16,0,Nov-18,6,0,0
5662,user_5662,4140,75,64,11,May-19,0,0,1
5663,user_5663,26143,173,115,58,May-19,0,1,1
5664,user_5664,7028,126,57,69,May-19,0,1,1
5665,user_5665,1939,33,26,7,Mar-19,2,0,0
5666,user_5666,18,3,2,1,Feb-19,3,0,0
5667,user_5667,5440,134,134,0,Nov-18,6,0,0
5668,user_5668,25646,661,661,0,Dec-18,5,0,0
5669,user_5669,2759,53,46,7,Feb-19,3,0,0
5670,user_5670,1101,36,2,34,Apr-19,1,1,0
5671,user_5671,3764,90,72,18,Feb-19,3,0,0
5672,user_5672,3643,129,76,53,Apr-19,1,1,0
5673,user_5673,26122,14,11,3,Mar-19,2,0,0
5674,user_5674,15767,96,65,31,Apr-19,1,1,0
5675,user_5675,299,17,4,13,May-19,0,1,1
5676,user_5676,1511,43,16,27,Apr-19,1,1,0
5677,user_5677,1984,41,37,4,May-19,0,0,1
5678,user_5678,26288,106,100,6,Mar-19,2,0,0
5679,user_5679,5192,114,85,29,Apr-19,1,1,0
5680,user_5680,1192,29,21,8,May-19,0,0,1
5681,user_5681,12287,420,284,136,May-19,0,1,1
5682,user_5682,2143,42,24,18,Feb-19,3,0,0
5683,user_5683,8679,389,140,249,May-19,0,1,1
5684,user_5684,2943,23,23,0,Nov-18,6,0,0
5686,user_5686,106,3,3,0,May-18,12,0,0
5688,user_5688,17,4,4,0,May-18,12,0,0
5689,user_5689,2711,35,35,0,Sep-18,8,0,0
5690,user_5690,1195,49,49,0,Nov-18,6,0,0
5691,user_5691,10904,426,183,243,May-19,0,1,1
5692,user_5692,1242,149,78,71,May-19,0,1,1
5693,user_5693,16952,346,235,111,May-19,0,1,1
5695,user_5695,32778,296,216,80,Feb-19,3,0,0
5696,user_5696,8382,390,239,151,May-19,0,1,1
5697,user_5697,1677,31,25,6,Jan-19,4,0,0
5698,user_5698,2174,37,14,23,Apr-19,1,1,0
5699,user_5699,18,3,0,3,Feb-19,3,0,0
5700,user_5700,51,5,5,0,Jul-18,10,0,0
5701,user_5701,10157,472,246,226,May-19,0,1,1
5702,user_5702,9514,260,74,186,May-19,0,1,1
5703,user_5703,49,8,8,0,Aug-18,9,0,0
5704,user_5704,2638,117,113,4,Mar-19,2,0,0
5705,user_5705,5018,35,35,0,Sep-18,8,0,0
5706,user_5706,9904,197,87,110,May-19,0,1,1
5707,user_5707,2079,89,62,27,May-19,0,1,1
5708,user_5708,1515,42,6,36,Mar-19,2,0,0
5709,user_5709,869,56,5,51,Mar-19,2,0,0
5710,user_5710,182,30,24,6,Feb-19,3,0,0
5711,user_5711,24688,971,477,494,May-19,0,1,1
5712,user_5712,5342,128,45,83,May-19,0,1,1
5713,user_5713,4635,293,291,2,Jan-19,4,0,0
5714,user_5714,2475,14,12,2,Apr-19,1,1,0
5715,user_5715,20156,599,389,210,May-19,0,1,1
5716,user_5716,647,17,10,7,Mar-19,2,0,0
5717,user_5717,42852,1277,731,546,May-19,0,1,1
5718,user_5718,130794,2387,1418,969,May-19,0,1,1
5719,user_5719,9,2,2,0,Jun-18,11,0,0
5720,user_5720,17840,12,12,0,May-18,12,0,0
5721,user_5721,201,3,3,0,May-18,12,0,0
5722,user_5722,12,3,3,0,May-18,12,0,0
5723,user_5723,5945,27,17,10,Apr-19,1,1,0
5724,user_5724,7252,350,191,159,May-19,0,1,1
5725,user_5725,32616,204,57,147,May-19,0,1,1
5726,user_5726,70,4,4,0,May-18,12,0,0
5727,user_5727,11804,171,161,10,May-19,0,1,1
5728,user_5728,13097,51,47,4,Apr-19,1,1,0
5729,user_5729,10156,355,355,0,Nov-18,6,0,0
5730,user_5730,1528,43,43,0,Aug-18,9,0,0
5731,user_5731,16746,159,113,46,May-19,0,1,1
5732,user_5732,10,1,0,1,Apr-19,1,1,0
5733,user_5733,13486,148,105,43,May-19,0,1,1
5734,user_5734,17328,183,127,56,Mar-19,2,0,0
5735,user_5735,722,40,5,35,Apr-19,1,1,0
5736,user_5736,22639,1444,784,660,May-19,0,1,1
5737,user_5737,1683,68,59,9,Feb-19,3,0,0
5738,user_5738,3673,151,128,23,May-19,0,1,1
5739,user_5739,13475,454,273,181,May-19,0,1,1
5740,user_5740,3662,83,53,30,Apr-19,1,1,0
5741,user_5741,14814,366,202,164,May-19,0,1,1
5742,user_5742,462,17,16,1,May-19,0,0,1
5743,user_5743,158938,235,98,137,May-19,0,1,1
5744,user_5744,18,4,4,0,Dec-18,5,0,0
5745,user_5745,5929,3,2,1,Jan-19,4,0,0
5746,user_5746,692,9,9,0,Dec-18,5,0,0
5747,user_5747,57,8,8,0,Aug-18,9,0,0
5748,user_5748,958,22,8,14,Apr-19,1,1,0
5749,user_5749,45713,151,60,91,May-19,0,1,1
5750,user_5750,17,4,3,1,Apr-19,1,1,0
5751,user_5751,494,25,25,0,Aug-18,9,0,0
5752,user_5752,34960,961,526,435,May-19,0,1,1
5753,user_5753,629,42,31,11,May-19,0,1,1
5754,user_5754,9578,109,104,5,Apr-19,1,1,0
5755,user_5755,1911,132,114,18,May-19,0,1,1
5756,user_5756,8270,187,187,0,Sep-18,8,0,0
5757,user_5757,1532,202,202,0,Oct-18,7,0,0
5758,user_5758,10361,637,450,187,May-19,0,1,1
5759,user_5759,8194,52,33,19,May-19,0,1,1
5760,user_5760,1474,10,8,2,Apr-19,1,1,0
5761,user_5761,8267,178,43,135,May-19,0,1,1
5762,user_5762,184,15,0,15,May-19,0,1,1
5763,user_5763,21,3,3,0,Jul-18,10,0,0
5764,user_5764,106264,183,106,77,May-19,0,1,1
5765,user_5765,1,1,1,0,May-18,12,0,0
5766,user_5766,271,9,8,1,Apr-19,1,1,0
5767,user_5767,3555,127,93,34,May-19,0,1,1
5768,user_5768,5,1,1,0,May-18,12,0,0
5769,user_5769,30,3,3,0,Sep-18,8,0,0
5770,user_5770,363,90,54,36,May-19,0,1,1
5771,user_5771,4612,392,392,0,Nov-18,6,0,0
5772,user_5772,23669,124,124,0,Sep-18,8,0,0
5773,user_5773,8865,158,150,8,Jan-19,4,0,0
5774,user_5774,11904,458,431,27,Feb-19,3,0,0
5775,user_5775,5186,87,86,1,Apr-19,1,1,0
5776,user_5776,5898,231,169,62,Apr-19,1,1,0
5777,user_5777,16966,739,484,255,May-19,0,1,1
5778,user_5778,2256,11,7,4,May-19,0,0,1
5779,user_5779,1519,19,10,9,May-19,0,1,1
5780,user_5780,9548,528,80,448,May-19,0,1,1
5781,user_5781,11606,795,440,355,May-19,0,1,1
5782,user_5782,5299,79,79,0,Dec-18,5,0,0
5783,user_5783,5382,144,67,77,Apr-19,1,1,0
5784,user_5784,5100,229,140,89,May-19,0,1,1
5785,user_5785,86,3,3,0,May-18,12,0,0
5786,user_5786,6,3,3,0,May-18,12,0,0
5787,user_5787,451,14,3,11,May-19,0,1,1
5788,user_5788,1829,65,49,16,Apr-19,1,1,0
5789,user_5789,2948,153,119,34,May-19,0,1,1
5790,user_5790,249,22,17,5,Mar-19,2,0,0
5791,user_5791,17632,423,213,210,May-19,0,1,1
5792,user_5792,453,53,0,53,May-19,0,1,1
5793,user_5793,34478,306,203,103,May-19,0,1,1
5794,user_5794,15566,434,177,257,May-19,0,1,1
5795,user_5795,22,5,5,0,May-18,12,0,0
5796,user_5796,12658,607,283,324,May-19,0,1,1
5797,user_5797,3364,77,58,19,May-19,0,0,1
5798,user_5798,596,33,33,0,Dec-18,5,0,0
5799,user_5799,15920,376,305,71,Apr-19,1,1,0
5800,user_5800,51,16,9,7,Apr-19,1,1,0
5801,user_5801,97969,72,39,33,May-19,0,1,1
5803,user_5803,3740,79,52,27,Apr-19,1,1,0
5804,user_5804,286,53,30,23,May-19,0,0,1
5805,user_5805,4000,223,108,115,May-19,0,1,1
5806,user_5806,5606,157,107,50,Apr-19,1,1,0
5807,user_5807,7444,208,162,46,May-19,0,1,1
5808,user_5808,60,4,4,0,Jun-18,11,0,0
5809,user_5809,12896,239,237,2,Mar-19,2,0,0
5810,user_5810,56349,1296,683,613,May-19,0,1,1
5811,user_5811,6,4,4,0,Jun-18,11,0,0
5812,user_5812,15113,750,488,262,May-19,0,1,1
5813,user_5813,4056,141,106,35,May-19,0,1,1
5814,user_5814,1562,123,18,105,May-19,0,1,1
5815,user_5815,11021,482,352,130,May-19,0,1,1
5816,user_5816,493,60,56,4,Apr-19,1,1,0
5817,user_5817,1490,7,7,0,Nov-18,6,0,0
5818,user_5818,363,15,15,0,Jun-18,11,0,0
5819,user_5819,47414,349,177,172,May-19,0,1,1
5820,user_5820,4115,97,87,10,Apr-19,1,1,0
5821,user_5821,10,2,0,2,May-19,0,0,1
5822,user_5822,756,39,29,10,Apr-19,1,1,0
5823,user_5823,16,3,3,0,May-18,12,0,0
5824,user_5824,2113,70,66,4,Apr-19,1,1,0
5825,user_5825,2718,54,49,5,May-19,0,0,1
5826,user_5826,3212,35,0,35,May-19,0,1,1
5827,user_5827,2906,43,41,2,Apr-19,1,1,0
5828,user_5828,56,3,0,3,Apr-19,1,1,0
5829,user_5829,134020,227,1,226,May-19,0,1,1
5830,user_5830,5014,114,76,38,May-19,0,1,1
5831,user_5831,8605,514,358,156,May-19,0,1,1
5832,user_5832,2437,36,23,13,May-19,0,1,1
5833,user_5833,38811,544,368,176,May-19,0,1,1
5834,user_5834,77,1,1,0,May-18,12,0,0
5835,user_5835,1850,79,78,1,Feb-19,3,0,0
5836,user_5836,18921,58,51,7,Feb-19,3,0,0
5837,user_5837,12875,107,99,8,Mar-19,2,0,0
5838,user_5838,2276,133,74,59,May-19,0,1,1
5839,user_5839,5355,100,100,0,Aug-18,9,0,0
5840,user_5840,9,2,0,2,Mar-19,2,0,0
5841,user_5841,253,18,18,0,Oct-18,7,0,0
5842,user_5842,1381,24,21,3,May-19,0,0,1
5843,user_5843,8367,302,38,264,Apr-19,1,1,0
5844,user_5844,13604,92,69,23,Apr-19,1,1,0
5845,user_5845,2140,76,46,30,Mar-19,2,0,0
5846,user_5846,5763,221,145,76,May-19,0,1,1
5847,user_5847,9502,1042,504,538,May-19,0,1,1
5848,user_5848,883,14,14,0,Aug-18,9,0,0
5849,user_5849,1268,47,38,9,May-19,0,1,1
5850,user_5850,13629,542,134,408,May-19,0,1,1
5851,user_5851,352,14,13,1,Apr-19,1,1,0
5852,user_5852,16387,272,239,33,Mar-19,2,0,0
5853,user_5853,3067,67,67,0,Dec-18,5,0,0
5854,user_5854,17095,658,168,490,May-19,0,1,1
5855,user_5855,1703,102,73,29,May-19,0,1,1
5856,user_5856,3252,210,82,128,May-19,0,1,1
5857,user_5857,7119,189,136,53,Mar-19,2,0,0
5858,user_5858,12030,298,98,200,May-19,0,1,1
5859,user_5859,16887,166,129,37,Apr-19,1,1,0
5860,user_5860,1013,44,38,6,May-19,0,0,1
5861,user_5861,8463,109,72,37,Apr-19,1,1,0
5862,user_5862,737,25,0,25,May-19,0,1,1
5863,user_5863,1401,8,8,0,May-18,12,0,0
5864,user_5864,8,4,2,2,Apr-19,1,1,0
5865,user_5865,3149,174,148,26,Apr-19,1,1,0
5866,user_5866,9132,315,214,101,May-19,0,1,1
5867,user_5867,18874,281,15,266,May-19,0,1,1
5868,user_5868,1516,52,28,24,May-19,0,1,1
5869,user_5869,3216,73,60,13,Apr-19,1,1,0
5870,user_5870,4414,133,36,97,May-19,0,1,1
5871,user_5871,71399,153,105,48,May-19,0,1,1
5872,user_5872,23700,406,246,160,May-19,0,1,1
5874,user_5874,75549,786,531,255,May-19,0,1,1
5875,user_5875,2212,63,28,35,Apr-19,1,1,0
5876,user_5876,8905,181,84,97,May-19,0,1,1
5877,user_5877,89,10,9,1,Feb-19,3,0,0
5878,user_5878,57,14,14,0,Jul-18,10,0,0
5879,user_5879,4254,92,92,0,Aug-18,9,0,0
5880,user_5880,1014,68,29,39,May-19,0,1,1
5881,user_5881,8692,44,41,3,Jan-19,4,0,0
5882,user_5882,5471,65,26,39,May-19,0,1,1
5883,user_5883,268,6,6,0,Jun-18,11,0,0
5884,user_5884,13298,171,84,87,May-19,0,1,1
5885,user_5885,12904,261,153,108,May-19,0,1,1
5886,user_5886,2685,95,0,95,May-19,0,1,1
5887,user_5887,2062,29,29,0,Jun-18,11,0,0
5888,user_5888,20422,138,6,132,May-19,0,1,1
5889,user_5889,5153,131,126,5,Apr-19,1,1,0
5890,user_5890,23029,731,467,264,May-19,0,1,1
5891,user_5891,900,53,53,0,Nov-18,6,0,0
5892,user_5892,91929,664,497,167,May-19,0,1,1
5893,user_5893,10,1,1,0,Jun-18,11,0,0
5894,user_5894,2179,224,156,68,Apr-19,1,1,0
5895,user_5895,425,31,29,2,Mar-19,2,0,0
5897,user_5897,91583,315,158,157,May-19,0,1,1
5898,user_5898,11,2,2,0,Nov-18,6,0,0
5900,user_5900,237,6,6,0,Sep-18,8,0,0
5901,user_5901,16166,355,229,126,May-19,0,1,1
5902,user_5902,10,1,1,0,Jun-18,11,0,0
5903,user_5903,2959,100,99,1,Feb-19,3,0,0
5904,user_5904,1247,36,34,2,Jan-19,4,0,0
5905,user_5905,158,14,8,6,Apr-19,1,1,0
5906,user_5906,39401,199,133,66,May-19,0,1,1
5907,user_5907,9,2,2,0,Jun-18,11,0,0
5908,user_5908,1830,54,36,18,Apr-19,1,1,0
5909,user_5909,11465,119,63,56,May-19,0,1,1
5910,user_5910,11519,137,102,35,May-19,0,0,1
5911,user_5911,59204,101,55,46,Apr-19,1,1,0
5912,user_5912,18679,298,180,118,May-19,0,1,1
5913,user_5913,1944,57,36,21,May-19,0,1,1
5914,user_5914,146,36,1,35,Mar-19,2,0,0
5915,user_5915,6222,345,171,174,May-19,0,1,1
5916,user_5916,107,8,8,0,Sep-18,8,0,0
5917,user_5917,3358,229,139,90,May-19,0,1,1
5918,user_5918,1647,25,5,20,Mar-19,2,0,0
5919,user_5919,1515,10,10,0,Aug-18,9,0,0
5920,user_5920,89,7,7,0,Oct-18,7,0,0
5921,user_5921,61823,875,462,413,May-19,0,1,1
5922,user_5922,3467,93,39,54,Mar-19,2,0,0
5923,user_5923,2711,151,72,79,May-19,0,1,1
5924,user_5924,3517,179,137,42,May-19,0,1,1
5925,user_5925,777,34,3,31,May-19,0,1,1
5927,user_5927,1492,102,76,26,May-19,0,1,1
5928,user_5928,12755,81,18,63,Apr-19,1,1,0
5929,user_5929,14457,48,16,32,May-19,0,1,1
5930,user_5930,6201,197,138,59,May-19,0,1,1
5931,user_5931,254,34,34,0,Dec-18,5,0,0
5932,user_5932,17221,183,180,3,Feb-19,3,0,0
5933,user_5933,22,5,5,0,Jun-18,11,0,0
5934,user_5934,1925,165,3,162,May-19,0,1,1
5935,user_5935,2497,28,28,0,Jul-18,10,0,0
5936,user_5936,4646,342,242,100,May-19,0,1,1
5937,user_5937,85662,11,4,7,Apr-19,1,1,0
5938,user_5938,793,60,47,13,Apr-19,1,1,0
5939,user_5939,6633,104,99,5,Jan-19,4,0,0
5940,user_5940,8158,55,19,36,Mar-19,2,0,0
5941,user_5941,6989,93,56,37,Apr-19,1,1,0
5942,user_5942,9,2,2,0,Jun-18,11,0,0
5943,user_5943,3002,65,56,9,Mar-19,2,0,0
5944,user_5944,237,19,14,5,Mar-19,2,0,0
5945,user_5945,1040,26,26,0,Dec-18,5,0,0
5946,user_5946,1207,24,24,0,Sep-18,8,0,0
5947,user_5947,998,78,23,55,May-19,0,1,1
5948,user_5948,1040,36,36,0,Jul-18,10,0,0
5949,user_5949,3116,221,17,204,May-19,0,1,1
5950,user_5950,8,3,3,0,May-18,12,0,0
5951,user_5951,4265,195,98,97,May-19,0,1,1
5952,user_5952,6199,368,198,170,May-19,0,1,1
5953,user_5953,856,20,19,1,Jan-19,4,0,0
5954,user_5954,121,3,3,0,May-18,12,0,0
5956,user_5956,9695,58,5,53,Apr-19,1,1,0
5957,user_5957,30391,33,32,1,Apr-19,1,1,0
5958,user_5958,517,28,28,0,Jun-18,11,0,0
5959,user_5959,17,4,4,0,Jun-18,11,0,0
5960,user_5960,14,3,3,0,Jun-18,11,0,0
5961,user_5961,16,3,3,0,May-18,12,0,0
5962,user_5962,9,1,1,0,May-18,12,0,0
5963,user_5963,14590,297,179,118,May-19,0,1,1
5964,user_5964,2597,281,121,160,May-19,0,1,1
5965,user_5965,14022,499,67,432,May-19,0,1,1
5966,user_5966,65,8,6,2,Feb-19,3,0,0
5967,user_5967,661,48,0,48,May-19,0,1,1
5968,user_5968,10532,625,435,190,May-19,0,1,1
5969,user_5969,6243,202,135,67,May-19,0,1,1
5970,user_5970,9182,146,108,38,May-19,0,1,1
5971,user_5971,18797,555,337,218,May-19,0,1,1
5972,user_5972,27889,929,494,435,May-19,0,1,1
5973,user_5973,1953,68,56,12,Mar-19,2,0,0
5974,user_5974,15860,212,107,105,May-19,0,1,1
5975,user_5975,72,6,3,3,May-19,0,0,1
5976,user_5976,262,31,9,22,May-19,0,1,1
5977,user_5977,16884,956,536,420,May-19,0,1,1
5978,user_5978,2318,90,54,36,Mar-19,2,0,0
5979,user_5979,5184,96,72,24,Apr-19,1,1,0
5980,user_5980,83181,2376,1198,1178,May-19,0,1,1
5981,user_5981,47958,1836,924,912,May-19,0,1,1
5982,user_5982,32200,41,12,29,May-19,0,1,1
5984,user_5984,10164,941,564,377,May-19,0,1,1
5985,user_5985,42,6,6,0,Sep-18,8,0,0
5986,user_5986,13173,323,210,113,May-19,0,1,1
5987,user_5987,1365,36,36,0,Oct-18,7,0,0
5988,user_5988,616,25,25,0,Oct-18,7,0,0
5989,user_5989,7546,122,51,71,May-19,0,1,1
5990,user_5990,8018,185,135,50,Apr-19,1,1,0
5991,user_5991,7577,81,81,0,Sep-18,8,0,0
5992,user_5992,169,12,12,0,Sep-18,8,0,0
5993,user_5993,1354,96,29,67,Apr-19,1,1,0
5994,user_5994,20827,337,137,200,May-19,0,1,1
5995,user_5995,24,4,4,0,Sep-18,8,0,0
5997,user_5997,67,7,3,4,Apr-19,1,1,0
5998,user_5998,10063,229,159,70,Apr-19,1,1,0
5999,user_5999,511,7,7,0,May-18,12,0,0
6000,user_6000,11751,304,155,149,May-19,0,1,1
6001,user_6001,3722,253,253,0,Aug-18,9,0,0
6002,user_6002,3354,62,45,17,May-19,0,1,1
6003,user_6003,2301,92,92,0,Sep-18,8,0,0
6004,user_6004,39,5,5,0,Jun-18,11,0,0
6005,user_6005,11793,330,301,29,Apr-19,1,1,0
6006,user_6006,18654,407,28,379,May-19,0,1,1
6007,user_6007,6189,148,66,82,May-19,0,1,1
6008,user_6008,1088,13,13,0,Jun-18,11,0,0
6009,user_6009,5079,475,103,372,May-19,0,1,1
6010,user_6010,16186,102,98,4,Feb-19,3,0,0
6011,user_6011,11,2,2,0,May-18,12,0,0
6012,user_6012,1699,36,36,0,Sep-18,8,0,0
6013,user_6013,2476,56,50,6,Jan-19,4,0,0
6014,user_6014,812,208,97,111,May-19,0,1,1
6015,user_6015,1200,150,140,10,Apr-19,1,1,0
6016,user_6016,8291,80,57,23,May-19,0,1,1
6017,user_6017,6652,146,146,0,Dec-18,5,0,0
6018,user_6018,9198,234,148,86,May-19,0,1,1
6019,user_6019,4735,286,161,125,May-19,0,1,1
6020,user_6020,26463,46,34,12,May-19,0,1,1
6021,user_6021,1038,24,11,13,Apr-19,1,1,0
6022,user_6022,4554,28,12,16,May-19,0,1,1
6023,user_6023,176,12,6,6,May-19,0,0,1
6024,user_6024,11225,106,82,24,Mar-19,2,0,0
6025,user_6025,4187,87,50,37,May-19,0,1,1
6026,user_6026,1951,102,73,29,Jan-19,4,0,0
6027,user_6027,1525,21,21,0,Jul-18,10,0,0
6028,user_6028,23090,1063,1040,23,Apr-19,1,1,0
6029,user_6029,5903,10,10,0,Aug-18,9,0,0
6030,user_6030,3565,120,91,29,Apr-19,1,1,0
6031,user_6031,5838,174,145,29,May-19,0,1,1
6032,user_6032,4059,146,92,54,May-19,0,1,1
6033,user_6033,212039,472,427,45,May-19,0,1,1
6034,user_6034,17704,135,97,38,Mar-19,2,0,0
6035,user_6035,706,8,8,0,May-18,12,0,0
6036,user_6036,2788,197,80,117,May-19,0,1,1
6037,user_6037,49203,607,396,211,May-19,0,1,1
6038,user_6038,24387,244,119,125,May-19,0,1,1
6039,user_6039,1961,40,40,0,Jul-18,10,0,0
6040,user_6040,1758,13,6,7,May-19,0,0,1
6041,user_6041,220420,1697,859,838,May-19,0,1,1
6042,user_6042,7697,334,299,35,May-19,0,1,1
6043,user_6043,4411,133,133,0,Dec-18,5,0,0
6044,user_6044,1503,155,69,86,May-19,0,1,1
6045,user_6045,27609,335,66,269,May-19,0,1,1
6046,user_6046,21,4,4,0,Jul-18,10,0,0
6047,user_6047,1344,46,30,16,May-19,0,1,1
6048,user_6048,11,2,2,0,Jun-18,11,0,0
6049,user_6049,23,4,4,0,Nov-18,6,0,0
6050,user_6050,18331,539,447,92,May-19,0,1,1
6051,user_6051,3907,177,26,151,May-19,0,1,1
6052,user_6052,2055,28,28,0,Nov-18,6,0,0
6053,user_6053,90,1,1,0,May-18,12,0,0
6054,user_6054,2711,59,53,6,Mar-19,2,0,0
6055,user_6055,1111,36,1,35,Apr-19,1,1,0
6056,user_6056,27058,24,9,15,May-19,0,1,1
6057,user_6057,23770,325,244,81,May-19,0,1,1
6058,user_6058,102,5,5,0,Jun-18,11,0,0
6059,user_6059,830,19,14,5,Mar-19,2,0,0
6060,user_6060,17549,203,95,108,May-19,0,1,1
6061,user_6061,1859,48,48,0,Aug-18,9,0,0
6062,user_6062,11077,368,238,130,May-19,0,0,1
6063,user_6063,100,22,20,2,Feb-19,3,0,0
6064,user_6064,31,4,4,0,May-18,12,0,0
6065,user_6065,6757,95,17,78,May-19,0,1,1
6066,user_6066,2264,109,66,43,Apr-19,1,1,0
6067,user_6067,960,49,9,40,Apr-19,1,1,0
6068,user_6068,11178,66,38,28,May-19,0,0,1
6069,user_6069,20942,775,407,368,May-19,0,1,1
6070,user_6070,1262,52,52,0,Jun-18,11,0,0
6071,user_6071,12757,753,356,397,May-19,0,1,1
6072,user_6072,10909,555,407,148,May-19,0,1,1
6073,user_6073,66690,1572,686,886,May-19,0,1,1
6074,user_6074,2591,43,36,7,May-19,0,1,1
6075,user_6075,7790,95,94,1,Mar-19,2,0,0
6076,user_6076,6841,374,302,72,May-19,0,1,1
6077,user_6077,2195,68,64,4,Apr-19,1,1,0
6078,user_6078,8937,110,62,48,Apr-19,1,1,0
6079,user_6079,2173,58,27,31,May-19,0,1,1
6080,user_6080,2182,82,53,29,May-19,0,1,1
6081,user_6081,3754,47,28,19,May-19,0,1,1
6083,user_6083,574,66,54,12,Apr-19,1,1,0
6084,user_6084,19,10,10,0,Jul-18,10,0,0
6085,user_6085,11931,303,216,87,Apr-19,1,1,0
6086,user_6086,6535,473,200,273,May-19,0,1,1
6087,user_6087,19967,413,132,281,May-19,0,1,1
6088,user_6088,909,28,28,0,Jul-18,10,0,0
6089,user_6089,5721,37,37,0,Jul-18,10,0,0
6090,user_6090,859,49,49,0,Jun-18,11,0,0
6091,user_6091,36,6,6,0,May-18,12,0,0
6092,user_6092,1156,31,31,0,Oct-18,7,0,0
6093,user_6093,2812,119,114,5,Apr-19,1,1,0
6094,user_6094,13223,172,160,12,Mar-19,2,0,0
6095,user_6095,18501,165,66,99,May-19,0,1,1
6097,user_6097,599,7,7,0,Sep-18,8,0,0
6098,user_6098,5908,258,180,78,May-19,0,1,1
6099,user_6099,1343,126,74,52,May-19,0,1,1
6100,user_6100,8022,197,110,87,Apr-19,1,1,0
6101,user_6101,628,21,0,21,May-19,0,1,1
6102,user_6102,150,7,7,0,Dec-18,5,0,0
6103,user_6103,31918,1156,634,522,May-19,0,1,1
6104,user_6104,8577,536,430,106,May-19,0,1,1
6105,user_6105,3045,82,65,17,May-19,0,1,1
6106,user_6106,21505,320,275,45,May-19,0,1,1
6107,user_6107,2064,185,154,31,May-19,0,1,1
6109,user_6109,417,21,21,0,Jun-18,11,0,0
6110,user_6110,3843,27,23,4,Jan-19,4,0,0
6111,user_6111,9,2,2,0,May-18,12,0,0
6112,user_6112,1811,70,61,9,Apr-19,1,1,0
6113,user_6113,39903,1045,739,306,May-19,0,1,1
6114,user_6114,14,3,3,0,May-18,12,0,0
6115,user_6115,2938,88,49,39,May-19,0,1,1
6116,user_6116,1123,66,20,46,Apr-19,1,1,0
6117,user_6117,2174,25,25,0,Aug-18,9,0,0
6118,user_6118,26,4,4,0,Oct-18,7,0,0
6119,user_6119,38595,267,98,169,May-19,0,1,1
6120,user_6120,1167,33,3,30,May-19,0,1,1
6121,user_6121,2984,28,2,26,Apr-19,1,1,0
6122,user_6122,4975,213,141,72,May-19,0,1,1
6123,user_6123,24966,609,493,116,May-19,0,1,1
6124,user_6124,41,5,5,0,May-18,12,0,0
6125,user_6125,1440,137,92,45,May-19,0,1,1
6126,user_6126,5909,144,135,9,Mar-19,2,0,0
6127,user_6127,18,5,2,3,Apr-19,1,1,0
6128,user_6128,423,21,19,2,Mar-19,2,0,0
6129,user_6129,502,10,3,7,Apr-19,1,1,0
6130,user_6130,1521,32,28,4,Apr-19,1,1,0
6131,user_6131,1253,56,33,23,May-19,0,1,1
6132,user_6132,893,29,10,19,May-19,0,1,1
6133,user_6133,26519,276,160,116,May-19,0,1,1
6134,user_6134,12850,215,49,166,May-19,0,1,1
6135,user_6135,5230,42,32,10,Feb-19,3,0,0
6136,user_6136,2890,171,88,83,Apr-19,1,1,0
6137,user_6137,9411,173,116,57,May-19,0,1,1
6138,user_6138,674,29,29,0,Oct-18,7,0,0
6139,user_6139,2934,143,106,37,Mar-19,2,0,0
6140,user_6140,6230,111,8,103,May-19,0,1,1
6141,user_6141,1690,10,10,0,Jun-18,11,0,0
6142,user_6142,2919,219,143,76,Apr-19,1,1,0
6143,user_6143,14744,144,86,58,May-19,0,1,1
6144,user_6144,18,3,2,1,Mar-19,2,0,0
6145,user_6145,945473,653,449,204,May-19,0,1,1
6146,user_6146,1368,117,0,117,May-19,0,1,1
6147,user_6147,16943,521,335,186,May-19,0,1,1
6148,user_6148,12529,405,212,193,May-19,0,1,1
6149,user_6149,2887,51,49,2,Feb-19,3,0,0
6150,user_6150,3037,58,58,0,Nov-18,6,0,0
6151,user_6151,22,6,6,0,May-18,12,0,0
6152,user_6152,65,3,3,0,May-18,12,0,0
6153,user_6153,1786,39,39,0,Aug-18,9,0,0
6154,user_6154,6073,176,73,103,Apr-19,1,1,0
6156,user_6156,209,20,18,2,Apr-19,1,1,0
6157,user_6157,8583,142,57,85,May-19,0,1,1
6158,user_6158,10,4,4,0,Jul-18,10,0,0
6159,user_6159,5410,257,253,4,Apr-19,1,1,0
6160,user_6160,3757,54,35,19,May-19,0,1,1
6161,user_6161,8314,192,7,185,May-19,0,1,1
6162,user_6162,7656,174,168,6,May-19,0,0,1
6163,user_6163,834,28,10,18,May-19,0,1,1
6164,user_6164,1484,42,28,14,Jan-19,4,0,0
6165,user_6165,4088,163,109,54,Apr-19,1,1,0
6166,user_6166,8178,42,42,0,Aug-18,9,0,0
6167,user_6167,795,26,26,0,Jul-18,10,0,0
6168,user_6168,21318,397,314,83,Apr-19,1,1,0
6169,user_6169,1614,113,91,22,May-19,0,1,1
6170,user_6170,5519,118,60,58,May-19,0,1,1
6171,user_6171,16828,335,335,0,Sep-18,8,0,0
6172,user_6172,7141,266,161,105,Apr-19,1,1,0
6173,user_6173,5208,145,91,54,May-19,0,0,1
6174,user_6174,3238,65,63,2,Apr-19,1,1,0
6175,user_6175,667,65,63,2,Apr-19,1,1,0
6176,user_6176,3697,145,50,95,May-19,0,1,1
6177,user_6177,8681,59,29,30,Mar-19,2,0,0
6178,user_6178,1217,37,4,33,Apr-19,1,1,0
6179,user_6179,187677,241,161,80,May-19,0,1,1
6180,user_6180,24381,197,142,55,Apr-19,1,1,0
6181,user_6181,715,25,10,15,Apr-19,1,1,0
6182,user_6182,15,1,1,0,May-18,12,0,0
6183,user_6183,831,12,9,3,May-19,0,0,1
6184,user_6184,1,1,1,0,May-18,12,0,0
6185,user_6185,14,3,3,0,May-18,12,0,0
6186,user_6186,7823,111,110,1,May-19,0,0,1
6187,user_6187,8103,329,130,199,May-19,0,1,1
6188,user_6188,5353,82,82,0,Nov-18,6,0,0
6189,user_6189,3313,509,438,71,May-19,0,1,1
6190,user_6190,71,5,5,0,Oct-18,7,0,0
6191,user_6191,588,47,15,32,Apr-19,1,1,0
6192,user_6192,59948,672,272,400,May-19,0,1,1
6193,user_6193,299,18,17,1,Jan-19,4,0,0
6194,user_6194,2228,56,56,0,Nov-18,6,0,0
6195,user_6195,6877,77,40,37,May-19,0,1,1
6196,user_6196,15809,81,55,26,Apr-19,1,1,0
6197,user_6197,6204,297,76,221,May-19,0,1,1
6198,user_6198,69,8,8,0,Jul-18,10,0,0
6199,user_6199,11,2,2,0,May-18,12,0,0
6200,user_6200,14000,442,255,187,May-19,0,1,1
6201,user_6201,4917,297,144,153,May-19,0,1,1
6202,user_6202,365,5,0,5,Apr-19,1,1,0
6203,user_6203,2451,61,47,14,Feb-19,3,0,0
6204,user_6204,3939,154,117,37,May-19,0,1,1
6205,user_6205,11872,231,201,30,May-19,0,1,1
6206,user_6206,2041,41,38,3,Mar-19,2,0,0
6207,user_6207,12727,206,145,61,Apr-19,1,1,0
6208,user_6208,47823,615,354,261,May-19,0,1,1
6209,user_6209,2999,101,2,99,May-19,0,1,1
6210,user_6210,435,7,5,2,May-19,0,0,1
6211,user_6211,29106,52,44,8,May-19,0,1,1
6212,user_6212,3181,72,69,3,Apr-19,1,1,0
6213,user_6213,3452,52,49,3,Feb-19,3,0,0
6214,user_6214,799,9,9,0,May-18,12,0,0
6215,user_6215,47110,281,114,167,May-19,0,1,1
6216,user_6216,14867,116,24,92,May-19,0,1,1
6217,user_6217,8658,189,113,76,Feb-19,3,0,0
6218,user_6218,13231,22,19,3,Apr-19,1,1,0
6219,user_6219,1639,71,40,31,Apr-19,1,1,0
6220,user_6220,64,4,4,0,Jun-18,11,0,0
6221,user_6221,4776,223,100,123,Apr-19,1,1,0
6222,user_6222,3597,65,61,4,Mar-19,2,0,0
6223,user_6223,5219,167,133,34,May-19,0,1,1
6224,user_6224,5708,68,65,3,Mar-19,2,0,0
6225,user_6225,43000,1021,539,482,May-19,0,1,1
6226,user_6226,68,11,6,5,Mar-19,2,0,0
6227,user_6227,70736,314,224,90,May-19,0,1,1
6228,user_6228,19897,356,168,188,May-19,0,1,1
6229,user_6229,608,34,34,0,Dec-18,5,0,0
6230,user_6230,21,7,4,3,Mar-19,2,0,0
6231,user_6231,22784,383,166,217,May-19,0,1,1
6232,user_6232,248792,28,25,3,Apr-19,1,1,0
6233,user_6233,5841,77,67,10,Apr-19,1,1,0
6234,user_6234,2620,121,103,18,May-19,0,1,1
6235,user_6235,31414,137,122,15,Mar-19,2,0,0
6236,user_6236,4176,27,11,16,May-19,0,0,1
6237,user_6237,14,3,3,0,May-18,12,0,0
6238,user_6238,849,41,41,0,Dec-18,5,0,0
6239,user_6239,66,10,10,0,Aug-18,9,0,0
6240,user_6240,3509,63,63,0,Nov-18,6,0,0
6241,user_6241,6525,498,353,145,May-19,0,1,1
6242,user_6242,11884,281,160,121,Apr-19,1,1,0
6243,user_6243,14914,715,469,246,May-19,0,1,1
6244,user_6244,1967,65,23,42,May-19,0,1,1
6245,user_6245,927,25,25,0,Jun-18,11,0,0
6246,user_6246,905,25,25,0,Sep-18,8,0,0
6247,user_6247,8210,169,158,11,May-19,0,1,1
6248,user_6248,227,26,25,1,Mar-19,2,0,0
6249,user_6249,405686,676,371,305,May-19,0,1,1
6250,user_6250,2121,20,17,3,Jan-19,4,0,0
6251,user_6251,3950,130,36,94,May-19,0,1,1
6252,user_6252,14983,357,200,157,May-19,0,1,1
6253,user_6253,1074,27,8,19,May-19,0,1,1
6254,user_6254,1452,14,12,2,Mar-19,2,0,0
6255,user_6255,1223,83,56,27,May-19,0,1,1
6256,user_6256,1690,96,73,23,May-19,0,1,1
6257,user_6257,1831,48,48,0,Jul-18,10,0,0
6258,user_6258,3060,43,24,19,Mar-19,2,0,0
6259,user_6259,6214,225,201,24,Feb-19,3,0,0
6260,user_6260,1964,26,14,12,May-19,0,1,1
6261,user_6261,12683,139,111,28,Apr-19,1,1,0
6262,user_6262,2512,53,3,50,May-19,0,1,1
6263,user_6263,873,49,27,22,May-19,0,1,1
6264,user_6264,2931,161,147,14,Apr-19,1,1,0
6265,user_6265,29,7,7,0,Jul-18,10,0,0
6267,user_6267,5596,168,138,30,Feb-19,3,0,0
6268,user_6268,5524,107,86,21,Apr-19,1,1,0
6269,user_6269,20821,366,147,219,May-19,0,1,1
6270,user_6270,11340,151,141,10,Apr-19,1,1,0
6271,user_6271,6653,164,104,60,May-19,0,1,1
6272,user_6272,14147,329,221,108,May-19,0,1,1
6273,user_6273,110,12,11,1,Jan-19,4,0,0
6274,user_6274,838,25,12,13,May-19,0,1,1
6275,user_6275,3623,73,70,3,May-19,0,1,1
6276,user_6276,5136,267,20,247,May-19,0,1,1
6277,user_6277,11855,110,99,11,Apr-19,1,1,0
6278,user_6278,9682,94,61,33,Mar-19,2,0,0
6279,user_6279,1962,106,41,65,May-19,0,1,1
6280,user_6280,10490,209,119,90,May-19,0,1,1
6281,user_6281,3303,85,60,25,May-19,0,1,1
6282,user_6282,20401,178,131,47,May-19,0,1,1
6283,user_6283,728,149,115,34,May-19,0,1,1
6284,user_6284,1251,74,70,4,May-19,0,0,1
6285,user_6285,7143,81,65,16,Apr-19,1,1,0
6286,user_6286,2810,70,59,11,Feb-19,3,0,0
6287,user_6287,2202,161,146,15,Apr-19,1,1,0
6288,user_6288,2314,105,10,95,May-19,0,1,1
6289,user_6289,8845,552,263,289,May-19,0,1,1
6290,user_6290,2687,70,67,3,Mar-19,2,0,0
6291,user_6291,7307,140,97,43,May-19,0,1,1
6292,user_6292,8237,79,54,25,May-19,0,1,1
6293,user_6293,597,5,0,5,May-19,0,1,1
6294,user_6294,5858,348,216,132,May-19,0,1,1
6295,user_6295,3356,216,213,3,Mar-19,2,0,0
6296,user_6296,3516,56,14,42,Apr-19,1,1,0
6297,user_6297,23,4,4,0,Oct-18,7,0,0
6298,user_6298,20915,200,116,84,May-19,0,1,1
6299,user_6299,17990,223,118,105,May-19,0,1,1
6300,user_6300,2433,28,28,0,Dec-18,5,0,0
6301,user_6301,34810,829,419,410,May-19,0,1,1
6302,user_6302,108,7,7,0,Jun-18,11,0,0
6303,user_6303,2885,56,56,0,Jun-18,11,0,0
6304,user_6304,6528,57,49,8,May-19,0,0,1
6305,user_6305,4116,117,85,32,May-19,0,1,1
6306,user_6306,26,3,3,0,Nov-18,6,0,0
6307,user_6307,1048,156,30,126,May-19,0,1,1
6308,user_6308,16895,937,551,386,May-19,0,1,1
6309,user_6309,1779,26,26,0,Oct-18,7,0,0
6310,user_6310,8705,218,71,147,May-19,0,1,1
6312,user_6312,10375,288,149,139,May-19,0,1,1
6314,user_6314,223,6,4,2,Mar-19,2,0,0
6315,user_6315,23,4,4,0,Jun-18,11,0,0
6316,user_6316,16336,309,174,135,Apr-19,1,1,0
6317,user_6317,4413,56,17,39,May-19,0,1,1
6318,user_6318,47223,131,61,70,May-19,0,1,1
6319,user_6319,5817,49,45,4,Mar-19,2,0,0
6320,user_6320,4489,51,31,20,May-19,0,1,1
6321,user_6321,538,13,10,3,Mar-19,2,0,0
6322,user_6322,9997,115,105,10,Apr-19,1,1,0
6323,user_6323,2059,43,0,43,May-19,0,1,1
6324,user_6324,4825,75,56,19,May-19,0,1,1
6325,user_6325,9469,75,65,10,Jan-19,4,0,0
6326,user_6326,2827,95,69,26,May-19,0,1,1
6327,user_6327,3823,292,144,148,May-19,0,1,1
6328,user_6328,3055,275,253,22,Mar-19,2,0,0
6329,user_6329,11953,93,79,14,May-19,0,1,1
6330,user_6330,10252,736,385,351,May-19,0,1,1
6331,user_6331,30245,185,88,97,May-19,0,1,1
6332,user_6332,7489,119,19,100,May-19,0,1,1
6333,user_6333,20457,495,461,34,Feb-19,3,0,0
6335,user_6335,9,2,2,0,May-18,12,0,0
6336,user_6336,3687,221,56,165,May-19,0,1,1
6337,user_6337,4893,425,212,213,May-19,0,1,1
6338,user_6338,230,13,12,1,Apr-19,1,1,0
6339,user_6339,31,9,9,0,Nov-18,6,0,0
6340,user_6340,29517,80,43,37,May-19,0,1,1
6341,user_6341,2024,118,89,29,May-19,0,1,1
6342,user_6342,211,15,15,0,Sep-18,8,0,0
6343,user_6343,34439,94,36,58,May-19,0,1,1
6344,user_6344,4462,170,134,36,Apr-19,1,1,0
6345,user_6345,18189,1486,853,633,May-19,0,1,1
6346,user_6346,2760,62,40,22,Mar-19,2,0,0
6347,user_6347,6020,54,54,0,Oct-18,7,0,0
6348,user_6348,21,3,3,0,May-18,12,0,0
6349,user_6349,15132,431,249,182,May-19,0,1,1
6350,user_6350,3174,397,395,2,Jan-19,4,0,0
6351,user_6351,15980,154,135,19,Apr-19,1,1,0
6352,user_6352,1622,11,11,0,Jun-18,11,0,0
6353,user_6353,1470,72,63,9,May-19,0,1,1
6354,user_6354,315,9,2,7,May-19,0,1,1
6355,user_6355,366,5,5,0,Dec-18,5,0,0
6356,user_6356,35796,424,255,169,May-19,0,1,1
6357,user_6357,76416,578,368,210,May-19,0,1,1
6358,user_6358,2768,55,37,18,Mar-19,2,0,0
6359,user_6359,11927,461,441,20,Apr-19,1,1,0
6360,user_6360,697,33,33,0,Aug-18,9,0,0
6361,user_6361,4975,35,29,6,Apr-19,1,1,0
6362,user_6362,1378,34,34,0,Aug-18,9,0,0
6363,user_6363,1527,38,19,19,Apr-19,1,1,0
6364,user_6364,49476,183,121,62,Apr-19,1,1,0
6365,user_6365,57,17,5,12,May-19,0,0,1
6366,user_6366,1672,208,139,69,May-19,0,1,1
6367,user_6367,31,5,5,0,Dec-18,5,0,0
6368,user_6368,3151,24,24,0,Jun-18,11,0,0
6369,user_6369,5728,106,0,106,May-19,0,1,1
6370,user_6370,2070,271,230,41,May-19,0,1,1
6371,user_6371,14158,248,246,2,Apr-19,1,1,0
6372,user_6372,821,55,40,15,May-19,0,1,1
6373,user_6373,735,21,18,3,Apr-19,1,1,0
6374,user_6374,14148,209,143,66,Apr-19,1,1,0
6375,user_6375,741,50,49,1,Feb-19,3,0,0
6376,user_6376,3306,56,56,0,Aug-18,9,0,0
6377,user_6377,537,48,33,15,May-19,0,1,1
6378,user_6378,239,35,25,10,Apr-19,1,1,0
6379,user_6379,0,2,2,0,May-18,12,0,0
6381,user_6381,6258,261,79,182,May-19,0,1,1
6382,user_6382,1004,64,53,11,Apr-19,1,1,0
6383,user_6383,4340,170,144,26,Apr-19,1,1,0
6384,user_6384,8908,289,236,53,May-19,0,1,1
6385,user_6385,1189,25,0,25,Apr-19,1,1,0
6386,user_6386,4113,58,19,39,Apr-19,1,1,0
6387,user_6387,552,44,34,10,Apr-19,1,1,0
6388,user_6388,9223,632,451,181,May-19,0,1,1
6389,user_6389,2414,33,23,10,May-19,0,1,1
6390,user_6390,696,18,2,16,Apr-19,1,1,0
6391,user_6391,12459,174,164,10,Mar-19,2,0,0
6392,user_6392,9371,75,52,23,May-19,0,1,1
6393,user_6393,485,33,33,0,Dec-18,5,0,0
6394,user_6394,8807,52,9,43,Apr-19,1,1,0
6395,user_6395,16319,35,16,19,Mar-19,2,0,0
6396,user_6396,2906,55,55,0,Nov-18,6,0,0
6397,user_6397,1440,63,35,28,May-19,0,1,1
6398,user_6398,7827,204,124,80,May-19,0,1,1
6399,user_6399,207,11,8,3,May-19,0,0,1
6400,user_6400,2670,91,43,48,May-19,0,1,1
6401,user_6401,8807,405,163,242,May-19,0,1,1
6402,user_6402,4,2,2,0,May-18,12,0,0
6403,user_6403,2532,32,22,10,May-19,0,1,1
6404,user_6404,31,6,6,0,Sep-18,8,0,0
6405,user_6405,7942,240,78,162,May-19,0,1,1
6406,user_6406,28221,505,184,321,May-19,0,1,1
6407,user_6407,137,16,12,4,Apr-19,1,1,0
6408,user_6408,8,2,2,0,May-18,12,0,0
6409,user_6409,67,16,16,0,Jul-18,10,0,0
6410,user_6410,2567,81,80,1,Apr-19,1,1,0
6411,user_6411,414,20,20,0,Jun-18,11,0,0
6412,user_6412,655,10,7,3,Apr-19,1,1,0
6413,user_6413,4732,160,112,48,May-19,0,1,1
6414,user_6414,579,33,29,4,Jan-19,4,0,0
6415,user_6415,344,21,17,4,May-19,0,0,1
6416,user_6416,925,30,19,11,Mar-19,2,0,0
6417,user_6417,3157,109,76,33,Mar-19,2,0,0
6418,user_6418,52,7,7,0,Aug-18,9,0,0
6419,user_6419,20,2,2,0,Jun-18,11,0,0
6420,user_6420,50,7,6,1,Jan-19,4,0,0
6421,user_6421,8,3,3,0,Dec-18,5,0,0
6422,user_6422,3266,83,76,7,Mar-19,2,0,0
6423,user_6423,5462,144,48,96,May-19,0,1,1
6424,user_6424,2131,149,149,0,Sep-18,8,0,0
6425,user_6425,2528,8,7,1,Apr-19,1,1,0
6426,user_6426,9407,43,42,1,Jan-19,4,0,0
6427,user_6427,10023,126,126,0,Dec-18,5,0,0
6428,user_6428,2019,239,175,64,May-19,0,1,1
6429,user_6429,2314,30,30,0,Jun-18,11,0,0
6430,user_6430,34855,63,38,25,May-19,0,1,1
6431,user_6431,24967,220,220,0,Dec-18,5,0,0
6432,user_6432,1244,26,8,18,May-19,0,1,1
6433,user_6433,1258,54,5,49,May-19,0,1,1
6434,user_6434,12349,320,140,180,May-19,0,1,1
6435,user_6435,48207,96,69,27,Mar-19,2,0,0
6436,user_6436,111,10,10,0,May-18,12,0,0
6437,user_6437,5665,108,78,30,May-19,0,1,1
6438,user_6438,67,6,6,0,Dec-18,5,0,0
6439,user_6439,14,3,3,0,Jun-18,11,0,0
6440,user_6440,3431,83,83,0,Sep-18,8,0,0
6441,user_6441,9319,312,153,159,May-19,0,1,1
6442,user_6442,16762,331,224,107,May-19,0,1,1
6443,user_6443,10664,190,57,133,May-19,0,1,1
6444,user_6444,16160,296,207,89,Apr-19,1,1,0
6445,user_6445,4469,144,103,41,Mar-19,2,0,0
6446,user_6446,28354,253,180,73,May-19,0,1,1
6447,user_6447,5543,141,53,88,Apr-19,1,1,0
6448,user_6448,1610,64,56,8,Apr-19,1,1,0
6449,user_6449,7156,207,147,60,May-19,0,1,1
6450,user_6450,86,3,3,0,Jul-18,10,0,0
6451,user_6451,9683,638,432,206,May-19,0,1,1
6452,user_6452,2847,116,96,20,Apr-19,1,1,0
6453,user_6453,2909,321,297,24,Apr-19,1,1,0
6454,user_6454,35,8,7,1,Mar-19,2,0,0
6455,user_6455,6902,96,46,50,Mar-19,2,0,0
6456,user_6456,2662,51,51,0,Nov-18,6,0,0
6457,user_6457,2630,196,171,25,Apr-19,1,1,0
6458,user_6458,1510,50,47,3,Apr-19,1,1,0
6459,user_6459,941,126,75,51,May-19,0,1,1
6460,user_6460,23587,491,273,218,May-19,0,1,1
6461,user_6461,531,15,9,6,May-19,0,1,1
6462,user_6462,518,29,23,6,Mar-19,2,0,0
6463,user_6463,3662,96,96,0,Aug-18,9,0,0
6464,user_6464,11227,501,391,110,May-19,0,1,1
6465,user_6465,47,10,8,2,Mar-19,2,0,0
6466,user_6466,3094,108,77,31,Mar-19,2,0,0
6467,user_6467,20,5,5,0,Dec-18,5,0,0
6468,user_6468,32328,451,208,243,May-19,0,1,1
6469,user_6469,202,6,4,2,Apr-19,1,1,0
6470,user_6470,10507,38,38,0,Oct-18,7,0,0
6471,user_6471,0,1,1,0,May-18,12,0,0
6472,user_6472,1520,12,12,0,Jun-18,11,0,0
6473,user_6473,19340,259,177,82,Apr-19,1,1,0
6474,user_6474,5810,552,316,236,May-19,0,1,1
6475,user_6475,1066,13,6,7,Feb-19,3,0,0
6476,user_6476,214,15,7,8,Feb-19,3,0,0
6477,user_6477,62231,974,690,284,May-19,0,1,1
6478,user_6478,11868,343,201,142,May-19,0,1,1
6479,user_6479,899,32,30,2,Apr-19,1,1,0
6481,user_6481,87926,126,102,24,May-19,0,1,1
6482,user_6482,9978,76,64,12,Apr-19,1,1,0
6483,user_6483,8910,148,75,73,May-19,0,1,1
6484,user_6484,24148,137,92,45,May-19,0,1,1
6486,user_6486,5211,634,630,4,Apr-19,1,1,0
6487,user_6487,7085,162,110,52,May-19,0,1,1
6488,user_6488,11130,185,162,23,May-19,0,0,1
6489,user_6489,11883,286,174,112,May-19,0,1,1
6490,user_6490,1007,38,38,0,Jun-18,11,0,0
6491,user_6491,456,15,15,0,Nov-18,6,0,0
6493,user_6493,21170,243,155,88,May-19,0,1,1
6494,user_6494,2431,73,39,34,Mar-19,2,0,0
6495,user_6495,396,7,6,1,May-19,0,0,1
6496,user_6496,689,33,33,0,Dec-18,5,0,0
6497,user_6497,3959,100,74,26,May-19,0,1,1
6498,user_6498,257120,298,160,138,May-19,0,1,1
6499,user_6499,214,25,19,6,Apr-19,1,1,0
6500,user_6500,5270,62,53,9,May-19,0,1,1
6501,user_6501,18589,976,456,520,May-19,0,1,1
6502,user_6502,61654,507,330,177,May-19,0,1,1
6503,user_6503,2934,35,35,0,Jul-18,10,0,0
6504,user_6504,2598,220,137,83,Apr-19,1,1,0
6505,user_6505,996,46,37,9,May-19,0,1,1
6506,user_6506,31133,613,196,417,May-19,0,1,1
6507,user_6507,3888,51,40,11,May-19,0,1,1
6508,user_6508,29710,193,129,64,May-19,0,1,1
6509,user_6509,349,15,4,11,Apr-19,1,1,0
6510,user_6510,1817,14,14,0,Sep-18,8,0,0
6511,user_6511,14215,101,80,21,May-19,0,1,1
6512,user_6512,1730,20,16,4,Apr-19,1,1,0
6513,user_6513,22136,1521,654,867,May-19,0,1,1
6514,user_6514,3090,52,51,1,Jan-19,4,0,0
6515,user_6515,7035,184,89,95,May-19,0,1,1
6516,user_6516,6268,219,130,89,May-19,0,1,1
6517,user_6517,8,2,0,2,Mar-19,2,0,0
6518,user_6518,9,2,2,0,Jul-18,10,0,0
6519,user_6519,1244,18,17,1,Apr-19,1,1,0
6520,user_6520,5,1,1,0,May-18,12,0,0
6521,user_6521,13269,204,80,124,May-19,0,1,1
6522,user_6522,30,8,7,1,Jan-19,4,0,0
6523,user_6523,5972,225,184,41,May-19,0,1,1
6524,user_6524,84,17,17,0,Jun-18,11,0,0
6525,user_6525,6550,495,340,155,May-19,0,1,1
6526,user_6526,4389,225,158,67,Apr-19,1,1,0
6527,user_6527,823,47,47,0,Dec-18,5,0,0
6528,user_6528,929,93,76,17,May-19,0,1,1
6529,user_6529,110256,204,116,88,May-19,0,1,1
6530,user_6530,21522,1188,728,460,May-19,0,1,1
6531,user_6531,931,56,56,0,Dec-18,5,0,0
6532,user_6532,822,10,10,0,Jul-18,10,0,0
6533,user_6533,893,38,38,0,Dec-18,5,0,0
6534,user_6534,3070,87,81,6,Mar-19,2,0,0
6535,user_6535,535,81,61,20,Apr-19,1,1,0
6536,user_6536,101652,925,479,446,May-19,0,1,1
6537,user_6537,529,24,24,0,Aug-18,9,0,0
6538,user_6538,6249,101,100,1,May-19,0,0,1
6539,user_6539,10542,226,130,96,May-19,0,1,1
6540,user_6540,673,70,27,43,May-19,0,1,1
6541,user_6541,701,29,29,0,Dec-18,5,0,0
6542,user_6542,3295,167,53,114,May-19,0,1,1
6543,user_6543,428,52,30,22,Apr-19,1,1,0
6544,user_6544,14940,883,557,326,May-19,0,1,1
6545,user_6545,357,25,14,11,Mar-19,2,0,0
6546,user_6546,11758,26,13,13,May-19,0,1,1
6547,user_6547,6387,112,112,0,Oct-18,7,0,0
6548,user_6548,1398,87,53,34,Apr-19,1,1,0
6549,user_6549,2827,59,59,0,Jul-18,10,0,0
6550,user_6550,144847,2594,1026,1568,May-19,0,1,1
6551,user_6551,6318,228,113,115,May-19,0,1,1
6552,user_6552,12510,236,212,24,May-19,0,1,1
6553,user_6553,2231,32,32,0,Oct-18,7,0,0
6554,user_6554,2656,331,289,42,Mar-19,2,0,0
6555,user_6555,3600,55,31,24,May-19,0,1,1
6556,user_6556,52653,403,382,21,May-19,0,1,1
6557,user_6557,388,16,6,10,Mar-19,2,0,0
6559,user_6559,2069,140,139,1,Jan-19,4,0,0
6560,user_6560,510,2,2,0,Jun-18,11,0,0
6561,user_6561,2836,73,55,18,Apr-19,1,1,0
6562,user_6562,17054,197,96,101,May-19,0,1,1
6563,user_6563,21,3,3,0,May-18,12,0,0
6564,user_6564,4311,80,55,25,Apr-19,1,1,0
6565,user_6565,196,21,15,6,May-19,0,1,1
6566,user_6566,4331,69,40,29,May-19,0,1,1
6567,user_6567,14933,314,215,99,May-19,0,1,1
6568,user_6568,11165,6,6,0,Dec-18,5,0,0
6569,user_6569,1222,38,15,23,Apr-19,1,1,0
6570,user_6570,25577,910,822,88,May-19,0,1,1
6571,user_6571,7443,403,191,212,May-19,0,1,1
6572,user_6572,5165,90,67,23,May-19,0,0,1
6573,user_6573,63,5,5,0,Jun-18,11,0,0
6574,user_6574,14687,173,173,0,Jul-18,10,0,0
6575,user_6575,11632,375,215,160,Apr-19,1,1,0
6576,user_6576,6027,247,126,121,May-19,0,1,1
6577,user_6577,21,3,3,0,May-18,12,0,0
6578,user_6578,4588,35,25,10,May-19,0,1,1
6579,user_6579,9861,464,341,123,May-19,0,1,1
6580,user_6580,4589,103,7,96,May-19,0,1,1
6581,user_6581,1926,31,18,13,Mar-19,2,0,0
6582,user_6582,34276,1537,737,800,May-19,0,1,1
6583,user_6583,28981,211,134,77,Apr-19,1,1,0
6584,user_6584,4501,41,37,4,Jan-19,4,0,0
6585,user_6585,4940,65,59,6,Mar-19,2,0,0
6586,user_6586,3979,127,73,54,Mar-19,2,0,0
6587,user_6587,3236,42,41,1,Mar-19,2,0,0
6588,user_6588,2172,52,52,0,Nov-18,6,0,0
6589,user_6589,166,21,1,20,Apr-19,1,1,0
6590,user_6590,2652,52,30,22,Feb-19,3,0,0
6591,user_6591,31,4,4,0,Oct-18,7,0,0
6592,user_6592,14902,439,171,268,May-19,0,1,1
6593,user_6593,1563,51,48,3,Apr-19,1,1,0
6594,user_6594,16873,448,377,71,May-19,0,1,1
6595,user_6595,1278,65,11,54,Apr-19,1,1,0
6596,user_6596,2715,50,14,36,May-19,0,1,1
6597,user_6597,3161,80,66,14,Apr-19,1,1,0
6598,user_6598,22505,118,22,96,May-19,0,1,1
6599,user_6599,675,31,2,29,Apr-19,1,1,0
6600,user_6600,43249,1984,817,1167,May-19,0,1,1
6601,user_6601,1779,87,68,19,May-19,0,1,1
6602,user_6602,141,29,23,6,Apr-19,1,1,0
6603,user_6603,7,5,5,0,Jun-18,11,0,0
6604,user_6604,2383,85,65,20,Apr-19,1,1,0
6605,user_6605,8015,79,79,0,Oct-18,7,0,0
6606,user_6606,401,3,3,0,Jun-18,11,0,0
6607,user_6607,7495,79,54,25,Mar-19,2,0,0
6608,user_6608,3277,14,14,0,Aug-18,9,0,0
6609,user_6609,9082,499,268,231,May-19,0,1,1
6610,user_6610,17589,96,80,16,Apr-19,1,1,0
6611,user_6611,77453,303,174,129,May-19,0,1,1
6612,user_6612,861,27,8,19,Apr-19,1,1,0
6614,user_6614,2939,73,45,28,May-19,0,1,1
6615,user_6615,829,25,21,4,Apr-19,1,1,0
6617,user_6617,11750,51,49,2,Mar-19,2,0,0
6618,user_6618,2357,55,32,23,Apr-19,1,1,0
6619,user_6619,25814,1079,750,329,May-19,0,1,1
6620,user_6620,123,12,8,4,May-19,0,1,1
6621,user_6621,670,54,38,16,May-19,0,1,1
6622,user_6622,5046,140,71,69,May-19,0,1,1
6623,user_6623,1954,45,44,1,Mar-19,2,0,0
6624,user_6624,52075,1533,536,997,May-19,0,1,1
6625,user_6625,140,6,3,3,Apr-19,1,1,0
6626,user_6626,6812,132,94,38,Apr-19,1,1,0
6627,user_6627,13,3,0,3,May-19,0,0,1
6628,user_6628,1204,59,14,45,Apr-19,1,1,0
6629,user_6629,3767,293,45,248,May-19,0,1,1
6630,user_6630,21,1,1,0,Jun-18,11,0,0
6631,user_6631,15819,269,156,113,May-19,0,1,1
6632,user_6632,7466,378,77,301,May-19,0,1,1
6633,user_6633,2312,106,47,59,May-19,0,1,1
6634,user_6634,868,26,19,7,Apr-19,1,1,0
6635,user_6635,2621,91,90,1,Jan-19,4,0,0
6636,user_6636,5235,108,41,67,Apr-19,1,1,0
6637,user_6637,692,7,7,0,Jul-18,10,0,0
6638,user_6638,3117,52,52,0,Sep-18,8,0,0
6639,user_6639,2253,79,76,3,Apr-19,1,1,0
6640,user_6640,1352,49,32,17,May-19,0,0,1
6641,user_6641,233,8,7,1,Mar-19,2,0,0
6642,user_6642,3,1,1,0,Jun-18,11,0,0
6643,user_6643,66,9,7,2,Mar-19,2,0,0
6644,user_6644,5844,205,133,72,May-19,0,1,1
6645,user_6645,3026,24,24,0,Jun-18,11,0,0
6646,user_6646,21201,296,172,124,May-19,0,1,1
6648,user_6648,6286,195,15,180,May-19,0,1,1
6649,user_6649,3140,58,12,46,May-19,0,1,1
6650,user_6650,3014,32,24,8,Mar-19,2,0,0
6651,user_6651,12293,731,369,362,May-19,0,1,1
6652,user_6652,4534,172,160,12,May-19,0,1,1
6653,user_6653,1599,22,22,0,Jun-18,11,0,0
6654,user_6654,222,17,17,0,Oct-18,7,0,0
6655,user_6655,71348,719,390,329,May-19,0,1,1
6656,user_6656,3137,116,92,24,May-19,0,1,1
6657,user_6657,1660,48,48,0,Jul-18,10,0,0
6658,user_6658,5002,74,23,51,May-19,0,1,1
6659,user_6659,93,4,4,0,Nov-18,6,0,0
6660,user_6660,21,3,2,1,May-19,0,0,1
6661,user_6661,3518,21,16,5,Apr-19,1,1,0
6663,user_6663,12328,540,343,197,May-19,0,1,1
6664,user_6664,2665,62,54,8,May-19,0,0,1
6665,user_6665,70,1,1,0,Jun-18,11,0,0
6666,user_6666,125,2,2,0,Aug-18,9,0,0
6667,user_6667,181379,1003,276,727,May-19,0,1,1
6668,user_6668,13267,177,151,26,May-19,0,1,1
6669,user_6669,19566,141,125,16,Feb-19,3,0,0
6670,user_6670,108163,2288,1099,1189,May-19,0,1,1
6671,user_6671,650,15,14,1,Apr-19,1,1,0
6673,user_6673,2857,288,142,146,May-19,0,1,1
6674,user_6674,2874,36,36,0,Sep-18,8,0,0
6675,user_6675,52392,2126,1100,1026,May-19,0,1,1
6676,user_6676,6215,188,14,174,May-19,0,1,1
6678,user_6678,5783,344,193,151,May-19,0,1,1
6679,user_6679,69,3,3,0,Jun-18,11,0,0
6680,user_6680,9,2,2,0,Dec-18,5,0,0
6681,user_6681,154,7,7,0,Jun-18,11,0,0
6682,user_6682,4469,94,64,30,May-19,0,1,1
6683,user_6683,9338,279,153,126,May-19,0,1,1
6684,user_6684,2045,78,24,54,May-19,0,1,1
6685,user_6685,10503,392,299,93,Apr-19,1,1,0
6686,user_6686,182,13,8,5,May-19,0,1,1
6687,user_6687,4638,244,99,145,Apr-19,1,1,0
6688,user_6688,100,11,2,9,Apr-19,1,1,0
6689,user_6689,568,74,27,47,May-19,0,1,1
6690,user_6690,1606,111,72,39,Apr-19,1,1,0
6691,user_6691,2113,70,55,15,Apr-19,1,1,0
6692,user_6692,143,4,4,0,Jun-18,11,0,0
6693,user_6693,85,19,19,0,Dec-18,5,0,0
6694,user_6694,8951,249,111,138,May-19,0,1,1
6695,user_6695,38914,95,57,38,Apr-19,1,1,0
6696,user_6696,25934,267,209,58,Apr-19,1,1,0
6697,user_6697,16765,167,54,113,May-19,0,1,1
6698,user_6698,1792,10,10,0,Jun-18,11,0,0
6699,user_6699,177,21,11,10,May-19,0,1,1
6700,user_6700,4411,113,26,87,Apr-19,1,1,0
6701,user_6701,6994,116,60,56,May-19,0,1,1
6702,user_6702,21,3,3,0,Jun-18,11,0,0
6703,user_6703,7974,192,107,85,May-19,0,1,1
6704,user_6704,2660,56,53,3,Mar-19,2,0,0
6705,user_6705,11049,361,360,1,Mar-19,2,0,0
6706,user_6706,1394,67,66,1,Mar-19,2,0,0
6707,user_6707,19,3,3,0,Jun-18,11,0,0
6708,user_6708,11776,537,315,222,May-19,0,1,1
6709,user_6709,216,20,18,2,Feb-19,3,0,0
6710,user_6710,17244,215,162,53,May-19,0,0,1
6711,user_6711,8898,120,53,67,May-19,0,1,1
6712,user_6712,12405,265,180,85,May-19,0,1,1
6713,user_6713,11978,797,411,386,May-19,0,1,1
6714,user_6714,1878,32,12,20,May-19,0,1,1
6715,user_6715,1601,48,37,11,Feb-19,3,0,0
6716,user_6716,1909,107,34,73,May-19,0,1,1
6717,user_6717,31712,1069,371,698,May-19,0,1,1
6718,user_6718,268,9,9,0,Dec-18,5,0,0
6719,user_6719,2255,36,34,2,May-19,0,0,1
6720,user_6720,5926,77,4,73,May-19,0,1,1
6721,user_6721,3109,127,49,78,May-19,0,1,1
6722,user_6722,202227,173,73,100,May-19,0,1,1
6723,user_6723,7978,676,414,262,May-19,0,1,1
6724,user_6724,15615,267,182,85,Apr-19,1,1,0
6725,user_6725,9796,132,118,14,Apr-19,1,1,0
6726,user_6726,4001,181,152,29,Apr-19,1,1,0
6727,user_6727,44762,257,60,197,May-19,0,1,1
6728,user_6728,21,3,3,0,Jun-18,11,0,0
6729,user_6729,48468,294,197,97,May-19,0,0,1
6730,user_6730,1550,37,36,1,Jan-19,4,0,0
6731,user_6731,7500,277,181,96,May-19,0,1,1
6732,user_6732,4569,59,29,30,Apr-19,1,1,0
6733,user_6733,1279,17,14,3,Mar-19,2,0,0
6734,user_6734,3362,133,133,0,Aug-18,9,0,0
6735,user_6735,30,6,5,1,Apr-19,1,1,0
6736,user_6736,7802,106,59,47,Apr-19,1,1,0
6737,user_6737,4138,191,34,157,May-19,0,1,1
6738,user_6738,8457,170,168,2,Jan-19,4,0,0
6739,user_6739,8941,352,207,145,May-19,0,1,1
6740,user_6740,5790,85,55,30,May-19,0,1,1
6741,user_6741,27676,1023,629,394,May-19,0,1,1
6742,user_6742,250,15,15,0,Nov-18,6,0,0
6743,user_6743,2621,59,58,1,May-19,0,0,1
6744,user_6744,14558,218,189,29,May-19,0,1,1
6745,user_6745,348,7,7,0,Jul-18,10,0,0
6746,user_6746,34,7,2,5,Feb-19,3,0,0
6747,user_6747,27,5,5,0,Aug-18,9,0,0
6748,user_6748,14440,233,156,77,May-19,0,1,1
6749,user_6749,1048,31,27,4,Apr-19,1,1,0
6750,user_6750,13664,114,107,7,Apr-19,1,1,0
6751,user_6751,1229,61,37,24,Apr-19,1,1,0
6752,user_6752,40220,1012,621,391,Apr-19,1,1,0
6753,user_6753,16335,381,52,329,May-19,0,1,1
6754,user_6754,807,20,19,1,Feb-19,3,0,0
6755,user_6755,23879,189,108,81,May-19,0,1,1
6757,user_6757,21,3,3,0,Jun-18,11,0,0
6758,user_6758,5694,464,255,209,May-19,0,1,1
6759,user_6759,590,29,22,7,Feb-19,3,0,0
6760,user_6760,16904,1260,773,487,May-19,0,1,1
6761,user_6761,2167,220,145,75,Apr-19,1,1,0
6762,user_6762,2165,35,28,7,Apr-19,1,1,0
6763,user_6763,16,3,3,0,Jun-18,11,0,0
6764,user_6764,4736,139,128,11,May-19,0,1,1
6765,user_6765,1023,64,27,37,Apr-19,1,1,0
6766,user_6766,3300,21,15,6,Feb-19,3,0,0
6767,user_6767,1253,64,32,32,May-19,0,1,1
6768,user_6768,713,9,9,0,Nov-18,6,0,0
6769,user_6769,1767,76,34,42,May-19,0,1,1
6770,user_6770,84,25,12,13,Mar-19,2,0,0
6771,user_6771,8848,33,33,0,Oct-18,7,0,0
6772,user_6772,1534,39,3,36,Apr-19,1,1,0
6773,user_6773,18,3,3,0,Jun-18,11,0,0
6774,user_6774,86,2,2,0,Dec-18,5,0,0
6775,user_6775,159,4,4,0,Jul-18,10,0,0
6776,user_6776,535,9,9,0,Nov-18,6,0,0
6777,user_6777,11,2,2,0,Jun-18,11,0,0
6778,user_6778,11,2,2,0,Jun-18,11,0,0
6779,user_6779,3794,172,158,14,Apr-19,1,1,0
6780,user_6780,3647,200,64,136,May-19,0,1,1
6781,user_6781,36,2,0,2,Mar-19,2,0,0
6782,user_6782,1313,18,13,5,May-19,0,0,1
6783,user_6783,13786,339,252,87,May-19,0,1,1
6784,user_6784,18358,645,360,285,May-19,0,1,1
6785,user_6785,65923,577,356,221,May-19,0,1,1
6786,user_6786,9984,588,280,308,May-19,0,1,1
6787,user_6787,8,3,3,0,Jun-18,11,0,0
6788,user_6788,9,1,1,0,Jun-18,11,0,0
6789,user_6789,57,8,3,5,Apr-19,1,1,0
6790,user_6790,81048,941,462,479,May-19,0,1,1
6791,user_6791,705,8,8,0,Aug-18,9,0,0
6792,user_6792,1966,83,51,32,Apr-19,1,1,0
6793,user_6793,10,3,1,2,Jan-19,4,0,0
6794,user_6794,34445,317,252,65,May-19,0,1,1
6795,user_6795,9810,341,216,125,May-19,0,1,1
6796,user_6796,10552,111,108,3,Jan-19,4,0,0
6797,user_6797,1631,93,57,36,Apr-19,1,1,0
6798,user_6798,853820,168,45,123,May-19,0,1,1
6799,user_6799,25905,176,163,13,May-19,0,1,1
6800,user_6800,3207,107,67,40,May-19,0,1,1
6801,user_6801,241,15,12,3,Mar-19,2,0,0
6802,user_6802,34,6,0,6,Apr-19,1,1,0
6803,user_6803,30,4,4,0,Jun-18,11,0,0
6804,user_6804,3227,100,93,7,Mar-19,2,0,0
6805,user_6805,6603,128,88,40,May-19,0,1,1
6806,user_6806,5531,102,57,45,Apr-19,1,1,0
6808,user_6808,6873,57,19,38,May-19,0,1,1
6809,user_6809,11,2,2,0,Jun-18,11,0,0
6810,user_6810,2413,63,61,2,Apr-19,1,1,0
6811,user_6811,151,13,13,0,Sep-18,8,0,0
6812,user_6812,4579,63,63,0,Oct-18,7,0,0
6813,user_6813,800,29,5,24,Mar-19,2,0,0
6814,user_6814,17,6,4,2,Mar-19,2,0,0
6815,user_6815,3490,466,316,150,May-19,0,1,1
6816,user_6816,4795,31,18,13,May-19,0,1,1
6817,user_6817,270,7,4,3,Mar-19,2,0,0
6818,user_6818,5347,60,8,52,May-19,0,1,1
6819,user_6819,16924,91,89,2,Apr-19,1,1,0
6820,user_6820,1569,82,33,49,Apr-19,1,1,0
6821,user_6821,3107,132,118,14,Mar-19,2,0,0
6822,user_6822,4699,66,40,26,May-19,0,1,1
6823,user_6823,28457,221,109,112,May-19,0,1,1
6824,user_6824,5010,240,72,168,May-19,0,1,1
6825,user_6825,1637,167,119,48,May-19,0,1,1
6826,user_6826,5755,132,94,38,Apr-19,1,1,0
6827,user_6827,259,9,9,0,Sep-18,8,0,0
6828,user_6828,7,5,5,0,Jun-18,11,0,0
6829,user_6829,8239,240,178,62,May-19,0,1,1
6830,user_6830,9,2,2,0,Jun-18,11,0,0
6831,user_6831,25,23,0,23,May-19,0,1,1
6832,user_6832,12298,110,48,62,May-19,0,1,1
6833,user_6833,7903,185,182,3,Mar-19,2,0,0
6834,user_6834,1206,36,36,0,Sep-18,8,0,0
6835,user_6835,2610,27,21,6,May-19,0,0,1
6836,user_6836,4956,101,77,24,Apr-19,1,1,0
6837,user_6837,42764,1355,1114,241,May-19,0,1,1
6838,user_6838,7456,215,124,91,Apr-19,1,1,0
6839,user_6839,10195,773,362,411,May-19,0,1,1
6840,user_6840,2160,115,10,105,May-19,0,1,1
6841,user_6841,233,17,17,0,Dec-18,5,0,0
6842,user_6842,1797,53,33,20,May-19,0,0,1
6843,user_6843,99108,270,178,92,May-19,0,1,1
6844,user_6844,3354,235,185,50,May-19,0,1,1
6845,user_6845,22342,711,387,324,May-19,0,1,1
6846,user_6846,5658,170,97,73,Apr-19,1,1,0
6847,user_6847,25351,568,265,303,May-19,0,1,1
6848,user_6848,1497,154,83,71,May-19,0,0,1
6849,user_6849,6274,276,204,72,Apr-19,1,1,0
6850,user_6850,4686,185,0,185,May-19,0,1,1
6851,user_6851,40400,1155,765,390,May-19,0,1,1
6852,user_6852,2100,103,68,35,May-19,0,1,1
6853,user_6853,4159,154,82,72,Apr-19,1,1,0
6854,user_6854,2203,173,138,35,Apr-19,1,1,0
6855,user_6855,665,45,45,0,Dec-18,5,0,0
6856,user_6856,2707,55,55,0,Nov-18,6,0,0
6857,user_6857,168,6,6,0,Jun-18,11,0,0
6858,user_6858,11147,303,245,58,May-19,0,0,1
6859,user_6859,40,2,2,0,Dec-18,5,0,0
6860,user_6860,6,3,2,1,Apr-19,1,1,0
6861,user_6861,179,31,31,0,Nov-18,6,0,0
6862,user_6862,12691,535,327,208,May-19,0,1,1
6863,user_6863,39695,89,85,4,May-19,0,1,1
6864,user_6864,24277,535,354,181,May-19,0,1,1
6865,user_6865,25320,64,37,27,May-19,0,1,1
6866,user_6866,1830,67,32,35,May-19,0,1,1
6867,user_6867,1973,41,41,0,Dec-18,5,0,0
6868,user_6868,3983,70,37,33,Apr-19,1,1,0
6869,user_6869,2575,22,21,1,Apr-19,1,1,0
6871,user_6871,146658,296,42,254,May-19,0,1,1
6872,user_6872,15740,460,328,132,May-19,0,1,1
6873,user_6873,732,34,23,11,May-19,0,1,1
6874,user_6874,287,4,4,0,Jun-18,11,0,0
6875,user_6875,2655,74,40,34,May-19,0,1,1
6876,user_6876,12838,151,78,73,May-19,0,1,1
6877,user_6877,7299,318,144,174,May-19,0,1,1
6878,user_6878,36,5,4,1,Apr-19,1,1,0
6879,user_6879,1400,159,111,48,May-19,0,1,1
6880,user_6880,7278,195,137,58,May-19,0,1,1
6881,user_6881,7927,103,103,0,Oct-18,7,0,0
6882,user_6882,3377,34,34,0,Aug-18,9,0,0
6883,user_6883,178,9,9,0,Dec-18,5,0,0
6884,user_6884,10193,653,387,266,May-19,0,1,1
6885,user_6885,1290,17,17,0,Jul-18,10,0,0
6886,user_6886,345,12,12,0,Dec-18,5,0,0
6887,user_6887,14488,170,134,36,May-19,0,1,1
6888,user_6888,15,7,4,3,May-19,0,0,1
6889,user_6889,3949,168,107,61,May-19,0,1,1
6891,user_6891,8153,111,83,28,Apr-19,1,1,0
6892,user_6892,3989,95,78,17,Apr-19,1,1,0
6893,user_6893,219,11,11,0,Aug-18,9,0,0
6894,user_6894,1101,75,75,0,Dec-18,5,0,0
6895,user_6895,940,85,20,65,May-19,0,1,1
6896,user_6896,139558,59,31,28,Apr-19,1,1,0
6897,user_6897,2864,25,25,0,Sep-18,8,0,0
6898,user_6898,1186,47,47,0,Dec-18,5,0,0
6899,user_6899,948,117,78,39,May-19,0,0,1
6900,user_6900,447,22,22,0,Dec-18,5,0,0
6901,user_6901,1890,39,39,0,Jul-18,10,0,0
6902,user_6902,1190,13,11,2,Feb-19,3,0,0
6903,user_6903,9304,244,175,69,May-19,0,1,1
6904,user_6904,3620,318,178,140,May-19,0,1,1
6905,user_6905,4964,224,157,67,May-19,0,1,1
6906,user_6906,12536,353,188,165,May-19,0,1,1
6907,user_6907,30,5,5,0,Nov-18,6,0,0
6908,user_6908,14,3,3,0,Jul-18,10,0,0
6909,user_6909,16,3,3,0,Jun-18,11,0,0
6910,user_6910,517,18,15,3,Apr-19,1,1,0
6911,user_6911,4756,41,33,8,May-19,0,1,1
6912,user_6912,3850,29,29,0,Aug-18,9,0,0
6913,user_6913,437,19,19,0,Sep-18,8,0,0
6914,user_6914,55112,595,373,222,May-19,0,1,1
6915,user_6915,483,43,43,0,Oct-18,7,0,0
6916,user_6916,1291,42,42,0,Nov-18,6,0,0
6917,user_6917,477,18,9,9,May-19,0,1,1
6918,user_6918,1259,41,31,10,May-19,0,1,1
6919,user_6919,330,20,16,4,Feb-19,3,0,0
6920,user_6920,823,112,78,34,Mar-19,2,0,0
6921,user_6921,12528,691,461,230,May-19,0,1,1
6922,user_6922,894,48,35,13,Mar-19,2,0,0
6923,user_6923,289,20,20,0,Nov-18,6,0,0
6924,user_6924,1424,48,26,22,May-19,0,0,1
6925,user_6925,131,4,4,0,Jun-18,11,0,0
6926,user_6926,169,23,8,15,Apr-19,1,1,0
6927,user_6927,2421,28,28,0,Sep-18,8,0,0
6928,user_6928,186,11,11,0,Sep-18,8,0,0
6929,user_6929,26,2,0,2,Mar-19,2,0,0
6930,user_6930,2898,61,49,12,May-19,0,1,1
6931,user_6931,514,34,33,1,Feb-19,3,0,0
6932,user_6932,16,3,3,0,Jun-18,11,0,0
6933,user_6933,41885,214,56,158,May-19,0,1,1
6934,user_6934,1031,10,10,0,Jun-18,11,0,0
6935,user_6935,31978,860,427,433,May-19,0,1,1
6936,user_6936,21673,472,293,179,May-19,0,1,1
6937,user_6937,929,25,25,0,Jul-18,10,0,0
6938,user_6938,40,4,4,0,Jul-18,10,0,0
6939,user_6939,16,4,4,0,Dec-18,5,0,0
6940,user_6940,418,13,13,0,Aug-18,9,0,0
6941,user_6941,1337,28,25,3,Mar-19,2,0,0
6942,user_6942,5179,212,132,80,Mar-19,2,0,0
6944,user_6944,21,3,3,0,Jun-18,11,0,0
6945,user_6945,18937,835,421,414,May-19,0,1,1
6946,user_6946,13,3,3,0,Jun-18,11,0,0
6947,user_6947,9,2,2,0,Jun-18,11,0,0
6948,user_6948,7668,119,106,13,Apr-19,1,1,0
6949,user_6949,13595,236,91,145,May-19,0,1,1
6950,user_6950,12494,16,3,13,May-19,0,0,1
6951,user_6951,1223,39,39,0,Jul-18,10,0,0
6952,user_6952,958,45,44,1,Feb-19,3,0,0
6953,user_6953,17,7,7,0,Nov-18,6,0,0
6954,user_6954,69,17,14,3,Mar-19,2,0,0
6955,user_6955,10062,93,52,41,May-19,0,1,1
6956,user_6956,214,17,3,14,Apr-19,1,1,0
6957,user_6957,8,4,4,0,Jun-18,11,0,0
6958,user_6958,23972,205,147,58,May-19,0,1,1
6959,user_6959,91,22,22,0,Jul-18,10,0,0
6960,user_6960,3502,24,24,0,Jul-18,10,0,0
6961,user_6961,379,45,9,36,Apr-19,1,1,0
6962,user_6962,650,90,0,90,May-19,0,1,1
6963,user_6963,887,73,49,24,May-19,0,1,1
6964,user_6964,6643,40,4,36,May-19,0,0,1
6965,user_6965,12127,68,59,9,May-19,0,1,1
6966,user_6966,41191,1154,774,380,May-19,0,1,1
6967,user_6967,101730,1196,882,314,May-19,0,1,1
6968,user_6968,15,2,2,0,Jul-18,10,0,0
6969,user_6969,1168,59,57,2,Jan-19,4,0,0
6970,user_6970,32473,676,435,241,May-19,0,1,1
6971,user_6971,9346,334,245,89,Apr-19,1,1,0
6972,user_6972,3456,41,8,33,Apr-19,1,1,0
6973,user_6973,7912,88,88,0,Sep-18,8,0,0
6974,user_6974,4,2,2,0,Jun-18,11,0,0
6975,user_6975,35032,16,11,5,Apr-19,1,1,0
6976,user_6976,11676,109,27,82,May-19,0,1,1
6977,user_6977,7310,91,78,13,Apr-19,1,1,0
6978,user_6978,9702,65,45,20,Mar-19,2,0,0
6979,user_6979,2951,185,162,23,Apr-19,1,1,0
6980,user_6980,6179,89,62,27,May-19,0,1,1
6981,user_6981,17648,448,292,156,May-19,0,1,1
6982,user_6982,5633,109,68,41,Apr-19,1,1,0
6983,user_6983,2967,114,114,0,Sep-18,8,0,0
6984,user_6984,1099,31,30,1,Jan-19,4,0,0
6985,user_6985,4275,27,27,0,Aug-18,9,0,0
6986,user_6986,565,6,6,0,Sep-18,8,0,0
6987,user_6987,9,2,2,0,Jul-18,10,0,0
6988,user_6988,2401,16,16,0,Jul-18,10,0,0
6989,user_6989,6007,10,5,5,May-19,0,1,1
6990,user_6990,1062,57,53,4,Jan-19,4,0,0
6991,user_6991,33297,184,127,57,Apr-19,1,1,0
6992,user_6992,4733,165,156,9,Mar-19,2,0,0
6993,user_6993,437,31,9,22,Apr-19,1,1,0
6994,user_6994,16,3,3,0,Jun-18,11,0,0
6995,user_6995,1176,24,24,0,Nov-18,6,0,0
6996,user_6996,7042,86,74,12,May-19,0,1,1
6997,user_6997,285,42,36,6,Mar-19,2,0,0
6998,user_6998,7596,60,20,40,May-19,0,1,1
6999,user_6999,8677,449,214,235,May-19,0,1,1
7000,user_7000,1152,24,24,0,Jun-18,11,0,0
7001,user_7001,3304,149,104,45,May-19,0,1,1
7002,user_7002,3767,63,37,26,Mar-19,2,0,0
7003,user_7003,19,2,2,0,Jun-18,11,0,0
7004,user_7004,3512,119,54,65,Mar-19,2,0,0
7005,user_7005,62,9,6,3,Jan-19,4,0,0
7006,user_7006,6768,446,245,201,Apr-19,1,1,0
7007,user_7007,3456,247,78,169,May-19,0,1,1
7008,user_7008,16693,478,283,195,May-19,0,1,1
7009,user_7009,11096,444,271,173,May-19,0,1,1
7010,user_7010,10439,65,65,0,Dec-18,5,0,0
7011,user_7011,11723,318,249,69,May-19,0,1,1
7012,user_7012,2456,190,190,0,Dec-18,5,0,0
7013,user_7013,7444,62,54,8,Apr-19,1,1,0
7014,user_7014,206,11,3,8,Apr-19,1,1,0
7015,user_7015,4893,91,23,68,May-19,0,1,1
7016,user_7016,3940,7,7,0,Oct-18,7,0,0
7017,user_7017,1082,27,27,0,Sep-18,8,0,0
7018,user_7018,5951,96,84,12,May-19,0,1,1
7019,user_7019,14737,103,81,22,May-19,0,0,1
7020,user_7020,527,13,13,0,Jul-18,10,0,0
7021,user_7021,11,2,2,0,Jun-18,11,0,0
7022,user_7022,23531,132,99,33,Apr-19,1,1,0
7023,user_7023,20,5,5,0,Jun-18,11,0,0
7025,user_7025,9228,241,99,142,May-19,0,1,1
7026,user_7026,41970,400,183,217,May-19,0,1,1
7027,user_7027,1111,89,28,61,Apr-19,1,1,0
7028,user_7028,552,29,15,14,Apr-19,1,1,0
7029,user_7029,11324,247,141,106,Apr-19,1,1,0
7030,user_7030,8383,513,157,356,May-19,0,1,1
7031,user_7031,4432,49,24,25,Apr-19,1,1,0
7032,user_7032,3063,52,51,1,Mar-19,2,0,0
7033,user_7033,33862,425,341,84,May-19,0,1,1
7034,user_7034,6157,471,224,247,May-19,0,1,1
7035,user_7035,20,6,5,1,Apr-19,1,1,0
7036,user_7036,39915,898,348,550,May-19,0,1,1
7038,user_7038,3711,207,28,179,Apr-19,1,1,0
7039,user_7039,291,6,6,0,Jul-18,10,0,0
7040,user_7040,3555,88,62,26,May-19,0,0,1
7041,user_7041,3672,76,36,40,May-19,0,0,1
7042,user_7042,219,48,29,19,Apr-19,1,1,0
7043,user_7043,23475,604,94,510,May-19,0,1,1
7044,user_7044,3473,58,41,17,Feb-19,3,0,0
7045,user_7045,11578,239,147,92,May-19,0,1,1
7046,user_7046,2529,183,60,123,May-19,0,1,1
7048,user_7048,1082,56,56,0,Dec-18,5,0,0
7049,user_7049,18192,385,304,81,May-19,0,1,1
7050,user_7050,1903,85,85,0,Sep-18,8,0,0
7051,user_7051,1904,32,32,0,Jul-18,10,0,0
7052,user_7052,5235,149,110,39,May-19,0,1,1
7053,user_7053,1062,24,13,11,May-19,0,0,1
7054,user_7054,985,6,4,2,Mar-19,2,0,0
7055,user_7055,2148,20,20,0,Aug-18,9,0,0
7056,user_7056,2960,6,0,6,Mar-19,2,0,0
7057,user_7057,2488,81,59,22,May-19,0,1,1
7058,user_7058,26061,523,57,466,May-19,0,1,1
7059,user_7059,18326,1131,558,573,May-19,0,1,1
7060,user_7060,53551,477,298,179,May-19,0,1,1
7061,user_7061,1071,10,10,0,Oct-18,7,0,0
7062,user_7062,9328,387,292,95,Apr-19,1,1,0
7063,user_7063,7378,184,183,1,Jan-19,4,0,0
7064,user_7064,113,19,13,6,Mar-19,2,0,0
7065,user_7065,11436,253,100,153,May-19,0,1,1
7066,user_7066,20,2,2,0,Jun-18,11,0,0
7067,user_7067,5286,74,4,70,Apr-19,1,1,0
7068,user_7068,10093,569,282,287,May-19,0,1,1
7069,user_7069,368,41,15,26,May-19,0,1,1
7070,user_7070,7562,369,230,139,May-19,0,1,1
7071,user_7071,29510,1255,610,645,May-19,0,1,1
7072,user_7072,106,16,9,7,Apr-19,1,1,0
7073,user_7073,1488,24,24,0,Jul-18,10,0,0
7074,user_7074,4230,7,7,0,Jul-18,10,0,0
7075,user_7075,24811,566,318,248,May-19,0,1,1
7076,user_7076,324,8,4,4,May-19,0,1,1
7077,user_7077,3677,106,92,14,Mar-19,2,0,0
7078,user_7078,1024,25,23,2,Feb-19,3,0,0
7079,user_7079,17966,279,221,58,May-19,0,1,1
7080,user_7080,15227,1217,457,760,May-19,0,1,1
7081,user_7081,5526,164,65,99,May-19,0,1,1
7082,user_7082,765,18,18,0,Jul-18,10,0,0
7083,user_7083,1650,33,33,0,Oct-18,7,0,0
7084,user_7084,13816,393,157,236,May-19,0,1,1
7085,user_7085,2463,59,21,38,May-19,0,1,1
7086,user_7086,141,47,22,25,May-19,0,1,1
7087,user_7087,13148,258,106,152,May-19,0,1,1
7088,user_7088,6767,259,217,42,Apr-19,1,1,0
7089,user_7089,5240,645,383,262,May-19,0,1,1
7090,user_7090,2616,81,37,44,Apr-19,1,1,0
7091,user_7091,11394,56,30,26,May-19,0,0,1
7092,user_7092,40,4,0,4,Mar-19,2,0,0
7093,user_7093,7819,279,209,70,May-19,0,1,1
7094,user_7094,519,43,23,20,Apr-19,1,1,0
7095,user_7095,10956,40,15,25,May-19,0,1,1
7096,user_7096,66829,584,389,195,May-19,0,1,1
7097,user_7097,113,45,38,7,Apr-19,1,1,0
7098,user_7098,40680,57,41,16,May-19,0,0,1
7099,user_7099,8203,326,197,129,May-19,0,1,1
7101,user_7101,11912,266,144,122,May-19,0,1,1
7102,user_7102,1654,56,54,2,Jan-19,4,0,0
7103,user_7103,6085,67,0,67,May-19,0,1,1
7104,user_7104,32411,133,54,79,May-19,0,1,1
7105,user_7105,528,26,20,6,Feb-19,3,0,0
7106,user_7106,6573,32,21,11,Feb-19,3,0,0
7107,user_7107,9,2,0,2,Apr-19,1,1,0
7108,user_7108,15615,1263,727,536,May-19,0,1,1
7109,user_7109,20,5,5,0,Jun-18,11,0,0
7110,user_7110,949,18,5,13,Apr-19,1,1,0
7111,user_7111,12614,244,146,98,May-19,0,1,1
7112,user_7112,7447,110,51,59,Apr-19,1,1,0
7113,user_7113,2503,28,25,3,Mar-19,2,0,0
7114,user_7114,1171,15,7,8,Mar-19,2,0,0
7115,user_7115,2202,80,57,23,May-19,0,1,1
7116,user_7116,1958,30,30,0,Aug-18,9,0,0
7117,user_7117,0,2,2,0,Jun-18,11,0,0
7118,user_7118,2670,29,29,0,Dec-18,5,0,0
7119,user_7119,218,9,9,0,Jun-18,11,0,0
7120,user_7120,4146,29,20,9,Mar-19,2,0,0
7121,user_7121,5834,447,230,217,May-19,0,1,1
7122,user_7122,53173,1264,697,567,May-19,0,1,1
7123,user_7123,43,6,5,1,Feb-19,3,0,0
7124,user_7124,10907,160,71,89,May-19,0,1,1
7125,user_7125,638,33,33,0,Dec-18,5,0,0
7126,user_7126,16565,193,172,21,Apr-19,1,1,0
7127,user_7127,6724,530,271,259,May-19,0,1,1
7128,user_7128,95,11,6,5,May-19,0,1,1
7129,user_7129,276,6,6,0,Nov-18,6,0,0
7130,user_7130,18622,781,153,628,May-19,0,1,1
7131,user_7131,2171,69,40,29,May-19,0,1,1
7132,user_7132,3995,183,120,63,May-19,0,1,1
7133,user_7133,6197,102,95,7,Apr-19,1,1,0
7134,user_7134,274,13,3,10,Feb-19,3,0,0
7135,user_7135,442,7,5,2,Jan-19,4,0,0
7136,user_7136,3795,79,47,32,May-19,0,1,1
7137,user_7137,5418,95,57,38,May-19,0,1,1
7138,user_7138,45034,191,72,119,May-19,0,1,1
7139,user_7139,9,2,2,0,Jun-18,11,0,0
7140,user_7140,46,58,39,19,May-19,0,1,1
7141,user_7141,15261,212,133,79,May-19,0,1,1
7142,user_7142,16,3,3,0,Jul-18,10,0,0
7143,user_7143,2216,74,73,1,Jan-19,4,0,0
7144,user_7144,770,38,27,11,Mar-19,2,0,0
7145,user_7145,3693,19,19,0,Aug-18,9,0,0
7146,user_7146,10646,326,133,193,May-19,0,1,1
7147,user_7147,2629,17,10,7,Apr-19,1,1,0
7148,user_7148,16,3,3,0,Jun-18,11,0,0
7149,user_7149,20,2,2,0,Jun-18,11,0,0
7150,user_7150,4013,54,45,9,Apr-19,1,1,0
7151,user_7151,904,25,25,0,Aug-18,9,0,0
7152,user_7152,5675,99,33,66,May-19,0,1,1
7154,user_7154,692,62,10,52,May-19,0,1,1
7155,user_7155,40,5,5,0,Jul-18,10,0,0
7156,user_7156,8307,123,41,82,May-19,0,1,1
7157,user_7157,10,7,0,7,Apr-19,1,1,0
7158,user_7158,19742,921,412,509,May-19,0,1,1
7159,user_7159,170,4,4,0,Dec-18,5,0,0
7160,user_7160,5281,798,569,229,May-19,0,1,1
7161,user_7161,15170,241,133,108,May-19,0,1,1
7162,user_7162,11,2,2,0,Jun-18,11,0,0
7163,user_7163,4,1,1,0,Jun-18,11,0,0
7164,user_7164,557,12,12,0,Aug-18,9,0,0
7165,user_7165,20,2,0,2,Feb-19,3,0,0
7166,user_7166,630,34,34,0,Sep-18,8,0,0
7167,user_7167,19870,1009,669,340,May-19,0,1,1
7168,user_7168,6662,106,47,59,May-19,0,1,1
7169,user_7169,307,5,3,2,Feb-19,3,0,0
7170,user_7170,8685,92,10,82,May-19,0,1,1
7171,user_7171,8296,131,7,124,Apr-19,1,1,0
7172,user_7172,8137,60,34,26,Mar-19,2,0,0
7173,user_7173,1294,45,40,5,May-19,0,0,1
7174,user_7174,40429,1198,686,512,May-19,0,1,1
7175,user_7175,915,30,20,10,Mar-19,2,0,0
7176,user_7176,18,3,3,0,Jul-18,10,0,0
7177,user_7177,964,11,11,0,Oct-18,7,0,0
7178,user_7178,38996,399,188,211,May-19,0,1,1
7179,user_7179,4339,37,23,14,May-19,0,1,1
7180,user_7180,6915,347,187,160,May-19,0,1,1
7181,user_7181,38272,365,197,168,May-19,0,1,1
7182,user_7182,7365,228,133,95,May-19,0,1,1
7183,user_7183,21642,1026,591,435,May-19,0,1,1
7184,user_7184,3791,71,45,26,May-19,0,0,1
7185,user_7185,11,2,2,0,Jun-18,11,0,0
7186,user_7186,1856,74,54,20,May-19,0,1,1
7187,user_7187,387,42,25,17,Apr-19,1,1,0
7188,user_7188,10440,253,199,54,May-19,0,1,1
7189,user_7189,4244,77,65,12,Apr-19,1,1,0
7190,user_7190,15120,241,167,74,Apr-19,1,1,0
7191,user_7191,2401,44,35,9,Feb-19,3,0,0
7192,user_7192,11383,190,112,78,May-19,0,1,1
7193,user_7193,1217,33,15,18,Apr-19,1,1,0
7194,user_7194,7940,118,54,64,May-19,0,1,1
7195,user_7195,4003,66,46,20,Apr-19,1,1,0
7196,user_7196,8199,68,61,7,May-19,0,1,1
7197,user_7197,3022,31,28,3,Mar-19,2,0,0
7198,user_7198,3658,68,64,4,Mar-19,2,0,0
7199,user_7199,1452,63,43,20,May-19,0,1,1
7200,user_7200,2729,11,11,0,Sep-18,8,0,0
7201,user_7201,8042,174,133,41,Apr-19,1,1,0
7202,user_7202,3540,162,156,6,Mar-19,2,0,0
7203,user_7203,1399,52,52,0,Oct-18,7,0,0
7204,user_7204,12774,264,71,193,May-19,0,1,1
7205,user_7205,3318,181,87,94,May-19,0,1,1
7206,user_7206,6699,253,152,101,May-19,0,1,1
7207,user_7207,7929,74,58,16,Mar-19,2,0,0
7208,user_7208,53627,697,470,227,May-19,0,1,1
7209,user_7209,1054,41,5,36,May-19,0,1,1
7211,user_7211,5919,15,8,7,Apr-19,1,1,0
7212,user_7212,144,2,2,0,Jun-18,11,0,0
7213,user_7213,2032,16,10,6,Jan-19,4,0,0
7214,user_7214,1573,110,43,67,May-19,0,1,1
7215,user_7215,41,7,6,1,Mar-19,2,0,0
7216,user_7216,8324,187,105,82,May-19,0,1,1
7217,user_7217,5325,169,96,73,May-19,0,1,1
7218,user_7218,54363,1141,682,459,May-19,0,1,1
7219,user_7219,39224,1047,543,504,May-19,0,1,1
7220,user_7220,1154,29,2,27,Apr-19,1,1,0
7221,user_7221,8390,133,53,80,May-19,0,1,1
7222,user_7222,1414,20,20,0,Nov-18,6,0,0
7223,user_7223,2101,13,6,7,Apr-19,1,1,0
7226,user_7226,11113,653,376,277,May-19,0,1,1
7227,user_7227,8,3,3,0,Jul-18,10,0,0
7228,user_7228,15894,415,218,197,May-19,0,1,1
7229,user_7229,3467,67,33,34,Mar-19,2,0,0
7230,user_7230,2557,136,74,62,May-19,0,1,1
7231,user_7231,11723,217,141,76,May-19,0,1,1
7232,user_7232,10832,150,106,44,Apr-19,1,1,0
7233,user_7233,34930,762,483,279,May-19,0,1,1
7234,user_7234,1007,81,58,23,Apr-19,1,1,0
7235,user_7235,567,21,21,0,Oct-18,7,0,0
7236,user_7236,8426,266,85,181,May-19,0,1,1
7237,user_7237,35,1,1,0,Jun-18,11,0,0
7238,user_7238,1994,66,66,0,Dec-18,5,0,0
7239,user_7239,7226,144,22,122,May-19,0,1,1
7240,user_7240,21,3,3,0,Jun-18,11,0,0
7241,user_7241,1248,56,34,22,Apr-19,1,1,0
7242,user_7242,1415,7,7,0,Jul-18,10,0,0
7243,user_7243,11731,794,296,498,May-19,0,1,1
7244,user_7244,1500,25,2,23,Apr-19,1,1,0
7245,user_7245,9,2,0,2,May-19,0,0,1
7246,user_7246,10822,220,149,71,May-19,0,1,1
7247,user_7247,3739,114,81,33,May-19,0,1,1
7248,user_7248,6937,214,164,50,May-19,0,1,1
7249,user_7249,2829,23,2,21,Mar-19,2,0,0
7250,user_7250,2548,40,21,19,May-19,0,1,1
7251,user_7251,1,7,7,0,Jun-18,11,0,0
7252,user_7252,4452,145,84,61,May-19,0,1,1
7253,user_7253,1331,26,22,4,Feb-19,3,0,0
7254,user_7254,3566,79,46,33,May-19,0,1,1
7255,user_7255,21913,1143,723,420,May-19,0,1,1
7256,user_7256,13470,222,118,104,May-19,0,1,1
7257,user_7257,2396,96,18,78,May-19,0,1,1
7258,user_7258,2422,51,37,14,Jan-19,4,0,0
7259,user_7259,2699,61,22,39,May-19,0,1,1
7260,user_7260,619,16,7,9,Apr-19,1,1,0
7261,user_7261,16404,175,147,28,May-19,0,1,1
7262,user_7262,10415,507,140,367,May-19,0,1,1
7263,user_7263,3482,113,43,70,Apr-19,1,1,0
7264,user_7264,1366,187,116,71,May-19,0,1,1
7265,user_7265,3304,114,112,2,Apr-19,1,1,0
7266,user_7266,145,7,7,0,Jun-18,11,0,0
7267,user_7267,1890,155,78,77,May-19,0,1,1
7268,user_7268,6212,89,0,89,May-19,0,1,1
7269,user_7269,9788,291,50,241,Apr-19,1,1,0
7270,user_7270,16,3,3,0,Jun-18,11,0,0
7271,user_7271,8681,248,209,39,Apr-19,1,1,0
7272,user_7272,3692,56,56,0,Jul-18,10,0,0
7274,user_7274,609,60,33,27,May-19,0,1,1
7275,user_7275,4705,102,62,40,May-19,0,1,1
7276,user_7276,5204,44,44,0,Oct-18,7,0,0
7277,user_7277,2446,56,56,0,Nov-18,6,0,0
7278,user_7278,8,3,2,1,Mar-19,2,0,0
7279,user_7279,7571,404,45,359,May-19,0,1,1
7281,user_7281,1072,23,23,0,Aug-18,9,0,0
7282,user_7282,767,12,12,0,Aug-18,9,0,0
7283,user_7283,71,1,1,0,Jun-18,11,0,0
7284,user_7284,9814,119,88,31,May-19,0,1,1
7285,user_7285,2155,50,35,15,May-19,0,1,1
7286,user_7286,4254,81,56,25,May-19,0,1,1
7287,user_7287,60,6,6,0,Dec-18,5,0,0
7288,user_7288,60,2,2,0,Jul-18,10,0,0
7289,user_7289,16,3,3,0,Jun-18,11,0,0
7290,user_7290,10570,614,426,188,May-19,0,1,1
7291,user_7291,37973,465,219,246,May-19,0,1,1
7292,user_7292,11155,345,345,0,Dec-18,5,0,0
7293,user_7293,19334,1254,713,541,May-19,0,1,1
7294,user_7294,33,4,4,0,Jun-18,11,0,0
7295,user_7295,6476,42,42,0,Dec-18,5,0,0
7296,user_7296,5108,149,50,99,May-19,0,1,1
7297,user_7297,2310,113,39,74,May-19,0,1,1
7298,user_7298,3152,104,24,80,Apr-19,1,1,0
7299,user_7299,1917,69,42,27,Apr-19,1,1,0
7300,user_7300,34806,147,79,68,May-19,0,1,1
7301,user_7301,6559,263,222,41,May-19,0,1,1
7302,user_7302,991,24,24,0,Dec-18,5,0,0
7303,user_7303,1115,11,3,8,Mar-19,2,0,0
7304,user_7304,1253,80,26,54,Mar-19,2,0,0
7305,user_7305,14,3,0,3,Jan-19,4,0,0
7306,user_7306,333,42,7,35,Apr-19,1,1,0
7307,user_7307,11931,181,55,126,May-19,0,1,1
7308,user_7308,5067,120,89,31,Apr-19,1,1,0
7309,user_7309,240,15,15,0,Nov-18,6,0,0
7310,user_7310,16288,69,69,0,Nov-18,6,0,0
7311,user_7311,6263,103,7,96,May-19,0,1,1
7312,user_7312,606,22,16,6,May-19,0,0,1
7313,user_7313,3798,60,28,32,May-19,0,1,1
7314,user_7314,1447,53,53,0,Sep-18,8,0,0
7315,user_7315,160,60,41,19,May-19,0,1,1
7316,user_7316,333,24,4,20,Apr-19,1,1,0
7317,user_7317,3229,90,90,0,Aug-18,9,0,0
7318,user_7318,550,34,30,4,Apr-19,1,1,0
7319,user_7319,9136,217,74,143,May-19,0,1,1
7320,user_7320,138,12,8,4,Feb-19,3,0,0
7321,user_7321,4686,117,91,26,May-19,0,1,1
7322,user_7322,12128,1046,632,414,May-19,0,1,1
7323,user_7323,5475,72,53,19,May-19,0,0,1
7324,user_7324,2327,309,240,69,May-19,0,1,1
7325,user_7325,20,1,1,0,Jun-18,11,0,0
7326,user_7326,4668,61,53,8,Mar-19,2,0,0
7327,user_7327,5556,30,29,1,May-19,0,0,1
7328,user_7328,1431,43,30,13,Apr-19,1,1,0
7329,user_7329,14,3,3,0,Jun-18,11,0,0
7330,user_7330,3079,120,84,36,May-19,0,1,1
7331,user_7331,2474,59,47,12,Apr-19,1,1,0
7332,user_7332,15,5,0,5,Apr-19,1,1,0
7333,user_7333,72207,662,426,236,May-19,0,1,1
7334,user_7334,7702,880,559,321,May-19,0,1,1
7335,user_7335,16,3,3,0,Jun-18,11,0,0
7336,user_7336,14152,112,112,0,Nov-18,6,0,0
7337,user_7337,359,35,27,8,Mar-19,2,0,0
7338,user_7338,945,45,43,2,Feb-19,3,0,0
7339,user_7339,1140,67,43,24,Apr-19,1,1,0
7340,user_7340,5269,36,36,0,Oct-18,7,0,0
7341,user_7341,70184,1274,504,770,May-19,0,1,1
7342,user_7342,5719,97,96,1,Jan-19,4,0,0
7343,user_7343,14,3,3,0,Jun-18,11,0,0
7344,user_7344,2483,82,33,49,Apr-19,1,1,0
7345,user_7345,2798,87,65,22,Apr-19,1,1,0
7346,user_7346,182,18,15,3,May-19,0,0,1
7347,user_7347,2696,104,49,55,Apr-19,1,1,0
7348,user_7348,27471,37,12,25,May-19,0,1,1
7349,user_7349,7,5,5,0,Jul-18,10,0,0
7350,user_7350,1615,28,28,0,Dec-18,5,0,0
7351,user_7351,1526,83,74,9,May-19,0,1,1
7352,user_7352,5928,62,62,0,Nov-18,6,0,0
7353,user_7353,1875,31,7,24,May-19,0,0,1
7354,user_7354,2770,31,26,5,May-19,0,0,1
7355,user_7355,208,12,12,0,Dec-18,5,0,0
7356,user_7356,9178,59,15,44,Apr-19,1,1,0
7357,user_7357,1167,33,26,7,Jan-19,4,0,0
7358,user_7358,5131,99,61,38,Apr-19,1,1,0
7359,user_7359,3025,416,342,74,May-19,0,1,1
7361,user_7361,15,4,4,0,Jun-18,11,0,0
7362,user_7362,11,2,2,0,Jun-18,11,0,0
7363,user_7363,14,3,3,0,Jun-18,11,0,0
7364,user_7364,510,15,5,10,Apr-19,1,1,0
7365,user_7365,21,3,3,0,Jul-18,10,0,0
7366,user_7366,9567,570,269,301,May-19,0,1,1
7367,user_7367,2739,130,86,44,Apr-19,1,1,0
7368,user_7368,22790,954,663,291,May-19,0,1,1
7369,user_7369,29,4,4,0,Jul-18,10,0,0
7370,user_7370,1024,83,54,29,May-19,0,1,1
7371,user_7371,3120,111,68,43,Apr-19,1,1,0
7372,user_7372,1187,125,45,80,May-19,0,1,1
7373,user_7373,4736,116,84,32,Apr-19,1,1,0
7374,user_7374,3519,59,45,14,Mar-19,2,0,0
7375,user_7375,2098,81,33,48,May-19,0,1,1
7376,user_7376,4672,271,155,116,May-19,0,1,1
7378,user_7378,28019,350,138,212,May-19,0,1,1
7379,user_7379,9,2,2,0,Jun-18,11,0,0
7380,user_7380,25175,23,23,0,Nov-18,6,0,0
7381,user_7381,49,3,3,0,Jun-18,11,0,0
7382,user_7382,4004,108,90,18,Mar-19,2,0,0
7383,user_7383,4586,113,113,0,Dec-18,5,0,0
7384,user_7384,21550,153,81,72,May-19,0,1,1
7385,user_7385,1802,116,73,43,May-19,0,1,1
7386,user_7386,1442,31,29,2,May-19,0,0,1
7387,user_7387,6973,372,66,306,Apr-19,1,1,0
7388,user_7388,69600,131,52,79,May-19,0,1,1
7389,user_7389,1321,42,33,9,Apr-19,1,1,0
7390,user_7390,11,2,2,0,Jun-18,11,0,0
7391,user_7391,9164,401,237,164,May-19,0,1,1
7392,user_7392,11687,127,9,118,May-19,0,1,1
7393,user_7393,11,2,2,0,Jun-18,11,0,0
7394,user_7394,15907,580,238,342,May-19,0,1,1
7395,user_7395,8294,84,27,57,May-19,0,1,1
7396,user_7396,5811,143,104,39,May-19,0,1,1
7397,user_7397,56598,298,209,89,May-19,0,1,1
7398,user_7398,26928,151,111,40,May-19,0,1,1
7399,user_7399,8848,183,92,91,May-19,0,1,1
7400,user_7400,1706,91,91,0,Sep-18,8,0,0
7401,user_7401,13435,131,111,20,Apr-19,1,1,0
7402,user_7402,4046,85,78,7,Mar-19,2,0,0
7403,user_7403,3496,70,36,34,May-19,0,1,1
7404,user_7404,43,10,10,0,Jun-18,11,0,0
7405,user_7405,4143,142,100,42,May-19,0,1,1
7406,user_7406,1797,30,30,0,Jul-18,10,0,0
7407,user_7407,25090,674,308,366,May-19,0,1,1
7408,user_7408,408,75,31,44,May-19,0,1,1
7409,user_7409,28753,247,55,192,May-19,0,1,1
7410,user_7410,5200,33,26,7,Apr-19,1,1,0
7411,user_7411,7690,295,188,107,May-19,0,1,1
7412,user_7412,1109,71,68,3,Jan-19,4,0,0
7413,user_7413,1122,21,21,0,Oct-18,7,0,0
7414,user_7414,12418,1021,477,544,May-19,0,1,1
7415,user_7415,1742,64,48,16,May-19,0,1,1
7416,user_7416,393,18,2,16,May-19,0,1,1
7417,user_7417,11573,45,0,45,May-19,0,1,1
7418,user_7418,7,6,5,1,Mar-19,2,0,0
7419,user_7419,371,19,2,17,Jan-19,4,0,0
7420,user_7420,162427,28,19,9,Apr-19,1,1,0
7421,user_7421,37,6,6,0,Sep-18,8,0,0
7422,user_7422,12384,185,111,74,May-19,0,1,1
7423,user_7423,9140,158,101,57,May-19,0,1,1
7424,user_7424,5121,94,73,21,May-19,0,0,1
7425,user_7425,113,10,9,1,Feb-19,3,0,0
7426,user_7426,3888,44,41,3,Apr-19,1,1,0
7427,user_7427,448,23,23,0,Dec-18,5,0,0
7428,user_7428,6138,251,184,67,May-19,0,1,1
7429,user_7429,1150,13,3,10,May-19,0,1,1
7430,user_7430,44950,46,41,5,May-19,0,1,1
7431,user_7431,26003,685,318,367,May-19,0,1,1
7432,user_7432,3609,55,52,3,May-19,0,1,1
7433,user_7433,7,4,2,2,Jan-19,4,0,0
7434,user_7434,16192,263,139,124,May-19,0,1,1
7435,user_7435,13136,149,87,62,Apr-19,1,1,0
7436,user_7436,12745,224,146,78,May-19,0,1,1
7437,user_7437,310,10,10,0,Oct-18,7,0,0
7438,user_7438,86,4,4,0,Jul-18,10,0,0
7439,user_7439,2521,119,110,9,Apr-19,1,1,0
7440,user_7440,2370,304,203,101,May-19,0,1,1
7441,user_7441,6829,607,491,116,May-19,0,0,1
7442,user_7442,3117,139,137,2,Feb-19,3,0,0
7443,user_7443,6469,155,64,91,May-19,0,1,1
7444,user_7444,15782,22,18,4,Apr-19,1,1,0
7445,user_7445,3474,480,28,452,May-19,0,1,1
7446,user_7446,7867,272,253,19,May-19,0,1,1
7447,user_7447,42213,1006,762,244,May-19,0,1,1
7448,user_7448,3551,89,88,1,Mar-19,2,0,0
7449,user_7449,1,1,1,0,Aug-18,9,0,0
7450,user_7450,1012,59,57,2,Mar-19,2,0,0
7451,user_7451,2436,87,70,17,May-19,0,0,1
7452,user_7452,486535,677,395,282,May-19,0,1,1
7453,user_7453,1036,38,38,0,Aug-18,9,0,0
7454,user_7454,3333,453,270,183,May-19,0,1,1
7455,user_7455,2046,115,6,109,May-19,0,1,1
7456,user_7456,33392,2055,967,1088,May-19,0,1,1
7457,user_7457,13281,98,67,31,May-19,0,1,1
7458,user_7458,2286,43,43,0,Dec-18,5,0,0
7459,user_7459,8461,291,157,134,May-19,0,1,1
7460,user_7460,4590,111,68,43,Apr-19,1,1,0
7462,user_7462,125,11,8,3,May-19,0,1,1
7463,user_7463,1452,139,88,51,May-19,0,1,1
7464,user_7464,6055,563,248,315,May-19,0,1,1
7465,user_7465,890,35,35,0,Aug-18,9,0,0
7466,user_7466,227,13,6,7,Apr-19,1,1,0
7467,user_7467,23127,145,101,44,Apr-19,1,1,0
7468,user_7468,9491,402,219,183,May-19,0,1,1
7469,user_7469,17974,172,167,5,Apr-19,1,1,0
7470,user_7470,209,17,14,3,Feb-19,3,0,0
7471,user_7471,33074,229,46,183,May-19,0,1,1
7472,user_7472,24835,790,491,299,May-19,0,1,1
7473,user_7473,11,2,2,0,Jun-18,11,0,0
7474,user_7474,197,7,2,5,May-19,0,0,1
7475,user_7475,3646,95,76,19,May-19,0,0,1
7476,user_7476,3411,54,51,3,Apr-19,1,1,0
7477,user_7477,110737,613,337,276,May-19,0,1,1
7478,user_7478,4286,19,15,4,Apr-19,1,1,0
7479,user_7479,31408,255,200,55,Apr-19,1,1,0
7480,user_7480,200,17,7,10,Mar-19,2,0,0
7481,user_7481,14,3,3,0,Jun-18,11,0,0
7482,user_7482,13793,755,187,568,May-19,0,1,1
7483,user_7483,950,45,24,21,May-19,0,1,1
7484,user_7484,1002,83,50,33,Apr-19,1,1,0
7486,user_7486,834,37,2,35,May-19,0,1,1
7487,user_7487,14829,565,322,243,May-19,0,1,1
7488,user_7488,949,71,71,0,Dec-18,5,0,0
7489,user_7489,96645,189,93,96,May-19,0,1,1
7490,user_7490,2511,37,19,18,Apr-19,1,1,0
7491,user_7491,314,24,24,0,Dec-18,5,0,0
7492,user_7492,53160,189,166,23,Apr-19,1,1,0
7493,user_7493,24,3,3,0,Jun-18,11,0,0
7494,user_7494,5654,252,193,59,May-19,0,1,1
7495,user_7495,3680,53,19,34,Mar-19,2,0,0
7496,user_7496,12836,135,68,67,Apr-19,1,1,0
7497,user_7497,26431,644,396,248,May-19,0,1,1
7498,user_7498,52,8,4,4,Apr-19,1,1,0
7499,user_7499,37,4,2,2,Apr-19,1,1,0
7500,user_7500,30,3,3,0,Jun-18,11,0,0
7501,user_7501,1525,53,9,44,Apr-19,1,1,0
7502,user_7502,273,5,5,0,Sep-18,8,0,0
7503,user_7503,3447,361,257,104,May-19,0,1,1
7504,user_7504,4597,230,132,98,May-19,0,1,1
7505,user_7505,12238,201,87,114,Apr-19,1,1,0
7506,user_7506,53926,1436,411,1025,May-19,0,1,1
7507,user_7507,11346,222,79,143,Mar-19,2,0,0
7508,user_7508,16834,749,438,311,May-19,0,1,1
7509,user_7509,158147,86,82,4,Feb-19,3,0,0
7510,user_7510,18,3,3,0,Jul-18,10,0,0
7511,user_7511,185,7,7,0,Aug-18,9,0,0
7513,user_7513,1481,115,114,1,Feb-19,3,0,0
7514,user_7514,17150,214,126,88,Apr-19,1,1,0
7515,user_7515,80,6,6,0,Jun-18,11,0,0
7516,user_7516,1167,89,15,74,Apr-19,1,1,0
7517,user_7517,113,47,6,41,May-19,0,0,1
7518,user_7518,905,32,4,28,Apr-19,1,1,0
7519,user_7519,1923,74,69,5,May-19,0,1,1
7520,user_7520,6287,26,24,2,Apr-19,1,1,0
7521,user_7521,2191,15,15,0,Aug-18,9,0,0
7522,user_7522,14340,359,294,65,Mar-19,2,0,0
7523,user_7523,125,4,1,3,Apr-19,1,1,0
7524,user_7524,2260,130,67,63,May-19,0,1,1
7525,user_7525,13768,160,5,155,May-19,0,1,1
7526,user_7526,33,4,4,0,Jun-18,11,0,0
7527,user_7527,14537,206,142,64,Mar-19,2,0,0
7528,user_7528,16357,338,10,328,May-19,0,1,1
7529,user_7529,670,29,25,4,May-19,0,1,1
7530,user_7530,2715,78,34,44,Apr-19,1,1,0
7531,user_7531,2830,44,42,2,Apr-19,1,1,0
7532,user_7532,5726,89,84,5,Mar-19,2,0,0
7533,user_7533,1434,44,42,2,Mar-19,2,0,0
7534,user_7534,7671,210,151,59,May-19,0,1,1
7535,user_7535,1167,128,92,36,May-19,0,1,1
7536,user_7536,7776,174,166,8,Apr-19,1,1,0
7537,user_7537,4548,178,86,92,Mar-19,2,0,0
7538,user_7538,813,10,10,0,Sep-18,8,0,0
7539,user_7539,15028,41,21,20,Apr-19,1,1,0
7540,user_7540,3485,94,24,70,May-19,0,1,1
7542,user_7542,10202,55,13,42,May-19,0,1,1
7543,user_7543,290,12,7,5,Apr-19,1,1,0
7544,user_7544,2621,29,29,0,Oct-18,7,0,0
7545,user_7545,44853,80,47,33,May-19,0,0,1
7546,user_7546,104,10,7,3,May-19,0,1,1
7547,user_7547,7105,124,80,44,Apr-19,1,1,0
7548,user_7548,1833,95,95,0,Jul-18,10,0,0
7549,user_7549,6371,20,18,2,Apr-19,1,1,0
7550,user_7550,428,129,125,4,Apr-19,1,1,0
7551,user_7551,401,3,3,0,Aug-18,9,0,0
7552,user_7552,3818,108,56,52,May-19,0,1,1
7553,user_7553,22672,390,383,7,Apr-19,1,1,0
7554,user_7554,20,2,2,0,Jun-18,11,0,0
7555,user_7555,536,21,21,0,Jun-18,11,0,0
7556,user_7556,2973,184,111,73,Mar-19,2,0,0
7557,user_7557,4662,105,64,41,Apr-19,1,1,0
7558,user_7558,2539,70,11,59,May-19,0,1,1
7559,user_7559,693,38,30,8,May-19,0,1,1
7560,user_7560,2745,56,9,47,May-19,0,1,1
7561,user_7561,35,5,5,0,Aug-18,9,0,0
7562,user_7562,83,7,7,0,Dec-18,5,0,0
7563,user_7563,55046,872,378,494,May-19,0,1,1
7564,user_7564,22330,633,332,301,May-19,0,1,1
7566,user_7566,17,2,1,1,Mar-19,2,0,0
7567,user_7567,24261,439,229,210,May-19,0,1,1
7568,user_7568,821,28,26,2,Jan-19,4,0,0
7569,user_7569,466,43,12,31,May-19,0,1,1
7570,user_7570,31995,310,148,162,May-19,0,1,1
7571,user_7571,1271,45,2,43,May-19,0,1,1
7572,user_7572,1391,34,34,0,Dec-18,5,0,0
7573,user_7573,8050,489,486,3,Jan-19,4,0,0
7574,user_7574,3230,65,36,29,May-19,0,1,1
7575,user_7575,128,11,3,8,Jan-19,4,0,0
7576,user_7576,9054,73,30,43,May-19,0,1,1
7577,user_7577,1603,55,53,2,Feb-19,3,0,0
7578,user_7578,1805,95,63,32,Apr-19,1,1,0
7579,user_7579,1102,55,25,30,May-19,0,1,1
7580,user_7580,2567,33,17,16,May-19,0,1,1
7581,user_7581,3640,52,28,24,Apr-19,1,1,0
7582,user_7582,15261,79,76,3,Apr-19,1,1,0
7583,user_7583,3891,56,51,5,May-19,0,0,1
7584,user_7584,23628,208,110,98,May-19,0,1,1
7585,user_7585,3974,36,36,0,Jul-18,10,0,0
7586,user_7586,3046,255,154,101,May-19,0,1,1
7587,user_7587,4433,181,117,64,May-19,0,1,1
7588,user_7588,344,32,27,5,Apr-19,1,1,0
7589,user_7589,4405,224,86,138,May-19,0,1,1
7590,user_7590,7858,188,165,23,Feb-19,3,0,0
7591,user_7591,81,10,6,4,Apr-19,1,1,0
7592,user_7592,1995,50,16,34,Apr-19,1,1,0
7593,user_7593,2050,131,91,40,May-19,0,1,1
7594,user_7594,5332,219,165,54,May-19,0,1,1
7595,user_7595,1047,40,39,1,Apr-19,1,1,0
7596,user_7596,26492,37,27,10,Apr-19,1,1,0
7597,user_7597,3408,75,54,21,Mar-19,2,0,0
7598,user_7598,12927,171,43,128,May-19,0,1,1
7599,user_7599,4145,146,84,62,Mar-19,2,0,0
7600,user_7600,40765,369,180,189,May-19,0,1,1
7601,user_7601,258,18,14,4,Feb-19,3,0,0
7602,user_7602,164,14,14,0,Jul-18,10,0,0
7603,user_7603,20643,510,264,246,May-19,0,1,1
7604,user_7604,9486,45,35,10,May-19,0,0,1
7605,user_7605,18342,491,282,209,May-19,0,1,1
7606,user_7606,1125,66,32,34,May-19,0,1,1
7607,user_7607,13217,330,142,188,May-19,0,1,1
7608,user_7608,2277,69,18,51,May-19,0,1,1
7609,user_7609,1989,32,28,4,Mar-19,2,0,0
7610,user_7610,169841,773,468,305,May-19,0,1,1
7611,user_7611,683,14,8,6,Apr-19,1,1,0
7612,user_7612,89,12,10,2,Mar-19,2,0,0
7613,user_7613,7162,195,91,104,May-19,0,1,1
7615,user_7615,2521,121,93,28,Apr-19,1,1,0
7616,user_7616,718,11,11,0,Nov-18,6,0,0
7617,user_7617,1179,46,17,29,Apr-19,1,1,0
7618,user_7618,12418,60,48,12,Apr-19,1,1,0
7619,user_7619,1930,50,3,47,May-19,0,1,1
7620,user_7620,3203,325,222,103,May-19,0,1,1
7621,user_7621,9565,42,15,27,May-19,0,1,1
7622,user_7622,24253,533,10,523,May-19,0,1,1
7623,user_7623,4450,44,22,22,May-19,0,1,1
7624,user_7624,30114,535,214,321,May-19,0,1,1
7625,user_7625,1244,30,30,0,Sep-18,8,0,0
7626,user_7626,9,2,2,0,Aug-18,9,0,0
7627,user_7627,3713,29,29,0,Jul-18,10,0,0
7628,user_7628,4371,52,23,29,May-19,0,1,1
7629,user_7629,8769,226,164,62,May-19,0,1,1
7630,user_7630,29614,2585,953,1632,May-19,0,1,1
7631,user_7631,706,11,7,4,Mar-19,2,0,0
7632,user_7632,9,2,2,0,Jun-18,11,0,0
7633,user_7633,411,33,18,15,May-19,0,0,1
7634,user_7634,465,4,4,0,Oct-18,7,0,0
7635,user_7635,1096,19,2,17,May-19,0,0,1
7636,user_7636,2665,37,33,4,Mar-19,2,0,0
7638,user_7638,2469,57,49,8,Apr-19,1,1,0
7639,user_7639,7026,58,43,15,Apr-19,1,1,0
7640,user_7640,278,89,39,50,May-19,0,1,1
7641,user_7641,4906,131,80,51,Apr-19,1,1,0
7642,user_7642,245,6,6,0,Jun-18,11,0,0
7643,user_7643,1238,78,23,55,May-19,0,1,1
7644,user_7644,1726,70,62,8,May-19,0,1,1
7645,user_7645,7048,168,137,31,May-19,0,1,1
7646,user_7646,2721,131,86,45,May-19,0,1,1
7647,user_7647,1521,167,66,101,May-19,0,1,1
7648,user_7648,7741,447,231,216,May-19,0,1,1
7649,user_7649,2234,91,15,76,May-19,0,1,1
7650,user_7650,26487,158,123,35,May-19,0,1,1
7651,user_7651,9,2,2,0,Jun-18,11,0,0
7652,user_7652,1728,35,35,0,Sep-18,8,0,0
7653,user_7653,20,2,2,0,Jun-18,11,0,0
7654,user_7654,16538,190,31,159,May-19,0,1,1
7655,user_7655,3861,103,103,0,Aug-18,9,0,0
7656,user_7656,14804,1067,1040,27,Feb-19,3,0,0
7657,user_7657,12,6,3,3,Apr-19,1,1,0
7658,user_7658,962,10,7,3,Jan-19,4,0,0
7659,user_7659,10109,200,184,16,Apr-19,1,1,0
7661,user_7661,26,8,8,0,Jun-18,11,0,0
7662,user_7662,1463,37,34,3,Jan-19,4,0,0
7663,user_7663,16,21,0,21,Apr-19,1,1,0
7664,user_7664,3333,87,64,23,Apr-19,1,1,0
7665,user_7665,13777,513,317,196,Mar-19,2,0,0
7666,user_7666,2274,308,176,132,May-19,0,1,1
7667,user_7667,8544,44,18,26,May-19,0,0,1
7668,user_7668,2584,95,65,30,Mar-19,2,0,0
7669,user_7669,41092,839,494,345,May-19,0,1,1
7670,user_7670,38,6,6,0,Sep-18,8,0,0
7671,user_7671,1682,112,51,61,May-19,0,1,1
7672,user_7672,1342,20,20,0,Oct-18,7,0,0
7673,user_7673,419,30,0,30,May-19,0,1,1
7674,user_7674,21520,411,174,237,May-19,0,1,1
7675,user_7675,2536,90,30,60,May-19,0,1,1
7676,user_7676,63911,487,255,232,May-19,0,1,1
7677,user_7677,9128,277,166,111,May-19,0,1,1
7678,user_7678,367,18,18,0,Sep-18,8,0,0
7679,user_7679,1542,50,44,6,Mar-19,2,0,0
7680,user_7680,553,51,45,6,Apr-19,1,1,0
7681,user_7681,18259,296,36,260,May-19,0,1,1
7682,user_7682,3399,78,45,33,Feb-19,3,0,0
7683,user_7683,851531,35,18,17,Apr-19,1,1,0
7684,user_7684,20102,694,382,312,May-19,0,1,1
7685,user_7685,2762,89,65,24,Mar-19,2,0,0
7686,user_7686,7640,136,79,57,May-19,0,1,1
7687,user_7687,11400,359,298,61,May-19,0,1,1
7688,user_7688,3183,54,27,27,Mar-19,2,0,0
7689,user_7689,4136,385,269,116,May-19,0,1,1
7690,user_7690,15,2,2,0,Jun-18,11,0,0
7692,user_7692,15,2,2,0,Jun-18,11,0,0
7693,user_7693,7270,180,121,59,Apr-19,1,1,0
7695,user_7695,170,2,2,0,Jun-18,11,0,0
7696,user_7696,2021,113,103,10,May-19,0,1,1
7697,user_7697,30432,84,79,5,Apr-19,1,1,0
7698,user_7698,351,3,3,0,Nov-18,6,0,0
7699,user_7699,306,11,11,0,Aug-18,9,0,0
7700,user_7700,528,41,2,39,May-19,0,1,1
7701,user_7701,11037,168,96,72,May-19,0,1,1
7702,user_7702,48824,162,104,58,Apr-19,1,1,0
7703,user_7703,378,8,6,2,Mar-19,2,0,0
7704,user_7704,9,2,2,0,Oct-18,7,0,0
7705,user_7705,1808,127,106,21,May-19,0,1,1
7706,user_7706,2448,57,57,0,Nov-18,6,0,0
7707,user_7707,411,7,5,2,Apr-19,1,1,0
7709,user_7709,2763,36,10,26,Apr-19,1,1,0
7710,user_7710,16718,79,51,28,May-19,0,0,1
7711,user_7711,23,4,4,0,Jun-18,11,0,0
7712,user_7712,433,17,17,0,Jun-18,11,0,0
7713,user_7713,27218,461,254,207,May-19,0,1,1
7714,user_7714,27176,2108,889,1219,May-19,0,1,1
7715,user_7715,102,16,15,1,Feb-19,3,0,0
7716,user_7716,4186,408,198,210,May-19,0,1,1
7717,user_7717,16343,170,139,31,May-19,0,0,1
7718,user_7718,270,42,23,19,May-19,0,1,1
7719,user_7719,27348,36,35,1,Apr-19,1,1,0
7720,user_7720,289,9,9,0,Aug-18,9,0,0
7721,user_7721,12675,99,57,42,Feb-19,3,0,0
7722,user_7722,205,6,6,0,Jun-18,11,0,0
7724,user_7724,3,3,3,0,Jun-18,11,0,0
7725,user_7725,753,34,19,15,Apr-19,1,1,0
7726,user_7726,4747,299,55,244,May-19,0,1,1
7727,user_7727,4448,86,37,49,Feb-19,3,0,0
7728,user_7728,214,2,2,0,Jun-18,11,0,0
7729,user_7729,21661,284,78,206,May-19,0,1,1
7730,user_7730,458,16,16,0,Dec-18,5,0,0
7731,user_7731,5351,228,75,153,May-19,0,1,1
7732,user_7732,4676,29,25,4,Mar-19,2,0,0
7733,user_7733,12305,315,225,90,May-19,0,1,1
7734,user_7734,488,17,5,12,May-19,0,0,1
7735,user_7735,3088,305,138,167,May-19,0,1,1
7736,user_7736,1733,81,57,24,May-19,0,0,1
7737,user_7737,5078,94,69,25,Jan-19,4,0,0
7738,user_7738,2865,60,39,21,Apr-19,1,1,0
7739,user_7739,610,10,10,0,Jul-18,10,0,0
7740,user_7740,4151,101,77,24,May-19,0,1,1
7741,user_7741,16,3,3,0,Jun-18,11,0,0
7742,user_7742,9,2,2,0,Jun-18,11,0,0
7743,user_7743,39704,796,339,457,May-19,0,1,1
7744,user_7744,690,23,15,8,May-19,0,1,1
7745,user_7745,5657,278,130,148,May-19,0,1,1
7746,user_7746,14877,211,147,64,May-19,0,1,1
7747,user_7747,2617,72,69,3,Jan-19,4,0,0
7748,user_7748,42691,49,34,15,Apr-19,1,1,0
7749,user_7749,2327,77,60,17,Apr-19,1,1,0
7750,user_7750,7,5,5,0,Jul-18,10,0,0
7751,user_7751,865,23,0,23,May-19,0,1,1
7752,user_7752,535,51,51,0,Nov-18,6,0,0
7753,user_7753,1859,39,20,19,May-19,0,1,1
7754,user_7754,6104,223,96,127,May-19,0,1,1
7756,user_7756,16869,449,122,327,May-19,0,1,1
7757,user_7757,157,18,11,7,Apr-19,1,1,0
7758,user_7758,1853,65,65,0,Nov-18,6,0,0
7759,user_7759,3526,20,20,0,Jul-18,10,0,0
7760,user_7760,2303,57,22,35,Apr-19,1,1,0
7761,user_7761,5,1,1,0,Jun-18,11,0,0
7762,user_7762,10079,118,74,44,May-19,0,1,1
7763,user_7763,3024,91,80,11,May-19,0,1,1
7764,user_7764,3040,41,39,2,Feb-19,3,0,0
7765,user_7765,2423,196,107,89,May-19,0,1,1
7766,user_7766,1811,27,10,17,May-19,0,1,1
7767,user_7767,39186,569,315,254,May-19,0,1,1
7768,user_7768,80,15,15,0,Nov-18,6,0,0
7769,user_7769,12449,195,132,63,May-19,0,1,1
7770,user_7770,1,1,1,0,Dec-18,5,0,0
7771,user_7771,10,7,5,2,Feb-19,3,0,0
7772,user_7772,9,2,2,0,Jun-18,11,0,0
7773,user_7773,11,6,6,0,Jun-18,11,0,0
7774,user_7774,2209,119,105,14,Mar-19,2,0,0
7775,user_7775,260,7,3,4,May-19,0,1,1
7776,user_7776,11888,235,212,23,Apr-19,1,1,0
7777,user_7777,222,5,5,0,Aug-18,9,0,0
7778,user_7778,20906,476,405,71,May-19,0,1,1
7779,user_7779,1856,56,53,3,Apr-19,1,1,0
7780,user_7780,761,13,13,0,Dec-18,5,0,0
7781,user_7781,21,3,3,0,Jun-18,11,0,0
7782,user_7782,1394,35,15,20,May-19,0,1,1
7783,user_7783,57,38,27,11,Apr-19,1,1,0
7784,user_7784,2146,71,41,30,May-19,0,0,1
7785,user_7785,16,3,3,0,Jun-18,11,0,0
7786,user_7786,1809,91,57,34,May-19,0,1,1
7787,user_7787,1431,49,33,16,Apr-19,1,1,0
7788,user_7788,9932,501,257,244,May-19,0,1,1
7789,user_7789,64529,991,544,447,May-19,0,1,1
7790,user_7790,1782,57,4,53,May-19,0,1,1
7791,user_7791,4160,55,41,14,Feb-19,3,0,0
7792,user_7792,12659,182,107,75,May-19,0,1,1
7793,user_7793,48460,1329,878,451,May-19,0,1,1
7794,user_7794,349,17,15,2,Jan-19,4,0,0
7795,user_7795,3523,91,62,29,May-19,0,1,1
7796,user_7796,8315,352,153,199,May-19,0,1,1
7797,user_7797,2641,44,21,23,May-19,0,1,1
7798,user_7798,12,3,3,0,Jun-18,11,0,0
7799,user_7799,25716,1746,864,882,May-19,0,1,1
7800,user_7800,266,30,29,1,Apr-19,1,1,0
7801,user_7801,7730,131,98,33,May-19,0,1,1
7802,user_7802,22417,475,260,215,May-19,0,1,1
7803,user_7803,69,4,4,0,Nov-18,6,0,0
7804,user_7804,16,3,3,0,Jun-18,11,0,0
7805,user_7805,4542,89,84,5,Apr-19,1,1,0
7806,user_7806,459,34,5,29,May-19,0,1,1
7807,user_7807,2253,69,69,0,Aug-18,9,0,0
7808,user_7808,1057,51,0,51,Apr-19,1,1,0
7809,user_7809,400,22,17,5,Mar-19,2,0,0
7810,user_7810,3994,106,65,41,May-19,0,1,1
7812,user_7812,11832,111,77,34,Apr-19,1,1,0
7813,user_7813,20372,273,168,105,May-19,0,1,1
7814,user_7814,397,13,9,4,Apr-19,1,1,0
7815,user_7815,17917,33,32,1,Feb-19,3,0,0
7816,user_7816,24406,381,338,43,Feb-19,3,0,0
7817,user_7817,6443,202,190,12,May-19,0,1,1
7818,user_7818,585,10,1,9,Apr-19,1,1,0
7819,user_7819,9793,433,229,204,May-19,0,1,1
7820,user_7820,110,2,2,0,Jul-18,10,0,0
7821,user_7821,716,24,21,3,Feb-19,3,0,0
7822,user_7822,9806,322,144,178,May-19,0,1,1
7823,user_7823,304,23,7,16,Feb-19,3,0,0
7824,user_7824,4582,112,99,13,Apr-19,1,1,0
7825,user_7825,46,8,7,1,Feb-19,3,0,0
7826,user_7826,7342,195,112,83,May-19,0,1,1
7827,user_7827,1737,16,16,0,Jul-18,10,0,0
7828,user_7828,4377,97,49,48,May-19,0,1,1
7829,user_7829,5162,84,29,55,May-19,0,1,1
7830,user_7830,2474,72,41,31,May-19,0,1,1
7831,user_7831,8594,500,357,143,Apr-19,1,1,0
7832,user_7832,32150,439,324,115,May-19,0,1,1
7833,user_7833,22932,760,459,301,May-19,0,1,1
7835,user_7835,863,87,37,50,Apr-19,1,1,0
7836,user_7836,23786,302,229,73,Apr-19,1,1,0
7837,user_7837,15960,521,247,274,May-19,0,1,1
7838,user_7838,5439,116,58,58,Apr-19,1,1,0
7839,user_7839,3662,110,79,31,Apr-19,1,1,0
7840,user_7840,2595,87,86,1,Mar-19,2,0,0
7841,user_7841,7370,362,214,148,May-19,0,1,1
7842,user_7842,15167,243,80,163,May-19,0,1,1
7843,user_7843,137,29,28,1,Feb-19,3,0,0
7844,user_7844,8590,217,124,93,May-19,0,1,1
7845,user_7845,44033,835,186,649,May-19,0,1,1
7846,user_7846,11831,203,61,142,Apr-19,1,1,0
7847,user_7847,17964,147,104,43,Apr-19,1,1,0
7848,user_7848,183705,651,321,330,May-19,0,1,1
7849,user_7849,12354,155,0,155,May-19,0,1,1
7850,user_7850,19473,200,130,70,May-19,0,1,1
7851,user_7851,171,43,9,34,May-19,0,1,1
7852,user_7852,154911,246,152,94,May-19,0,1,1
7853,user_7853,761,95,54,41,May-19,0,1,1
7854,user_7854,1836,88,51,37,May-19,0,1,1
7855,user_7855,91937,381,234,147,May-19,0,1,1
7857,user_7857,3145,140,3,137,May-19,0,1,1
7858,user_7858,385,35,16,19,May-19,0,1,1
7859,user_7859,1010,28,21,7,Apr-19,1,1,0
7860,user_7860,164,8,8,0,Aug-18,9,0,0
7861,user_7861,2964,30,18,12,Apr-19,1,1,0
7862,user_7862,1558,84,36,48,May-19,0,1,1
7863,user_7863,60,7,7,0,Oct-18,7,0,0
7864,user_7864,1489,5,5,0,Aug-18,9,0,0
7865,user_7865,1736,60,44,16,Apr-19,1,1,0
7866,user_7866,1661,20,6,14,May-19,0,0,1
7867,user_7867,1626,34,32,2,Jan-19,4,0,0
7868,user_7868,666,18,5,13,Apr-19,1,1,0
7869,user_7869,62500,62,23,39,May-19,0,1,1
7870,user_7870,33420,118,75,43,Apr-19,1,1,0
7871,user_7871,24637,140,125,15,May-19,0,1,1
7872,user_7872,13439,158,158,0,Oct-18,7,0,0
7873,user_7873,621,25,17,8,Mar-19,2,0,0
7874,user_7874,36248,1281,406,875,May-19,0,1,1
7875,user_7875,9486,348,85,263,May-19,0,1,1
7876,user_7876,766,76,0,76,May-19,0,1,1
7877,user_7877,3292,24,24,0,Dec-18,5,0,0
7878,user_7878,4282,153,117,36,May-19,0,1,1
7879,user_7879,10918,163,163,0,Dec-18,5,0,0
7880,user_7880,4062,357,114,243,May-19,0,1,1
7881,user_7881,19449,270,110,160,May-19,0,1,1
7882,user_7882,6014,255,234,21,Apr-19,1,1,0
7883,user_7883,365,16,16,0,Nov-18,6,0,0
7884,user_7884,11672,319,152,167,Apr-19,1,1,0
7885,user_7885,1231,69,68,1,Jan-19,4,0,0
7886,user_7886,1298,32,28,4,Feb-19,3,0,0
7887,user_7887,20217,59,41,18,Jan-19,4,0,0
7888,user_7888,953,32,6,26,Mar-19,2,0,0
7889,user_7889,375,22,22,0,Nov-18,6,0,0
7890,user_7890,71277,1054,633,421,May-19,0,1,1
7891,user_7891,247,6,6,0,Jul-18,10,0,0
7892,user_7892,4048,77,14,63,May-19,0,1,1
7893,user_7893,8110,97,61,36,May-19,0,1,1
7894,user_7894,5117,96,9,87,May-19,0,1,1
7895,user_7895,4594,134,85,49,May-19,0,1,1
7896,user_7896,14290,72,52,20,Apr-19,1,1,0
7897,user_7897,5158,84,20,64,May-19,0,1,1
7898,user_7898,21085,456,400,56,Jan-19,4,0,0
7899,user_7899,72,5,5,0,Jun-18,11,0,0
7900,user_7900,14622,313,158,155,May-19,0,1,1
7901,user_7901,328,29,23,6,May-19,0,1,1
7902,user_7902,1488,52,31,21,Apr-19,1,1,0
7903,user_7903,9084,337,153,184,May-19,0,1,1
7904,user_7904,8871,81,78,3,Jan-19,4,0,0
7905,user_7905,9,2,2,0,Aug-18,9,0,0
7906,user_7906,395,55,34,21,Apr-19,1,1,0
7907,user_7907,41,5,5,0,Aug-18,9,0,0
7908,user_7908,1141,17,14,3,Apr-19,1,1,0
7909,user_7909,2813,98,1,97,May-19,0,1,1
7910,user_7910,3331,171,27,144,May-19,0,1,1
7911,user_7911,4332,41,17,24,May-19,0,1,1
7912,user_7912,20036,734,387,347,May-19,0,1,1
7913,user_7913,573,11,11,0,Sep-18,8,0,0
7914,user_7914,3797,34,34,0,Sep-18,8,0,0
7915,user_7915,12753,453,210,243,May-19,0,1,1
7916,user_7916,538,19,1,18,May-19,0,1,1
7917,user_7917,3672,78,0,78,May-19,0,1,1
7918,user_7918,6938,57,21,36,May-19,0,1,1
7919,user_7919,4097,52,42,10,May-19,0,1,1
7920,user_7920,1385,55,20,35,May-19,0,1,1
7921,user_7921,564,23,7,16,May-19,0,1,1
7922,user_7922,2936,90,43,47,May-19,0,1,1
7923,user_7923,19838,321,217,104,May-19,0,1,1
7925,user_7925,3442,58,42,16,Mar-19,2,0,0
7926,user_7926,3581,104,80,24,May-19,0,1,1
7927,user_7927,4136,178,142,36,Apr-19,1,1,0
7928,user_7928,2753,139,120,19,Apr-19,1,1,0
7929,user_7929,89,1,1,0,Jul-18,10,0,0
7930,user_7930,8300,138,87,51,May-19,0,1,1
7931,user_7931,1725,20,14,6,Feb-19,3,0,0
7932,user_7932,1231,12,12,0,Jul-18,10,0,0
7933,user_7933,6,7,7,0,Jul-18,10,0,0
7934,user_7934,7143,123,76,47,Apr-19,1,1,0
7935,user_7935,674,20,15,5,Apr-19,1,1,0
7936,user_7936,5928,112,13,99,May-19,0,0,1
7937,user_7937,21,3,3,0,Jun-18,11,0,0
7938,user_7938,1891,244,61,183,May-19,0,1,1
7939,user_7939,147,23,21,2,May-19,0,0,1
7940,user_7940,16,3,3,0,Jun-18,11,0,0
7941,user_7941,5171,148,89,59,May-19,0,1,1
7942,user_7942,6096,199,109,90,May-19,0,1,1
7943,user_7943,2389,58,27,31,May-19,0,1,1
7944,user_7944,513,11,10,1,Feb-19,3,0,0
7945,user_7945,159,11,11,0,Dec-18,5,0,0
7946,user_7946,39,4,4,0,Oct-18,7,0,0
7947,user_7947,1857,16,3,13,Mar-19,2,0,0
7948,user_7948,18239,263,164,99,May-19,0,1,1
7949,user_7949,3885,82,70,12,May-19,0,1,1
7950,user_7950,22414,180,112,68,May-19,0,1,1
7951,user_7951,1439,95,93,2,Mar-19,2,0,0
7952,user_7952,5512,584,335,249,May-19,0,1,1
7953,user_7953,2029,62,62,0,Dec-18,5,0,0
7955,user_7955,14,3,3,0,Jul-18,10,0,0
7956,user_7956,22472,260,168,92,May-19,0,1,1
7957,user_7957,17731,847,426,421,May-19,0,1,1
7958,user_7958,1839,79,69,10,May-19,0,1,1
7959,user_7959,146,4,4,0,Oct-18,7,0,0
7960,user_7960,38065,289,183,106,May-19,0,1,1
7961,user_7961,90907,65,58,7,May-19,0,0,1
7962,user_7962,1499,72,48,24,Mar-19,2,0,0
7963,user_7963,5900,110,94,16,May-19,0,0,1
7964,user_7964,628,58,45,13,May-19,0,0,1
7965,user_7965,1994,118,116,2,Apr-19,1,1,0
7966,user_7966,21769,264,174,90,May-19,0,1,1
7967,user_7967,104,5,4,1,May-19,0,0,1
7968,user_7968,680,29,25,4,May-19,0,1,1
7969,user_7969,6392,57,49,8,Feb-19,3,0,0
7970,user_7970,13069,248,211,37,May-19,0,1,1
7971,user_7971,111,3,2,1,Mar-19,2,0,0
7972,user_7972,1625,32,5,27,May-19,0,1,1
7973,user_7973,7336,41,34,7,May-19,0,1,1
7974,user_7974,5777,84,52,32,Jan-19,4,0,0
7975,user_7975,3483,196,99,97,May-19,0,1,1
7976,user_7976,4,1,1,0,Dec-18,5,0,0
7977,user_7977,12013,259,237,22,May-19,0,0,1
7978,user_7978,18409,516,372,144,May-19,0,1,1
7979,user_7979,15119,302,260,42,Mar-19,2,0,0
7980,user_7980,839,65,39,26,Apr-19,1,1,0
7981,user_7981,627,12,12,0,Aug-18,9,0,0
7982,user_7982,454,38,21,17,May-19,0,1,1
7983,user_7983,1721,83,34,49,Apr-19,1,1,0
7984,user_7984,16148,597,426,171,May-19,0,1,1
7985,user_7985,5172,108,97,11,Mar-19,2,0,0
7987,user_7987,68,8,8,0,Dec-18,5,0,0
7988,user_7988,8744,80,80,0,Sep-18,8,0,0
7989,user_7989,8,2,2,0,Jun-18,11,0,0
7990,user_7990,4503,8,7,1,Jan-19,4,0,0
7991,user_7991,12850,278,131,147,May-19,0,1,1
7992,user_7992,1453,50,45,5,May-19,0,1,1
7993,user_7993,485,24,19,5,Apr-19,1,1,0
7994,user_7994,5312,54,49,5,Apr-19,1,1,0
7996,user_7996,2741,171,123,48,May-19,0,1,1
7997,user_7997,3563,69,65,4,Jan-19,4,0,0
7998,user_7998,5505,106,16,90,May-19,0,1,1
7999,user_7999,3624,134,90,44,May-19,0,1,1
8000,user_8000,4414,70,53,17,Apr-19,1,1,0
8001,user_8001,70819,511,310,201,May-19,0,1,1
8002,user_8002,24451,188,49,139,May-19,0,1,1
8003,user_8003,410,52,26,26,May-19,0,1,1
8004,user_8004,1176,71,55,16,May-19,0,1,1
8005,user_8005,3878,120,39,81,May-19,0,1,1
8006,user_8006,3883,62,40,22,Apr-19,1,1,0
8008,user_8008,12208,145,140,5,Mar-19,2,0,0
8009,user_8009,102,24,22,2,Feb-19,3,0,0
8010,user_8010,3198,248,190,58,May-19,0,1,1
8011,user_8011,7308,70,26,44,May-19,0,1,1
8012,user_8012,40,1,1,0,Jun-18,11,0,0
8013,user_8013,9173,142,111,31,May-19,0,1,1
8015,user_8015,1240,26,26,0,Sep-18,8,0,0
8016,user_8016,6051,141,105,36,May-19,0,1,1
8017,user_8017,4240,94,77,17,Apr-19,1,1,0
8018,user_8018,19301,235,229,6,May-19,0,0,1
8019,user_8019,27804,117,109,8,May-19,0,1,1
8020,user_8020,1,1,1,0,Jun-18,11,0,0
8021,user_8021,228,10,10,0,Nov-18,6,0,0
8022,user_8022,3344,60,60,0,Dec-18,5,0,0
8023,user_8023,686,47,47,0,Dec-18,5,0,0
8024,user_8024,49451,1054,545,509,May-19,0,1,1
8026,user_8026,11,4,4,0,Jul-18,10,0,0
8027,user_8027,2552,39,39,0,Dec-18,5,0,0
8028,user_8028,115,12,12,0,Sep-18,8,0,0
8029,user_8029,16442,330,150,180,May-19,0,1,1
8030,user_8030,25472,227,99,128,May-19,0,1,1
8031,user_8031,16,3,3,0,Jun-18,11,0,0
8032,user_8032,5527,102,65,37,May-19,0,1,1
8033,user_8033,501,4,4,0,Jul-18,10,0,0
8034,user_8034,15,4,3,1,Mar-19,2,0,0
8035,user_8035,25151,48,39,9,May-19,0,1,1
8036,user_8036,457,50,15,35,Apr-19,1,1,0
8037,user_8037,3814,80,78,2,Feb-19,3,0,0
8038,user_8038,542,38,25,13,May-19,0,1,1
8039,user_8039,247,6,2,4,May-19,0,0,1
8040,user_8040,3619,167,125,42,May-19,0,1,1
8041,user_8041,1430,54,14,40,May-19,0,1,1
8042,user_8042,4193,395,207,188,May-19,0,1,1
8043,user_8043,23973,295,196,99,Apr-19,1,1,0
8044,user_8044,201,8,6,2,Jan-19,4,0,0
8045,user_8045,310593,663,459,204,May-19,0,1,1
8046,user_8046,27843,231,168,63,May-19,0,1,1
8047,user_8047,1,1,1,0,Jul-18,10,0,0
8048,user_8048,15255,153,119,34,Apr-19,1,1,0
8049,user_8049,20514,269,106,163,May-19,0,1,1
8050,user_8050,14,3,3,0,Jun-18,11,0,0
8051,user_8051,8588,171,120,51,Mar-19,2,0,0
8052,user_8052,580,55,9,46,Apr-19,1,1,0
8053,user_8053,11083,175,146,29,May-19,0,1,1
8054,user_8054,4254,59,12,47,May-19,0,1,1
8055,user_8055,499,30,26,4,Apr-19,1,1,0
8056,user_8056,157,17,10,7,May-19,0,1,1
8057,user_8057,3,3,3,0,Jun-18,11,0,0
8058,user_8058,2711,57,57,0,Dec-18,5,0,0
8059,user_8059,7748,62,46,16,May-19,0,1,1
8060,user_8060,70,8,2,6,May-19,0,1,1
8062,user_8062,12780,712,450,262,May-19,0,1,1
8063,user_8063,24693,955,552,403,May-19,0,1,1
8064,user_8064,2060,36,30,6,Jan-19,4,0,0
8065,user_8065,3005,69,35,34,Apr-19,1,1,0
8066,user_8066,16155,214,157,57,May-19,0,1,1
8067,user_8067,1024,7,5,2,Jan-19,4,0,0
8068,user_8068,3301,376,236,140,May-19,0,1,1
8070,user_8070,1371,47,30,17,Mar-19,2,0,0
8071,user_8071,1932,180,57,123,May-19,0,1,1
8072,user_8072,5456,95,74,21,Apr-19,1,1,0
8073,user_8073,177,5,4,1,Apr-19,1,1,0
8075,user_8075,2865,100,95,5,May-19,0,0,1
8076,user_8076,145830,1116,442,674,May-19,0,1,1
8077,user_8077,5731,260,163,97,May-19,0,1,1
8078,user_8078,17,1,1,0,Jun-18,11,0,0
8079,user_8079,1127,42,19,23,May-19,0,1,1
8080,user_8080,456,161,31,130,May-19,0,1,1
8081,user_8081,2368,203,96,107,May-19,0,1,1
8082,user_8082,4255,196,83,113,May-19,0,1,1
8083,user_8083,21,4,4,0,Oct-18,7,0,0
8084,user_8084,1118,20,5,15,Mar-19,2,0,0
8085,user_8085,1295,72,56,16,May-19,0,1,1
8086,user_8086,3490,264,146,118,Apr-19,1,1,0
8087,user_8087,30,7,7,0,Jul-18,10,0,0
8088,user_8088,9143,95,42,53,May-19,0,1,1
8089,user_8089,1414,103,52,51,May-19,0,0,1
8090,user_8090,60058,712,301,411,May-19,0,1,1
8091,user_8091,266,44,26,18,Mar-19,2,0,0
8092,user_8092,23098,157,120,37,May-19,0,1,1
8093,user_8093,117368,737,177,560,May-19,0,1,1
8094,user_8094,5721,87,48,39,May-19,0,1,1
8095,user_8095,2790,57,57,0,Sep-18,8,0,0
8096,user_8096,2749,139,134,5,Feb-19,3,0,0
8097,user_8097,10162,433,353,80,Apr-19,1,1,0
8098,user_8098,15756,279,102,177,May-19,0,1,1
8099,user_8099,101017,1282,720,562,May-19,0,1,1
8101,user_8101,11869,31,19,12,Apr-19,1,1,0
8102,user_8102,968,11,11,0,Aug-18,9,0,0
8103,user_8103,11800,278,152,126,May-19,0,1,1
8104,user_8104,3110,42,29,13,Mar-19,2,0,0
8105,user_8105,98303,584,289,295,May-19,0,1,1
8106,user_8106,4051,139,81,58,Apr-19,1,1,0
8107,user_8107,2853,103,100,3,May-19,0,0,1
8108,user_8108,4187,99,63,36,May-19,0,1,1
8109,user_8109,10204,457,142,315,May-19,0,1,1
8110,user_8110,6708,271,256,15,May-19,0,1,1
8111,user_8111,12,3,3,0,Jun-18,11,0,0
8112,user_8112,7150,157,96,61,May-19,0,1,1
8113,user_8113,20,8,8,0,Nov-18,6,0,0
8114,user_8114,12,7,6,1,Apr-19,1,1,0
8115,user_8115,47831,804,532,272,May-19,0,1,1
8116,user_8116,1978,57,57,0,Oct-18,7,0,0
8117,user_8117,21667,380,221,159,May-19,0,1,1
8118,user_8118,2277,36,32,4,May-19,0,0,1
8119,user_8119,7053,110,109,1,Feb-19,3,0,0
8120,user_8120,154,5,5,0,Aug-18,9,0,0
8121,user_8121,2513,181,112,69,May-19,0,1,1
8122,user_8122,507,19,17,2,Feb-19,3,0,0
8123,user_8123,119282,618,423,195,May-19,0,1,1
8124,user_8124,141,4,4,0,Jun-18,11,0,0
8126,user_8126,15099,173,165,8,Feb-19,3,0,0
8127,user_8127,5029,79,72,7,Jan-19,4,0,0
8128,user_8128,4976,213,112,101,May-19,0,1,1
8129,user_8129,5666,59,35,24,Apr-19,1,1,0
8130,user_8130,3249,116,55,61,May-19,0,1,1
8131,user_8131,3215,13,13,0,Jun-18,11,0,0
8132,user_8132,47,6,6,0,Jun-18,11,0,0
8133,user_8133,2173,64,10,54,May-19,0,0,1
8134,user_8134,3104,43,23,20,Apr-19,1,1,0
8135,user_8135,9331,45,6,39,Apr-19,1,1,0
8136,user_8136,590,14,9,5,May-19,0,1,1
8137,user_8137,12892,277,150,127,May-19,0,1,1
8138,user_8138,274,64,37,27,May-19,0,1,1
8139,user_8139,2021,64,56,8,Apr-19,1,1,0
8140,user_8140,1974,22,21,1,Apr-19,1,1,0
8141,user_8141,47817,389,191,198,May-19,0,1,1
8142,user_8142,4183,63,63,0,Aug-18,9,0,0
8143,user_8143,4751,117,93,24,Mar-19,2,0,0
8144,user_8144,3449,133,57,76,May-19,0,1,1
8145,user_8145,144,12,10,2,Feb-19,3,0,0
8146,user_8146,14610,342,72,270,May-19,0,1,1
8147,user_8147,903,12,12,0,Jul-18,10,0,0
8148,user_8148,14628,31,31,0,Nov-18,6,0,0
8149,user_8149,8,2,2,0,Sep-18,8,0,0
8150,user_8150,51,3,1,2,Mar-19,2,0,0
8151,user_8151,39226,864,734,130,May-19,0,1,1
8152,user_8152,1476,128,61,67,Apr-19,1,1,0
8153,user_8153,588,19,16,3,Mar-19,2,0,0
8154,user_8154,17883,209,82,127,May-19,0,1,1
8155,user_8155,0,1,1,0,Jun-18,11,0,0
8156,user_8156,27,9,7,2,Jan-19,4,0,0
8157,user_8157,20823,129,66,63,May-19,0,1,1
8158,user_8158,13742,106,106,0,Nov-18,6,0,0
8159,user_8159,1283,20,20,0,Nov-18,6,0,0
8160,user_8160,1039,37,31,6,May-19,0,0,1
8161,user_8161,703,44,44,0,Oct-18,7,0,0
8162,user_8162,4133,84,62,22,Apr-19,1,1,0
8163,user_8163,6727,26,16,10,May-19,0,1,1
8164,user_8164,6699,177,31,146,May-19,0,1,1
8165,user_8165,452,21,16,5,Feb-19,3,0,0
8166,user_8166,3269,127,38,89,May-19,0,1,1
8167,user_8167,655,13,13,0,Nov-18,6,0,0
8168,user_8168,9698,308,259,49,May-19,0,1,1
8169,user_8169,4217,143,142,1,Jan-19,4,0,0
8170,user_8170,5107,16,14,2,Jan-19,4,0,0
8171,user_8171,12671,253,245,8,Mar-19,2,0,0
8173,user_8173,45,4,4,0,Jul-18,10,0,0
8174,user_8174,2827,72,27,45,Apr-19,1,1,0
8175,user_8175,4402,32,32,0,Sep-18,8,0,0
8176,user_8176,1970,46,46,0,Jul-18,10,0,0
8177,user_8177,10,1,1,0,Jul-18,10,0,0
8178,user_8178,5867,77,49,28,Apr-19,1,1,0
8179,user_8179,3505,68,56,12,Apr-19,1,1,0
8180,user_8180,4,1,1,0,Jul-18,10,0,0
8181,user_8181,9,5,5,0,Aug-18,9,0,0
8182,user_8182,9237,349,140,209,May-19,0,1,1
8183,user_8183,222,6,6,0,Aug-18,9,0,0
8184,user_8184,66,35,35,0,Aug-18,9,0,0
8185,user_8185,7949,139,59,80,May-19,0,1,1
8186,user_8186,22,5,5,0,Aug-18,9,0,0
8187,user_8187,19570,49,1,48,May-19,0,1,1
8188,user_8188,1973,36,0,36,May-19,0,0,1
8189,user_8189,3419,120,57,63,May-19,0,1,1
8190,user_8190,14,3,3,0,Jul-18,10,0,0
8191,user_8191,22762,782,257,525,May-19,0,1,1
8192,user_8192,2030,36,36,0,Sep-18,8,0,0
8193,user_8193,2930,86,82,4,Mar-19,2,0,0
8194,user_8194,62,6,6,0,Oct-18,7,0,0
8195,user_8195,2289,29,27,2,Jan-19,4,0,0
8196,user_8196,4986,251,114,137,May-19,0,1,1
8197,user_8197,5823,222,126,96,Apr-19,1,1,0
8198,user_8198,21,3,3,0,Dec-18,5,0,0
8199,user_8199,2947,104,94,10,May-19,0,1,1
8200,user_8200,152,20,18,2,Mar-19,2,0,0
8201,user_8201,1590,38,38,0,Aug-18,9,0,0
8202,user_8202,7403,181,103,78,May-19,0,1,1
8203,user_8203,4831,262,165,97,May-19,0,1,1
8204,user_8204,19843,270,114,156,May-19,0,1,1
8205,user_8205,16209,160,120,40,Apr-19,1,1,0
8206,user_8206,13990,465,246,219,May-19,0,1,1
8207,user_8207,3706,50,25,25,May-19,0,1,1
8208,user_8208,1646,29,28,1,Jan-19,4,0,0
8209,user_8209,6408,92,76,16,Apr-19,1,1,0
8210,user_8210,180,18,0,18,May-19,0,1,1
8211,user_8211,23497,44,24,20,Apr-19,1,1,0
8213,user_8213,2843,49,49,0,Oct-18,7,0,0
8214,user_8214,3332,38,17,21,Apr-19,1,1,0
8215,user_8215,313,42,39,3,Jan-19,4,0,0
8216,user_8216,11,2,2,0,Jul-18,10,0,0
8217,user_8217,27,4,4,0,Nov-18,6,0,0
8219,user_8219,31552,240,82,158,Apr-19,1,1,0
8220,user_8220,9660,305,153,152,May-19,0,1,1
8221,user_8221,3661,456,102,354,May-19,0,1,1
8222,user_8222,34,5,5,0,Dec-18,5,0,0
8223,user_8223,1716,16,16,0,Nov-18,6,0,0
8224,user_8224,3798,72,4,68,May-19,0,1,1
8225,user_8225,23270,160,96,64,May-19,0,1,1
8226,user_8226,170,5,5,0,Aug-18,9,0,0
8227,user_8227,10276,530,436,94,Mar-19,2,0,0
8228,user_8228,23,7,7,0,Aug-18,9,0,0
8229,user_8229,57768,791,332,459,May-19,0,1,1
8230,user_8230,2299,23,17,6,May-19,0,1,1
8231,user_8231,15927,122,99,23,Apr-19,1,1,0
8232,user_8232,495,8,7,1,Jan-19,4,0,0
8233,user_8233,15,2,2,0,Jul-18,10,0,0
8234,user_8234,302,13,8,5,Feb-19,3,0,0
8235,user_8235,7410,119,84,35,Apr-19,1,1,0
8236,user_8236,55979,64,43,21,Apr-19,1,1,0
8237,user_8237,1137,15,15,0,Jul-18,10,0,0
8238,user_8238,561,69,61,8,Apr-19,1,1,0
8239,user_8239,10272,102,48,54,May-19,0,1,1
8240,user_8240,24411,331,164,167,May-19,0,1,1
8241,user_8241,14,3,3,0,Jul-18,10,0,0
8242,user_8242,2274,47,32,15,Apr-19,1,1,0
8243,user_8243,8050,170,112,58,May-19,0,1,1
8244,user_8244,20728,860,349,511,May-19,0,1,1
8245,user_8245,4160,63,34,29,May-19,0,1,1
8246,user_8246,775,5,5,0,Aug-18,9,0,0
8247,user_8247,27,3,3,0,Aug-18,9,0,0
8248,user_8248,2066,17,5,12,May-19,0,1,1
8250,user_8250,5852,491,26,465,May-19,0,1,1
8251,user_8251,1436,61,13,48,Mar-19,2,0,0
8252,user_8252,1023,13,13,0,Jul-18,10,0,0
8253,user_8253,14291,179,145,34,May-19,0,1,1
8254,user_8254,117266,473,219,254,May-19,0,1,1
8255,user_8255,8916,71,53,18,Apr-19,1,1,0
8256,user_8256,11,3,3,0,Jul-18,10,0,0
8257,user_8257,803,36,4,32,Apr-19,1,1,0
8258,user_8258,21608,471,104,367,Apr-19,1,1,0
8259,user_8259,334,11,4,7,Apr-19,1,1,0
8260,user_8260,43290,139,52,87,May-19,0,1,1
8261,user_8261,13,3,3,0,Jul-18,10,0,0
8262,user_8262,12816,294,207,87,May-19,0,0,1
8263,user_8263,12747,104,77,27,Apr-19,1,1,0
8264,user_8264,2400,46,25,21,Apr-19,1,1,0
8265,user_8265,8,2,2,0,Jul-18,10,0,0
8266,user_8266,20,4,4,0,Oct-18,7,0,0
8267,user_8267,19390,367,358,9,May-19,0,1,1
8268,user_8268,6241,398,161,237,May-19,0,1,1
8269,user_8269,5734,75,39,36,May-19,0,0,1
8271,user_8271,25952,177,123,54,May-19,0,1,1
8272,user_8272,2077,41,14,27,Mar-19,2,0,0
8273,user_8273,1435,127,92,35,May-19,0,1,1
8274,user_8274,5594,76,17,59,Apr-19,1,1,0
8275,user_8275,21738,179,110,69,May-19,0,1,1
8276,user_8276,9115,231,111,120,May-19,0,1,1
8277,user_8277,1440,58,53,5,Feb-19,3,0,0
8278,user_8278,8107,112,33,79,May-19,0,1,1
8279,user_8279,2315,63,23,40,May-19,0,1,1
8280,user_8280,3682,87,87,0,Sep-18,8,0,0
8281,user_8281,1842,80,36,44,Apr-19,1,1,0
8282,user_8282,19332,63,62,1,Apr-19,1,1,0
8283,user_8283,5956,261,226,35,Mar-19,2,0,0
8284,user_8284,16498,396,136,260,May-19,0,1,1
8285,user_8285,6011,307,122,185,May-19,0,1,1
8286,user_8286,1329,29,17,12,Apr-19,1,1,0
8288,user_8288,14,4,4,0,Jul-18,10,0,0
8289,user_8289,47,7,7,0,Sep-18,8,0,0
8290,user_8290,4461,284,231,53,May-19,0,1,1
8291,user_8291,3025,239,125,114,May-19,0,1,1
8292,user_8292,271,5,4,1,Feb-19,3,0,0
8293,user_8293,19911,50,14,36,May-19,0,1,1
8294,user_8294,4021,278,130,148,May-19,0,1,1
8295,user_8295,14,3,3,0,Jul-18,10,0,0
8296,user_8296,11787,49,48,1,Apr-19,1,1,0
8297,user_8297,9767,250,221,29,Jan-19,4,0,0
8298,user_8298,8938,494,246,248,May-19,0,1,1
8299,user_8299,14776,742,393,349,May-19,0,1,1
8300,user_8300,7986,64,35,29,May-19,0,1,1
8301,user_8301,2306,49,30,19,Apr-19,1,1,0
8302,user_8302,1100,44,10,34,Apr-19,1,1,0
8303,user_8303,1184,43,26,17,Apr-19,1,1,0
8304,user_8304,123,6,6,0,Jul-18,10,0,0
8305,user_8305,2418,111,101,10,Jan-19,4,0,0
8306,user_8306,5889,278,105,173,May-19,0,1,1
8307,user_8307,12,3,3,0,Jul-18,10,0,0
8308,user_8308,43981,2000,929,1071,May-19,0,1,1
8309,user_8309,2165,78,57,21,Apr-19,1,1,0
8310,user_8310,3694,15,12,3,Feb-19,3,0,0
8311,user_8311,4496,65,0,65,May-19,0,1,1
8312,user_8312,18,3,3,0,Aug-18,9,0,0
8313,user_8313,1127,36,36,0,Dec-18,5,0,0
8314,user_8314,1798,28,24,4,Apr-19,1,1,0
8315,user_8315,1118,27,12,15,May-19,0,1,1
8316,user_8316,38005,1076,507,569,May-19,0,1,1
8317,user_8317,8261,54,45,9,Apr-19,1,1,0
8318,user_8318,1104,16,16,0,Aug-18,9,0,0
8319,user_8319,216,13,13,0,Nov-18,6,0,0
8320,user_8320,20907,442,244,198,May-19,0,1,1
8321,user_8321,45273,381,127,254,May-19,0,1,1
8322,user_8322,823,13,6,7,Apr-19,1,1,0
8323,user_8323,755,21,5,16,May-19,0,1,1
8324,user_8324,773,52,52,0,Dec-18,5,0,0
8325,user_8325,35585,578,220,358,May-19,0,1,1
8326,user_8326,5384,92,87,5,May-19,0,0,1
8327,user_8327,7878,166,150,16,Apr-19,1,1,0
8328,user_8328,2000,42,27,15,Apr-19,1,1,0
8329,user_8329,610,10,10,0,Sep-18,8,0,0
8330,user_8330,24,6,6,0,Aug-18,9,0,0
8331,user_8331,4521,36,27,9,Apr-19,1,1,0
8332,user_8332,2103,48,47,1,Feb-19,3,0,0
8333,user_8333,6247,253,96,157,May-19,0,1,1
8334,user_8334,10089,827,599,228,May-19,0,1,1
8335,user_8335,24,4,2,2,Jan-19,4,0,0
8336,user_8336,56393,1223,703,520,May-19,0,1,1
8337,user_8337,27471,39,34,5,Mar-19,2,0,0
8338,user_8338,1222,11,2,9,May-19,0,1,1
8339,user_8339,339,18,5,13,Mar-19,2,0,0
8340,user_8340,579,84,68,16,Apr-19,1,1,0
8341,user_8341,4859,105,91,14,Mar-19,2,0,0
8342,user_8342,11823,247,118,129,May-19,0,1,1
8343,user_8343,874,21,6,15,Apr-19,1,1,0
8344,user_8344,7108,54,54,0,Aug-18,9,0,0
8345,user_8345,12054,147,33,114,May-19,0,1,1
8346,user_8346,2101,86,22,64,May-19,0,1,1
8347,user_8347,1263,26,26,0,Sep-18,8,0,0
8348,user_8348,817,82,43,39,May-19,0,1,1
8349,user_8349,16345,375,109,266,May-19,0,1,1
8350,user_8350,16,5,5,0,Aug-18,9,0,0
8351,user_8351,29723,115,114,1,May-19,0,0,1
8352,user_8352,8,2,2,0,Aug-18,9,0,0
8353,user_8353,646,45,32,13,Mar-19,2,0,0
8354,user_8354,3447,79,58,21,May-19,0,1,1
8355,user_8355,409,36,27,9,May-19,0,1,1
8356,user_8356,3698,239,136,103,May-19,0,1,1
8357,user_8357,85,12,3,9,Feb-19,3,0,0
8358,user_8358,4325,150,70,80,May-19,0,1,1
8359,user_8359,893,36,26,10,Apr-19,1,1,0
8360,user_8360,8373,217,83,134,May-19,0,1,1
8361,user_8361,8917,54,51,3,Mar-19,2,0,0
8362,user_8362,4604,89,78,11,Apr-19,1,1,0
8363,user_8363,5188,191,191,0,Sep-18,8,0,0
8364,user_8364,2637,152,146,6,May-19,0,0,1
8365,user_8365,306,6,6,0,Aug-18,9,0,0
8366,user_8366,17871,339,102,237,May-19,0,1,1
8367,user_8367,17095,149,121,28,Apr-19,1,1,0
8368,user_8368,6077,220,187,33,May-19,0,1,1
8369,user_8369,140,11,6,5,Jan-19,4,0,0
8370,user_8370,53,6,0,6,Apr-19,1,1,0
8371,user_8371,3199,128,73,55,May-19,0,1,1
8372,user_8372,1002,18,18,0,Aug-18,9,0,0
8373,user_8373,1013,22,13,9,Apr-19,1,1,0
8374,user_8374,6012,200,80,120,May-19,0,1,1
8375,user_8375,805,29,29,0,Dec-18,5,0,0
8376,user_8376,1103,25,25,0,Nov-18,6,0,0
8377,user_8377,306,2,2,0,Aug-18,9,0,0
8378,user_8378,19123,298,241,57,Apr-19,1,1,0
8379,user_8379,7365,101,88,13,Apr-19,1,1,0
8380,user_8380,401,26,0,26,May-19,0,0,1
8381,user_8381,5881,154,100,54,Apr-19,1,1,0
8382,user_8382,6525,251,91,160,May-19,0,1,1
8383,user_8383,1402,41,30,11,Apr-19,1,1,0
8384,user_8384,1835,91,48,43,May-19,0,1,1
8385,user_8385,2838,65,39,26,Apr-19,1,1,0
8386,user_8386,2453,17,16,1,May-19,0,0,1
8387,user_8387,25358,664,550,114,Feb-19,3,0,0
8388,user_8388,15,6,6,0,Jul-18,10,0,0
8389,user_8389,22128,558,342,216,May-19,0,1,1
8390,user_8390,3360,50,48,2,Apr-19,1,1,0
8391,user_8391,381,21,21,0,Dec-18,5,0,0
8392,user_8392,9591,43,13,30,May-19,0,1,1
8393,user_8393,360,21,21,0,Dec-18,5,0,0
8394,user_8394,4871,30,0,30,May-19,0,1,1
8395,user_8395,11344,229,128,101,Apr-19,1,1,0
8396,user_8396,1630,73,55,18,Apr-19,1,1,0
8397,user_8397,796,30,5,25,Apr-19,1,1,0
8398,user_8398,103,7,6,1,Jan-19,4,0,0
8399,user_8399,3212,78,72,6,Feb-19,3,0,0
8400,user_8400,320,32,8,24,Mar-19,2,0,0
8401,user_8401,725,19,18,1,Feb-19,3,0,0
8402,user_8402,19,3,3,0,Jul-18,10,0,0
8403,user_8403,14665,195,106,89,May-19,0,1,1
8404,user_8404,1369,50,43,7,Jan-19,4,0,0
8405,user_8405,1764,47,34,13,Jan-19,4,0,0
8406,user_8406,10483,163,122,41,Apr-19,1,1,0
8407,user_8407,630,27,13,14,May-19,0,1,1
8408,user_8408,137,12,7,5,Apr-19,1,1,0
8409,user_8409,3241,45,33,12,Feb-19,3,0,0
8410,user_8410,8532,227,13,214,May-19,0,1,1
8411,user_8411,3210,81,72,9,May-19,0,1,1
8412,user_8412,7289,171,38,133,May-19,0,1,1
8413,user_8413,8167,234,78,156,May-19,0,1,1
8414,user_8414,34325,385,0,385,May-19,0,1,1
8415,user_8415,199,15,12,3,May-19,0,1,1
8416,user_8416,2809,42,40,2,Mar-19,2,0,0
8417,user_8417,43,10,10,0,Oct-18,7,0,0
8418,user_8418,31046,595,301,294,May-19,0,1,1
8419,user_8419,2562,156,80,76,May-19,0,1,1
8420,user_8420,6591,71,33,38,Mar-19,2,0,0
8421,user_8421,12475,408,167,241,May-19,0,1,1
8422,user_8422,1203,23,23,0,Aug-18,9,0,0
8423,user_8423,24617,51,39,12,May-19,0,1,1
8424,user_8424,23524,114,65,49,Feb-19,3,0,0
8425,user_8425,301,19,5,14,Apr-19,1,1,0
8426,user_8426,219,3,3,0,Jul-18,10,0,0
8427,user_8427,2113,21,0,21,May-19,0,1,1
8428,user_8428,11022,13,0,13,Mar-19,2,0,0
8429,user_8429,2867,185,74,111,May-19,0,1,1
8430,user_8430,2286,87,45,42,Apr-19,1,1,0
8431,user_8431,173,17,17,0,Jul-18,10,0,0
8432,user_8432,12108,658,332,326,May-19,0,1,1
8433,user_8433,6743,34,27,7,Mar-19,2,0,0
8434,user_8434,4004,59,55,4,May-19,0,0,1
8435,user_8435,2248,17,17,0,Oct-18,7,0,0
8436,user_8436,5871,157,142,15,Mar-19,2,0,0
8437,user_8437,2360,82,63,19,Mar-19,2,0,0
8438,user_8438,856,96,4,92,May-19,0,1,1
8439,user_8439,3715,396,164,232,May-19,0,1,1
8440,user_8440,18151,386,332,54,May-19,0,1,1
8441,user_8441,15893,137,59,78,May-19,0,1,1
8442,user_8442,2268,44,0,44,Mar-19,2,0,0
8443,user_8443,30,2,2,0,Jul-18,10,0,0
8444,user_8444,1336,7,7,0,Oct-18,7,0,0
8445,user_8445,23222,267,88,179,May-19,0,1,1
8446,user_8446,10,1,1,0,Jul-18,10,0,0
8447,user_8447,2389,97,43,54,Apr-19,1,1,0
8448,user_8448,2057,74,20,54,May-19,0,1,1
8449,user_8449,7848,157,82,75,May-19,0,1,1
8450,user_8450,14948,479,318,161,Apr-19,1,1,0
8451,user_8451,13002,53,14,39,Apr-19,1,1,0
8452,user_8452,7871,648,339,309,May-19,0,1,1
8453,user_8453,204,11,3,8,Apr-19,1,1,0
8454,user_8454,14745,723,251,472,May-19,0,1,1
8455,user_8455,1615,22,22,0,Aug-18,9,0,0
8456,user_8456,8368,75,31,44,Apr-19,1,1,0
8457,user_8457,660,74,74,0,Sep-18,8,0,0
8458,user_8458,1722,133,83,50,Apr-19,1,1,0
8459,user_8459,6422,132,80,52,May-19,0,0,1
8460,user_8460,28174,1294,662,632,May-19,0,1,1
8461,user_8461,4058,68,68,0,Nov-18,6,0,0
8462,user_8462,8338,154,101,53,May-19,0,1,1
8463,user_8463,32,14,12,2,Apr-19,1,1,0
8464,user_8464,6759,421,17,404,May-19,0,1,1
8465,user_8465,677,13,9,4,Apr-19,1,1,0
8466,user_8466,9192,44,29,15,Apr-19,1,1,0
8467,user_8467,5989,259,116,143,May-19,0,1,1
8468,user_8468,29733,210,122,88,May-19,0,1,1
8469,user_8469,99,10,10,0,Sep-18,8,0,0
8470,user_8470,3694,81,59,22,Apr-19,1,1,0
8471,user_8471,814,49,5,44,Mar-19,2,0,0
8472,user_8472,1671,110,82,28,Apr-19,1,1,0
8473,user_8473,11605,219,147,72,May-19,0,1,1
8474,user_8474,813,6,2,4,Apr-19,1,1,0
8475,user_8475,11,2,2,0,Nov-18,6,0,0
8476,user_8476,2099,119,54,65,Apr-19,1,1,0
8477,user_8477,1721,70,62,8,May-19,0,1,1
8478,user_8478,1692,38,27,11,Jan-19,4,0,0
8479,user_8479,55191,138,79,59,May-19,0,1,1
8480,user_8480,2148,56,31,25,Apr-19,1,1,0
8481,user_8481,1995,39,39,0,Nov-18,6,0,0
8482,user_8482,12396,109,49,60,May-19,0,1,1
8483,user_8483,2117,27,19,8,May-19,0,0,1
8484,user_8484,774,50,26,24,May-19,0,1,1
8485,user_8485,2625,231,231,0,Oct-18,7,0,0
8486,user_8486,148,17,17,0,Nov-18,6,0,0
8487,user_8487,8179,181,181,0,Nov-18,6,0,0
8488,user_8488,2993,51,51,0,Dec-18,5,0,0
8489,user_8489,2481,51,44,7,Apr-19,1,1,0
8490,user_8490,116637,1424,744,680,May-19,0,1,1
8491,user_8491,502,36,34,2,Feb-19,3,0,0
8492,user_8492,1294,40,6,34,May-19,0,1,1
8493,user_8493,351,613,433,180,Apr-19,1,1,0
8494,user_8494,97,16,16,0,Oct-18,7,0,0
8496,user_8496,10167,342,221,121,May-19,0,1,1
8497,user_8497,137,12,12,0,Sep-18,8,0,0
8498,user_8498,421,16,0,16,May-19,0,1,1
8499,user_8499,4510,121,86,35,May-19,0,1,1
8500,user_8500,126,27,21,6,Feb-19,3,0,0
8501,user_8501,4595,258,258,0,Sep-18,8,0,0
8502,user_8502,10935,210,69,141,May-19,0,1,1
8503,user_8503,5795,82,39,43,May-19,0,1,1
8504,user_8504,4188,6,6,0,Jul-18,10,0,0
8505,user_8505,1446,93,71,22,May-19,0,1,1
8506,user_8506,5411,226,85,141,Mar-19,2,0,0
8507,user_8507,1431,5,3,2,Mar-19,2,0,0
8508,user_8508,16436,655,221,434,May-19,0,1,1
8509,user_8509,2878,46,1,45,May-19,0,1,1
8511,user_8511,3804,175,168,7,Jan-19,4,0,0
8512,user_8512,231,9,4,5,May-19,0,0,1
8513,user_8513,17283,165,105,60,May-19,0,1,1
8514,user_8514,14849,1124,661,463,May-19,0,1,1
8515,user_8515,215,9,9,0,Nov-18,6,0,0
8516,user_8516,188096,196,94,102,May-19,0,1,1
8517,user_8517,19799,344,157,187,May-19,0,1,1
8518,user_8518,15873,45,1,44,May-19,0,1,1
8519,user_8519,11013,489,296,193,May-19,0,1,1
8520,user_8520,8962,149,77,72,Apr-19,1,1,0
8521,user_8521,10,4,4,0,Aug-18,9,0,0
8522,user_8522,9244,323,156,167,May-19,0,1,1
8523,user_8523,3207,111,45,66,May-19,0,1,1
8524,user_8524,23751,94,62,32,Apr-19,1,1,0
8526,user_8526,4398,351,157,194,May-19,0,1,1
8527,user_8527,11,2,2,0,Jul-18,10,0,0
8528,user_8528,6752,56,43,13,Apr-19,1,1,0
8529,user_8529,2668,18,5,13,Apr-19,1,1,0
8531,user_8531,2819,50,0,50,May-19,0,1,1
8533,user_8533,15027,458,453,5,Apr-19,1,1,0
8534,user_8534,1507,49,9,40,May-19,0,1,1
8535,user_8535,11837,109,23,86,May-19,0,1,1
8536,user_8536,140,14,14,0,Sep-18,8,0,0
8537,user_8537,2318,122,85,37,Apr-19,1,1,0
8538,user_8538,1556,61,26,35,Apr-19,1,1,0
8539,user_8539,6155,77,77,0,Sep-18,8,0,0
8540,user_8540,65785,1557,431,1126,May-19,0,1,1
8541,user_8541,42,6,0,6,May-19,0,1,1
8542,user_8542,2281,108,34,74,May-19,0,1,1
8543,user_8543,8534,122,57,65,Feb-19,3,0,0
8544,user_8544,657013,1027,188,839,May-19,0,1,1
8545,user_8545,2114,22,5,17,May-19,0,1,1
8546,user_8546,513,99,73,26,May-19,0,1,1
8547,user_8547,20,2,2,0,Oct-18,7,0,0
8548,user_8548,52298,317,146,171,May-19,0,1,1
8549,user_8549,195,9,4,5,Apr-19,1,1,0
8550,user_8550,3545,220,205,15,Apr-19,1,1,0
8551,user_8551,15679,120,57,63,May-19,0,1,1
8552,user_8552,997,34,17,17,May-19,0,1,1
8553,user_8553,2559,131,82,49,May-19,0,0,1
8554,user_8554,101,3,3,0,Jul-18,10,0,0
8555,user_8555,1174,8,8,0,Oct-18,7,0,0
8556,user_8556,1879,50,29,21,Apr-19,1,1,0
8557,user_8557,2320,29,27,2,Mar-19,2,0,0
8558,user_8558,2042,73,68,5,May-19,0,0,1
8559,user_8559,9384,224,100,124,May-19,0,1,1
8560,user_8560,9291,229,158,71,May-19,0,1,1
8561,user_8561,9020,19,9,10,Mar-19,2,0,0
8562,user_8562,2654,79,77,2,Apr-19,1,1,0
8563,user_8563,3349,167,94,73,May-19,0,1,1
8564,user_8564,12385,194,94,100,Apr-19,1,1,0
8565,user_8565,22,2,2,0,Jul-18,10,0,0
8566,user_8566,4940,172,77,95,May-19,0,1,1
8567,user_8567,5458,227,104,123,May-19,0,1,1
8568,user_8568,10979,297,146,151,May-19,0,1,1
8569,user_8569,3637,31,31,0,Aug-18,9,0,0
8570,user_8570,3234,34,9,25,Apr-19,1,1,0
8571,user_8571,36241,98,37,61,May-19,0,1,1
8572,user_8572,438,17,15,2,Apr-19,1,1,0
8573,user_8573,44126,190,81,109,Apr-19,1,1,0
8574,user_8574,297,49,18,31,May-19,0,1,1
8575,user_8575,2509,80,67,13,May-19,0,1,1
8576,user_8576,2934,222,212,10,May-19,0,0,1
8577,user_8577,12165,813,640,173,May-19,0,1,1
8578,user_8578,452,25,21,4,Mar-19,2,0,0
8579,user_8579,11,2,2,0,Jul-18,10,0,0
8580,user_8580,10264,353,212,141,May-19,0,1,1
8581,user_8581,3342,97,87,10,May-19,0,0,1
8582,user_8582,87,8,7,1,Jan-19,4,0,0
8583,user_8583,4464,223,172,51,May-19,0,1,1
8584,user_8584,2692,51,29,22,Apr-19,1,1,0
8585,user_8585,31,4,4,0,Aug-18,9,0,0
8586,user_8586,3446,191,34,157,May-19,0,1,1
8587,user_8587,8633,278,151,127,Apr-19,1,1,0
8589,user_8589,4357,292,202,90,May-19,0,1,1
8590,user_8590,137,11,11,0,Aug-18,9,0,0
8591,user_8591,23839,872,441,431,May-19,0,1,1
8592,user_8592,2184,66,59,7,Mar-19,2,0,0
8593,user_8593,2202,24,24,0,Sep-18,8,0,0
8594,user_8594,25803,102,97,5,May-19,0,1,1
8595,user_8595,11416,347,302,45,May-19,0,1,1
8596,user_8596,556,29,18,11,Apr-19,1,1,0
8597,user_8597,9599,120,89,31,Apr-19,1,1,0
8598,user_8598,308,21,16,5,May-19,0,1,1
8599,user_8599,5487,663,342,321,Apr-19,1,1,0
8600,user_8600,4838,68,39,29,May-19,0,1,1
8601,user_8601,3935,34,10,24,May-19,0,1,1
8602,user_8602,1951,31,31,0,Aug-18,9,0,0
8603,user_8603,5141,68,68,0,Sep-18,8,0,0
8604,user_8604,13508,185,138,47,May-19,0,1,1
8605,user_8605,4784,192,106,86,May-19,0,1,1
8606,user_8606,15311,996,384,612,May-19,0,1,1
8607,user_8607,4836,146,92,54,May-19,0,1,1
8608,user_8608,1958,27,17,10,Mar-19,2,0,0
8609,user_8609,16337,466,215,251,May-19,0,1,1
8610,user_8610,688,24,20,4,Apr-19,1,1,0
8611,user_8611,2656,100,76,24,Mar-19,2,0,0
8612,user_8612,1374,129,103,26,Apr-19,1,1,0
8613,user_8613,362,15,15,0,Sep-18,8,0,0
8614,user_8614,7952,72,14,58,Apr-19,1,1,0
8616,user_8616,5482,202,101,101,May-19,0,1,1
8617,user_8617,8282,522,347,175,May-19,0,1,1
8618,user_8618,12051,421,84,337,May-19,0,1,1
8619,user_8619,102902,292,90,202,May-19,0,1,1
8620,user_8620,10645,82,47,35,Apr-19,1,1,0
8621,user_8621,3356,130,80,50,May-19,0,1,1
8622,user_8622,9,2,2,0,Aug-18,9,0,0
8623,user_8623,13870,361,160,201,May-19,0,1,1
8624,user_8624,4807,68,61,7,May-19,0,1,1
8625,user_8625,11177,97,52,45,Mar-19,2,0,0
8626,user_8626,3823,330,185,145,May-19,0,1,1
8627,user_8627,16,3,3,0,Jul-18,10,0,0
8628,user_8628,411,15,13,2,May-19,0,0,1
8629,user_8629,3923,42,10,32,Jan-19,4,0,0
8630,user_8630,25921,223,120,103,May-19,0,1,1
8631,user_8631,19327,172,130,42,May-19,0,1,1
8632,user_8632,1315,17,11,6,Apr-19,1,1,0
8633,user_8633,4825,126,104,22,Mar-19,2,0,0
8634,user_8634,38683,470,248,222,May-19,0,1,1
8635,user_8635,16,3,3,0,Jul-18,10,0,0
8636,user_8636,8262,159,81,78,May-19,0,1,1
8637,user_8637,7767,29,25,4,Feb-19,3,0,0
8638,user_8638,3810,50,39,11,Feb-19,3,0,0
8639,user_8639,2138,132,65,67,May-19,0,1,1
8640,user_8640,11731,129,83,46,May-19,0,1,1
8641,user_8641,7066,12,10,2,Mar-19,2,0,0
8642,user_8642,1252,33,20,13,May-19,0,1,1
8643,user_8643,215,5,0,5,May-19,0,1,1
8644,user_8644,1742,55,26,29,May-19,0,1,1
8645,user_8645,6212,152,92,60,May-19,0,1,1
8646,user_8646,12020,1195,644,551,May-19,0,1,1
8647,user_8647,2439,158,87,71,May-19,0,1,1
8648,user_8648,31,6,6,0,Sep-18,8,0,0
8649,user_8649,4202,295,162,133,May-19,0,1,1
8650,user_8650,5440,118,73,45,Mar-19,2,0,0
8651,user_8651,9638,488,272,216,May-19,0,1,1
8652,user_8652,2708,210,154,56,May-19,0,1,1
8653,user_8653,11481,449,337,112,May-19,0,1,1
8655,user_8655,751,11,7,4,Mar-19,2,0,0
8656,user_8656,16130,27,8,19,May-19,0,1,1
8657,user_8657,9474,387,158,229,May-19,0,1,1
8658,user_8658,20492,79,68,11,Apr-19,1,1,0
8659,user_8659,84,8,8,0,Oct-18,7,0,0
8660,user_8660,92,9,7,2,Mar-19,2,0,0
8661,user_8661,6184,91,43,48,Apr-19,1,1,0
8662,user_8662,780,19,14,5,May-19,0,1,1
8663,user_8663,206,11,9,2,Apr-19,1,1,0
8664,user_8664,18789,345,222,123,May-19,0,1,1
8665,user_8665,9540,571,218,353,May-19,0,1,1
8666,user_8666,633,39,38,1,Apr-19,1,1,0
8667,user_8667,3813,69,53,16,Apr-19,1,1,0
8668,user_8668,7945,96,35,61,May-19,0,1,1
8669,user_8669,2816,75,37,38,Apr-19,1,1,0
8670,user_8670,360,36,26,10,May-19,0,1,1
8671,user_8671,3070,37,37,0,Oct-18,7,0,0
8672,user_8672,3274,200,79,121,Apr-19,1,1,0
8673,user_8673,176,6,0,6,May-19,0,0,1
8675,user_8675,1009,55,51,4,Feb-19,3,0,0
8676,user_8676,22388,431,302,129,May-19,0,1,1
8677,user_8677,18272,338,290,48,Apr-19,1,1,0
8678,user_8678,9599,340,66,274,May-19,0,1,1
8679,user_8679,10823,215,53,162,May-19,0,1,1
8680,user_8680,381,16,2,14,Apr-19,1,1,0
8681,user_8681,5019,72,35,37,Mar-19,2,0,0
8682,user_8682,3978,56,40,16,Jan-19,4,0,0
8683,user_8683,4126,77,3,74,May-19,0,1,1
8684,user_8684,3504,111,50,61,May-19,0,1,1
8685,user_8685,11897,456,151,305,May-19,0,1,1
8686,user_8686,21417,571,303,268,May-19,0,1,1
8687,user_8687,9306,160,130,30,May-19,0,1,1
8688,user_8688,239,22,22,0,Sep-18,8,0,0
8690,user_8690,9146,138,71,67,May-19,0,1,1
8691,user_8691,4672,113,63,50,Apr-19,1,1,0
8692,user_8692,11626,333,144,189,May-19,0,1,1
8693,user_8693,14066,148,76,72,May-19,0,1,1
8694,user_8694,9985,220,129,91,Apr-19,1,1,0
8695,user_8695,965,57,47,10,May-19,0,1,1
8696,user_8696,5059,127,83,44,May-19,0,1,1
8697,user_8697,3765,95,79,16,May-19,0,1,1
8698,user_8698,32988,462,173,289,May-19,0,1,1
8699,user_8699,2064,44,41,3,Mar-19,2,0,0
8700,user_8700,5665,63,29,34,Apr-19,1,1,0
8701,user_8701,56,3,3,0,Aug-18,9,0,0
8702,user_8702,93,6,4,2,Apr-19,1,1,0
8703,user_8703,48,8,8,0,Jul-18,10,0,0
8704,user_8704,492,11,11,0,Aug-18,9,0,0
8705,user_8705,407,41,27,14,May-19,0,1,1
8706,user_8706,2823,126,78,48,May-19,0,1,1
8707,user_8707,856792,416,19,397,May-19,0,1,1
8708,user_8708,2255,30,22,8,Apr-19,1,1,0
8709,user_8709,4164,133,88,45,May-19,0,1,1
8710,user_8710,404,36,36,0,Nov-18,6,0,0
8711,user_8711,917,34,34,0,Nov-18,6,0,0
8712,user_8712,9,2,2,0,Jul-18,10,0,0
8713,user_8713,427,24,19,5,Mar-19,2,0,0
8714,user_8714,3121,49,42,7,Apr-19,1,1,0
8715,user_8715,15,5,5,0,Aug-18,9,0,0
8716,user_8716,2325,94,71,23,Mar-19,2,0,0
8718,user_8718,22885,75,66,9,Mar-19,2,0,0
8719,user_8719,3976,40,17,23,Apr-19,1,1,0
8720,user_8720,2257,43,43,0,Nov-18,6,0,0
8721,user_8721,381,66,38,28,May-19,0,1,1
8722,user_8722,393,13,8,5,Feb-19,3,0,0
8723,user_8723,1277,64,0,64,May-19,0,1,1
8724,user_8724,6214,113,108,5,Apr-19,1,1,0
8725,user_8725,1103,62,37,25,Apr-19,1,1,0
8726,user_8726,3814,60,57,3,Feb-19,3,0,0
8727,user_8727,40160,31,13,18,May-19,0,1,1
8728,user_8728,15171,26,26,0,Sep-18,8,0,0
8729,user_8729,2762,104,102,2,Jan-19,4,0,0
8730,user_8730,4270,314,232,82,May-19,0,1,1
8731,user_8731,37040,125,109,16,Mar-19,2,0,0
8732,user_8732,28789,602,266,336,May-19,0,1,1
8733,user_8733,1774,38,38,0,Dec-18,5,0,0
8734,user_8734,3158,17,17,0,Sep-18,8,0,0
8735,user_8735,2990,121,93,28,May-19,0,1,1
8736,user_8736,4503,187,103,84,May-19,0,1,1
8737,user_8737,4198,82,74,8,Apr-19,1,1,0
8738,user_8738,3915,239,4,235,May-19,0,1,1
8739,user_8739,2,2,2,0,Dec-18,5,0,0
8740,user_8740,747,147,77,70,May-19,0,1,1
8741,user_8741,751,145,37,108,May-19,0,1,1
8743,user_8743,1815,44,44,0,Sep-18,8,0,0
8744,user_8744,4466,163,95,68,May-19,0,1,1
8745,user_8745,4353,15,13,2,Apr-19,1,1,0
8746,user_8746,9921,98,62,36,May-19,0,1,1
8747,user_8747,3959,82,59,23,Apr-19,1,1,0
8748,user_8748,118,8,8,0,Aug-18,9,0,0
8749,user_8749,43193,250,182,68,Apr-19,1,1,0
8750,user_8750,23,5,5,0,Dec-18,5,0,0
8751,user_8751,2104,70,23,47,Mar-19,2,0,0
8752,user_8752,40,4,4,0,Jul-18,10,0,0
8753,user_8753,15318,485,315,170,May-19,0,1,1
8754,user_8754,16383,25,7,18,Apr-19,1,1,0
8755,user_8755,6438,272,253,19,Mar-19,2,0,0
8756,user_8756,93947,25,15,10,May-19,0,0,1
8757,user_8757,2184,36,29,7,Apr-19,1,1,0
8758,user_8758,30,4,3,1,Apr-19,1,1,0
8759,user_8759,9440,130,83,47,May-19,0,0,1
8760,user_8760,12,5,5,0,Dec-18,5,0,0
8761,user_8761,14113,255,71,184,Apr-19,1,1,0
8762,user_8762,841,43,43,0,Oct-18,7,0,0
8763,user_8763,1546,73,29,44,Apr-19,1,1,0
8764,user_8764,950,77,27,50,May-19,0,1,1
8765,user_8765,930,108,46,62,May-19,0,1,1
8766,user_8766,7444,137,129,8,Apr-19,1,1,0
8767,user_8767,113762,1287,669,618,May-19,0,1,1
8768,user_8768,1265,17,17,0,Jul-18,10,0,0
8769,user_8769,1689,24,24,0,Dec-18,5,0,0
8770,user_8770,4110,72,55,17,May-19,0,1,1
8771,user_8771,5885,86,3,83,May-19,0,1,1
8772,user_8772,328,21,20,1,Apr-19,1,1,0
8773,user_8773,148,8,0,8,May-19,0,1,1
8774,user_8774,5330,27,27,0,Jul-18,10,0,0
8775,user_8775,3982,67,35,32,May-19,0,1,1
8777,user_8777,60,5,5,0,Jul-18,10,0,0
8778,user_8778,124,11,11,0,Oct-18,7,0,0
8779,user_8779,36770,364,217,147,May-19,0,1,1
8780,user_8780,1766,72,42,30,Mar-19,2,0,0
8781,user_8781,312,17,16,1,Jan-19,4,0,0
8782,user_8782,26,4,4,0,Jul-18,10,0,0
8783,user_8783,52551,202,64,138,May-19,0,1,1
8784,user_8784,144,18,4,14,May-19,0,1,1
8785,user_8785,2765,151,72,79,Apr-19,1,1,0
8786,user_8786,8832,34,33,1,Apr-19,1,1,0
8787,user_8787,1516,21,21,0,Oct-18,7,0,0
8788,user_8788,34,8,8,0,Oct-18,7,0,0
8789,user_8789,2338,37,37,0,Aug-18,9,0,0
8790,user_8790,2845,128,78,50,Apr-19,1,1,0
8791,user_8791,917,29,18,11,May-19,0,1,1
8792,user_8792,639,47,23,24,May-19,0,1,1
8793,user_8793,30016,595,377,218,May-19,0,1,1
8794,user_8794,3881,108,70,38,May-19,0,0,1
8795,user_8795,4713,60,48,12,May-19,0,1,1
8796,user_8796,10960,233,90,143,May-19,0,1,1
8797,user_8797,8142,201,127,74,May-19,0,1,1
8798,user_8798,928,21,19,2,Mar-19,2,0,0
8799,user_8799,962,97,16,81,May-19,0,1,1
8800,user_8800,30042,50,29,21,May-19,0,1,1
8801,user_8801,1481,68,67,1,Mar-19,2,0,0
8802,user_8802,12630,682,275,407,May-19,0,1,1
8803,user_8803,121,4,4,0,Aug-18,9,0,0
8804,user_8804,36000,439,310,129,May-19,0,1,1
8805,user_8805,4635,135,54,81,May-19,0,0,1
8806,user_8806,16,3,3,0,Jul-18,10,0,0
8807,user_8807,26,4,3,1,Feb-19,3,0,0
8808,user_8808,304,30,19,11,Mar-19,2,0,0
8809,user_8809,3531,107,83,24,Apr-19,1,1,0
8810,user_8810,53,7,7,0,Jul-18,10,0,0
8811,user_8811,7894,155,82,73,May-19,0,1,1
8812,user_8812,13525,133,88,45,May-19,0,1,1
8813,user_8813,6861,8,8,0,Aug-18,9,0,0
8814,user_8814,1240,19,13,6,May-19,0,0,1
8815,user_8815,89,12,4,8,May-19,0,1,1
8816,user_8816,299,27,27,0,Nov-18,6,0,0
8817,user_8817,2426,96,18,78,May-19,0,1,1
8818,user_8818,29791,428,74,354,May-19,0,1,1
8819,user_8819,10905,239,180,59,Mar-19,2,0,0
8820,user_8820,4910,330,82,248,May-19,0,1,1
8821,user_8821,4494,78,78,0,Jul-18,10,0,0
8822,user_8822,12438,261,258,3,Apr-19,1,1,0
8823,user_8823,1121,51,8,43,May-19,0,1,1
8824,user_8824,426544,26,26,0,Sep-18,8,0,0
8825,user_8825,28600,345,160,185,May-19,0,1,1
8826,user_8826,1882,96,48,48,Apr-19,1,1,0
8827,user_8827,11601,199,99,100,May-19,0,1,1
8828,user_8828,2570,163,88,75,May-19,0,1,1
8829,user_8829,822,31,31,0,Aug-18,9,0,0
8830,user_8830,2327,38,37,1,Apr-19,1,1,0
8831,user_8831,2455,27,1,26,May-19,0,1,1
8832,user_8832,14808,281,134,147,May-19,0,1,1
8833,user_8833,23734,158,84,74,May-19,0,1,1
8834,user_8834,9791,121,103,18,May-19,0,1,1
8835,user_8835,29787,398,217,181,May-19,0,1,1
8836,user_8836,321,13,5,8,May-19,0,0,1
8837,user_8837,535,37,25,12,Apr-19,1,1,0
8838,user_8838,472,10,10,0,Aug-18,9,0,0
8839,user_8839,1209,124,39,85,May-19,0,1,1
8840,user_8840,2866,433,140,293,May-19,0,1,1
8841,user_8841,21,4,4,0,Jul-18,10,0,0
8842,user_8842,2610,57,41,16,May-19,0,1,1
8843,user_8843,5146,120,57,63,May-19,0,1,1
8844,user_8844,6844,229,116,113,May-19,0,1,1
8845,user_8845,5247,199,115,84,May-19,0,1,1
8846,user_8846,3677,64,48,16,Mar-19,2,0,0
8847,user_8847,3747,61,56,5,Apr-19,1,1,0
8848,user_8848,92,8,8,0,Aug-18,9,0,0
8849,user_8849,4675,56,42,14,May-19,0,0,1
8850,user_8850,203,6,5,1,Apr-19,1,1,0
8851,user_8851,20026,506,326,180,May-19,0,1,1
8852,user_8852,2220,20,17,3,Feb-19,3,0,0
8853,user_8853,1188,16,16,0,Nov-18,6,0,0
8854,user_8854,2138,185,72,113,May-19,0,1,1
8855,user_8855,3347,24,21,3,Feb-19,3,0,0
8856,user_8856,581,177,59,118,May-19,0,1,1
8857,user_8857,6669,41,5,36,May-19,0,1,1
8858,user_8858,7446,133,109,24,May-19,0,1,1
8859,user_8859,6568,302,155,147,Apr-19,1,1,0
8860,user_8860,104,8,7,1,Jan-19,4,0,0
8861,user_8861,2446,18,18,0,Sep-18,8,0,0
8862,user_8862,6447,85,85,0,Nov-18,6,0,0
8863,user_8863,1037,21,18,3,Mar-19,2,0,0
8864,user_8864,1504,10,10,0,Jul-18,10,0,0
8865,user_8865,1384,28,24,4,Mar-19,2,0,0
8866,user_8866,17,3,2,1,Apr-19,1,1,0
8867,user_8867,1514,23,15,8,Mar-19,2,0,0
8868,user_8868,2912,47,28,19,Feb-19,3,0,0
8869,user_8869,136,8,8,0,Aug-18,9,0,0
8870,user_8870,10513,191,105,86,Mar-19,2,0,0
8871,user_8871,7845,127,64,63,May-19,0,0,1
8873,user_8873,23,4,4,0,Sep-18,8,0,0
8874,user_8874,4587,50,50,0,Oct-18,7,0,0
8875,user_8875,354,79,72,7,Apr-19,1,1,0
8876,user_8876,4825,142,5,137,May-19,0,1,1
8877,user_8877,48,5,5,0,Aug-18,9,0,0
8878,user_8878,16,3,3,0,Jul-18,10,0,0
8879,user_8879,20,11,11,0,Oct-18,7,0,0
8880,user_8880,25989,104,85,19,Apr-19,1,1,0
8881,user_8881,1227,96,27,69,May-19,0,1,1
8882,user_8882,3299,22,17,5,May-19,0,1,1
8883,user_8883,3327,47,18,29,May-19,0,0,1
8884,user_8884,3545,118,56,62,May-19,0,1,1
8885,user_8885,32,5,5,0,Sep-18,8,0,0
8886,user_8886,6051,169,126,43,May-19,0,1,1
8887,user_8887,139,17,11,6,Apr-19,1,1,0
8888,user_8888,30724,66,44,22,Apr-19,1,1,0
8889,user_8889,16,3,3,0,Jul-18,10,0,0
8890,user_8890,309,23,23,0,Oct-18,7,0,0
8891,user_8891,11797,338,198,140,May-19,0,1,1
8892,user_8892,7184,42,42,0,Dec-18,5,0,0
8893,user_8893,917,30,27,3,Apr-19,1,1,0
8894,user_8894,2356,66,51,15,May-19,0,1,1
8895,user_8895,58,5,3,2,May-19,0,1,1
8896,user_8896,3644,254,213,41,Apr-19,1,1,0
8897,user_8897,17012,174,132,42,May-19,0,1,1
8898,user_8898,5597,96,58,38,Mar-19,2,0,0
8899,user_8899,51508,358,114,244,May-19,0,1,1
8900,user_8900,1243,68,56,12,Apr-19,1,1,0
8901,user_8901,279,11,11,0,Nov-18,6,0,0
8902,user_8902,1877,231,0,231,May-19,0,1,1
8903,user_8903,13406,17,14,3,Jan-19,4,0,0
8904,user_8904,732,6,6,0,Jul-18,10,0,0
8905,user_8905,6803,141,141,0,Sep-18,8,0,0
8906,user_8906,15204,392,259,133,May-19,0,1,1
8907,user_8907,3978,63,50,13,May-19,0,1,1
8908,user_8908,26238,174,76,98,May-19,0,1,1
8909,user_8909,16,3,3,0,Aug-18,9,0,0
8910,user_8910,11,2,2,0,Jul-18,10,0,0
8911,user_8911,3555,11,8,3,Jan-19,4,0,0
8912,user_8912,3757,141,74,67,May-19,0,1,1
8913,user_8913,20,5,5,0,Jul-18,10,0,0
8914,user_8914,39,6,5,1,Feb-19,3,0,0
8915,user_8915,14622,244,109,135,May-19,0,1,1
8916,user_8916,2511,70,7,63,May-19,0,1,1
8917,user_8917,293,4,3,1,Apr-19,1,1,0
8918,user_8918,525,20,20,0,Nov-18,6,0,0
8919,user_8919,3511,39,39,0,Aug-18,9,0,0
8920,user_8920,6556,256,110,146,May-19,0,1,1
8921,user_8921,11,2,2,0,Jul-18,10,0,0
8922,user_8922,2534,71,46,25,May-19,0,0,1
8923,user_8923,2424,76,55,21,May-19,0,1,1
8924,user_8924,1244,81,26,55,May-19,0,1,1
8925,user_8925,4212,325,119,206,May-19,0,1,1
8926,user_8926,7232,123,64,59,May-19,0,1,1
8927,user_8927,8669,289,238,51,May-19,0,1,1
8928,user_8928,11335,447,447,0,Nov-18,6,0,0
8929,user_8929,2601,53,42,11,Apr-19,1,1,0
8930,user_8930,5533,161,86,75,May-19,0,1,1
8931,user_8931,1024,6,3,3,Mar-19,2,0,0
8932,user_8932,7697,161,96,65,May-19,0,1,1
8933,user_8933,7051,131,44,87,Apr-19,1,1,0
8934,user_8934,31,4,4,0,Oct-18,7,0,0
8935,user_8935,2255,43,33,10,May-19,0,1,1
8936,user_8936,136,11,11,0,Oct-18,7,0,0
8937,user_8937,3783,88,48,40,Feb-19,3,0,0
8938,user_8938,17181,193,106,87,May-19,0,1,1
8939,user_8939,13675,403,208,195,May-19,0,1,1
8940,user_8940,1128,99,54,45,May-19,0,1,1
8941,user_8941,4685,221,125,96,May-19,0,1,1
8942,user_8942,44522,186,7,179,May-19,0,1,1
8943,user_8943,4327,272,150,122,May-19,0,1,1
8944,user_8944,4540,31,31,0,Dec-18,5,0,0
8945,user_8945,888,34,5,29,Jan-19,4,0,0
8946,user_8946,1744,29,25,4,Mar-19,2,0,0
8947,user_8947,11,2,2,0,Aug-18,9,0,0
8948,user_8948,33507,152,7,145,May-19,0,1,1
8949,user_8949,4247,151,25,126,May-19,0,1,1
8951,user_8951,33,7,7,0,Aug-18,9,0,0
8952,user_8952,921,100,53,47,Mar-19,2,0,0
8953,user_8953,43,5,5,0,Jul-18,10,0,0
8954,user_8954,2396,46,43,3,Mar-19,2,0,0
8955,user_8955,3087,69,64,5,Feb-19,3,0,0
8956,user_8956,7188,45,17,28,May-19,0,1,1
8957,user_8957,869673,598,546,52,May-19,0,1,1
8958,user_8958,4744,332,53,279,May-19,0,1,1
8959,user_8959,7271,282,249,33,May-19,0,1,1
8960,user_8960,37547,114,60,54,Apr-19,1,1,0
8961,user_8961,3680,76,63,13,May-19,0,1,1
8962,user_8962,10,3,3,0,Aug-18,9,0,0
8963,user_8963,4110,74,45,29,Apr-19,1,1,0
8964,user_8964,1374,27,27,0,Nov-18,6,0,0
8965,user_8965,23378,1659,736,923,May-19,0,1,1
8966,user_8966,7699,79,79,0,Dec-18,5,0,0
8967,user_8967,15027,782,505,277,May-19,0,1,1
8968,user_8968,1907,51,51,0,Oct-18,7,0,0
8969,user_8969,5187,85,73,12,Apr-19,1,1,0
8970,user_8970,8917,182,83,99,May-19,0,0,1
8971,user_8971,498,47,31,16,Mar-19,2,0,0
8972,user_8972,24888,246,134,112,May-19,0,1,1
8973,user_8973,891,27,18,9,Apr-19,1,1,0
8974,user_8974,16278,174,107,67,Apr-19,1,1,0
8975,user_8975,663,7,7,0,Jul-18,10,0,0
8976,user_8976,9,5,5,0,Nov-18,6,0,0
8977,user_8977,10,1,1,0,Jul-18,10,0,0
8978,user_8978,1522,86,37,49,May-19,0,1,1
8979,user_8979,7861,58,23,35,May-19,0,1,1
8980,user_8980,6842,254,0,254,May-19,0,1,1
8981,user_8981,3133,49,49,0,Oct-18,7,0,0
8982,user_8982,5154,134,63,71,May-19,0,1,1
8983,user_8983,2451,82,42,40,May-19,0,1,1
8984,user_8984,1051,13,8,5,Mar-19,2,0,0
8985,user_8985,27896,107,60,47,May-19,0,0,1
8986,user_8986,1474,108,53,55,May-19,0,1,1
8987,user_8987,2399,133,96,37,May-19,0,1,1
8988,user_8988,501,33,33,0,Nov-18,6,0,0
8989,user_8989,201,35,13,22,May-19,0,0,1
8990,user_8990,18,3,3,0,Jul-18,10,0,0
8991,user_8991,495,90,56,34,May-19,0,1,1
8992,user_8992,579,48,12,36,May-19,0,0,1
8993,user_8993,1,1,1,0,Dec-18,5,0,0
8994,user_8994,1275,156,115,41,Apr-19,1,1,0
8995,user_8995,10,3,3,0,Sep-18,8,0,0
8996,user_8996,25814,483,229,254,May-19,0,1,1
8997,user_8997,2345,59,17,42,May-19,0,1,1
8998,user_8998,2740,138,73,65,May-19,0,1,1
8999,user_8999,5061,108,71,37,May-19,0,0,1
9000,user_9000,2289,164,121,43,Apr-19,1,1,0
9001,user_9001,13137,998,475,523,May-19,0,1,1
9002,user_9002,8597,128,12,116,May-19,0,1,1
9003,user_9003,11868,261,80,181,May-19,0,1,1
9004,user_9004,30202,22,22,0,Oct-18,7,0,0
9005,user_9005,15233,335,267,68,May-19,0,1,1
9006,user_9006,4869,44,27,17,Mar-19,2,0,0
9007,user_9007,4204,135,53,82,May-19,0,1,1
9008,user_9008,8,8,8,0,Sep-18,8,0,0
9009,user_9009,24549,197,80,117,Apr-19,1,1,0
9010,user_9010,511,5,5,0,Sep-18,8,0,0
9011,user_9011,8671,110,76,34,May-19,0,1,1
9012,user_9012,27906,412,236,176,May-19,0,1,1
9013,user_9013,5385,102,50,52,Apr-19,1,1,0
9014,user_9014,56,6,5,1,Mar-19,2,0,0
9015,user_9015,1695,171,48,123,May-19,0,1,1
9016,user_9016,457,10,10,0,Aug-18,9,0,0
9017,user_9017,4437,443,309,134,May-19,0,1,1
9018,user_9018,18335,68,63,5,May-19,0,1,1
9019,user_9019,1618,21,21,0,Aug-18,9,0,0
9020,user_9020,2121,56,29,27,Apr-19,1,1,0
9021,user_9021,2615,136,32,104,May-19,0,1,1
9022,user_9022,7696,42,37,5,Apr-19,1,1,0
9024,user_9024,8162,68,15,53,May-19,0,1,1
9025,user_9025,1225,71,71,0,Dec-18,5,0,0
9026,user_9026,4702,385,264,121,May-19,0,1,1
9027,user_9027,559,7,7,0,Aug-18,9,0,0
9028,user_9028,4774,69,3,66,May-19,0,1,1
9029,user_9029,100955,146,73,73,May-19,0,1,1
9030,user_9030,16139,10,10,0,Jul-18,10,0,0
9031,user_9031,11,2,2,0,Jul-18,10,0,0
9032,user_9032,2841,57,42,15,Apr-19,1,1,0
9033,user_9033,4675,51,51,0,Sep-18,8,0,0
9034,user_9034,5243,127,53,74,May-19,0,1,1
9035,user_9035,452,20,9,11,May-19,0,1,1
9036,user_9036,1172,107,56,51,May-19,0,1,1
9037,user_9037,170,2,2,0,Dec-18,5,0,0
9038,user_9038,17583,34,19,15,May-19,0,1,1
9039,user_9039,1291,33,32,1,Mar-19,2,0,0
9040,user_9040,101,3,3,0,Aug-18,9,0,0
9041,user_9041,60426,275,107,168,May-19,0,1,1
9042,user_9042,1148,53,34,19,May-19,0,1,1
9043,user_9043,621,15,15,0,Aug-18,9,0,0
9044,user_9044,29221,71,58,13,Apr-19,1,1,0
9045,user_9045,22076,289,200,89,May-19,0,1,1
9046,user_9046,1359,38,35,3,Apr-19,1,1,0
9047,user_9047,236,13,0,13,May-19,0,1,1
9048,user_9048,6432,95,52,43,Apr-19,1,1,0
9049,user_9049,63,3,3,0,Jul-18,10,0,0
9050,user_9050,20787,256,120,136,May-19,0,1,1
9051,user_9051,2967,46,46,0,Aug-18,9,0,0
9052,user_9052,718,13,13,0,Nov-18,6,0,0
9053,user_9053,13,15,15,0,Jul-18,10,0,0
9054,user_9054,1742,100,30,70,May-19,0,1,1
9055,user_9055,2256,36,30,6,Apr-19,1,1,0
9056,user_9056,13403,238,124,114,May-19,0,1,1
9057,user_9057,631,25,25,0,Dec-18,5,0,0
9058,user_9058,1980,42,31,11,Mar-19,2,0,0
9059,user_9059,39839,47,13,34,Apr-19,1,1,0
9060,user_9060,14026,70,20,50,May-19,0,1,1
9061,user_9061,117,11,4,7,May-19,0,0,1
9062,user_9062,5848,75,45,30,Feb-19,3,0,0
9063,user_9063,2047,53,28,25,Mar-19,2,0,0
9064,user_9064,6978,92,61,31,May-19,0,1,1
9065,user_9065,6974,102,51,51,May-19,0,1,1
9066,user_9066,7872,119,36,83,Apr-19,1,1,0
9067,user_9067,27998,341,106,235,May-19,0,1,1
9068,user_9068,8319,335,327,8,Apr-19,1,1,0
9070,user_9070,14164,1045,518,527,May-19,0,1,1
9071,user_9071,3319,129,39,90,May-19,0,1,1
9072,user_9072,10400,644,291,353,May-19,0,1,1
9073,user_9073,819,21,21,0,Aug-18,9,0,0
9074,user_9074,346,21,15,6,Apr-19,1,1,0
9075,user_9075,56,7,7,0,Oct-18,7,0,0
9076,user_9076,44,8,8,0,Aug-18,9,0,0
9077,user_9077,8636,247,174,73,May-19,0,1,1
9078,user_9078,4029,120,112,8,Jan-19,4,0,0
9079,user_9079,264,27,27,0,Dec-18,5,0,0
9080,user_9080,2807,119,36,83,Apr-19,1,1,0
9081,user_9081,304778,94,51,43,May-19,0,1,1
9082,user_9082,356,16,0,16,May-19,0,1,1
9083,user_9083,89,46,18,28,May-19,0,1,1
9084,user_9084,4943,78,54,24,Apr-19,1,1,0
9085,user_9085,22778,144,75,69,Apr-19,1,1,0
9086,user_9086,3819,106,70,36,May-19,0,1,1
9087,user_9087,2222,69,4,65,May-19,0,1,1
9088,user_9088,2159,200,85,115,May-19,0,1,1
9089,user_9089,12429,296,173,123,May-19,0,1,1
9090,user_9090,240,29,22,7,May-19,0,1,1
9091,user_9091,2059,71,26,45,Apr-19,1,1,0
9092,user_9092,3590,49,49,0,Oct-18,7,0,0
9093,user_9093,10750,346,125,221,May-19,0,1,1
9094,user_9094,827,71,28,43,Apr-19,1,1,0
9095,user_9095,2486,122,9,113,May-19,0,1,1
9096,user_9096,8675,145,74,71,May-19,0,1,1
9097,user_9097,9,2,2,0,Jul-18,10,0,0
9098,user_9098,9602,98,73,25,May-19,0,1,1
9099,user_9099,16872,1035,710,325,May-19,0,1,1
9100,user_9100,4520,227,221,6,Mar-19,2,0,0
9101,user_9101,2571,44,44,0,Dec-18,5,0,0
9102,user_9102,34555,366,198,168,May-19,0,1,1
9103,user_9103,7379,259,88,171,May-19,0,1,1
9104,user_9104,6989,78,37,41,May-19,0,1,1
9105,user_9105,2736,134,82,52,Apr-19,1,1,0
9106,user_9106,18501,490,261,229,May-19,0,1,1
9107,user_9107,243,28,12,16,Apr-19,1,1,0
9108,user_9108,30056,72,29,43,Apr-19,1,1,0
9109,user_9109,41,7,0,7,Mar-19,2,0,0
9110,user_9110,21169,226,134,92,Apr-19,1,1,0
9111,user_9111,31426,175,139,36,Mar-19,2,0,0
9112,user_9112,7412,61,3,58,May-19,0,1,1
9113,user_9113,5254,76,50,26,May-19,0,0,1
9114,user_9114,5036,25,25,0,Dec-18,5,0,0
9115,user_9115,100,2,2,0,Jul-18,10,0,0
9116,user_9116,6754,325,157,168,May-19,0,1,1
9117,user_9117,1452,85,42,43,Apr-19,1,1,0
9118,user_9118,2940,48,48,0,Aug-18,9,0,0
9119,user_9119,6412,286,174,112,May-19,0,1,1
9120,user_9120,33,4,4,0,Jul-18,10,0,0
9121,user_9121,30,3,3,0,Sep-18,8,0,0
9123,user_9123,4097,89,87,2,Feb-19,3,0,0
9124,user_9124,19068,38,14,24,Apr-19,1,1,0
9125,user_9125,887,14,14,0,Aug-18,9,0,0
9126,user_9126,237,15,15,0,Dec-18,5,0,0
9127,user_9127,7585,226,144,82,May-19,0,1,1
9128,user_9128,3396,102,64,38,Apr-19,1,1,0
9129,user_9129,8315,105,40,65,May-19,0,1,1
9130,user_9130,6685,591,373,218,May-19,0,1,1
9131,user_9131,984,43,43,0,Dec-18,5,0,0
9133,user_9133,6293,100,68,32,Apr-19,1,1,0
9134,user_9134,3925,113,66,47,May-19,0,1,1
9135,user_9135,43134,440,283,157,May-19,0,1,1
9136,user_9136,2,2,2,0,Jul-18,10,0,0
9137,user_9137,5801,60,39,21,Mar-19,2,0,0
9138,user_9138,1238,86,40,46,May-19,0,1,1
9139,user_9139,1327,111,101,10,Apr-19,1,1,0
9140,user_9140,5240,138,61,77,Apr-19,1,1,0
9141,user_9141,433,8,8,0,Aug-18,9,0,0
9142,user_9142,13622,337,123,214,May-19,0,1,1
9143,user_9143,12582,164,99,65,May-19,0,1,1
9144,user_9144,25525,245,137,108,May-19,0,1,1
9145,user_9145,19558,145,71,74,May-19,0,1,1
9146,user_9146,9812,444,152,292,May-19,0,1,1
9147,user_9147,26488,814,271,543,May-19,0,1,1
9148,user_9148,10559,90,65,25,May-19,0,1,1
9149,user_9149,21,3,3,0,Aug-18,9,0,0
9150,user_9150,4264,22,22,0,Oct-18,7,0,0
9151,user_9151,2984,21,17,4,Apr-19,1,1,0
9152,user_9152,137166,2129,894,1235,May-19,0,1,1
9154,user_9154,6940,146,129,17,Apr-19,1,1,0
9155,user_9155,69,3,3,0,Jul-18,10,0,0
9156,user_9156,622,11,11,0,Aug-18,9,0,0
9157,user_9157,19438,72,68,4,Apr-19,1,1,0
9158,user_9158,15966,737,540,197,May-19,0,1,1
9159,user_9159,3686,142,78,64,May-19,0,1,1
9160,user_9160,7239,34,9,25,May-19,0,1,1
9161,user_9161,1622,28,10,18,May-19,0,1,1
9162,user_9162,192,11,9,2,Jan-19,4,0,0
9163,user_9163,1560,11,11,0,Nov-18,6,0,0
9164,user_9164,27113,1320,712,608,May-19,0,1,1
9165,user_9165,102604,50,28,22,Apr-19,1,1,0
9166,user_9166,2544,87,50,37,May-19,0,1,1
9167,user_9167,11531,12,9,3,Jan-19,4,0,0
9168,user_9168,21,3,3,0,Jul-18,10,0,0
9169,user_9169,22064,293,179,114,Apr-19,1,1,0
9170,user_9170,31441,342,114,228,May-19,0,1,1
9171,user_9171,4566,58,58,0,Dec-18,5,0,0
9172,user_9172,10350,128,123,5,Apr-19,1,1,0
9173,user_9173,4790,233,93,140,May-19,0,1,1
9174,user_9174,1422,97,97,0,Aug-18,9,0,0
9175,user_9175,1317,23,9,14,Apr-19,1,1,0
9176,user_9176,19599,671,270,401,May-19,0,1,1
9177,user_9177,1668,95,90,5,Apr-19,1,1,0
9178,user_9178,66361,1262,520,742,May-19,0,1,1
9179,user_9179,125,4,4,0,Aug-18,9,0,0
9180,user_9180,712,30,13,17,Apr-19,1,1,0
9181,user_9181,25591,1213,509,704,May-19,0,1,1
9182,user_9182,1444,14,9,5,Apr-19,1,1,0
9183,user_9183,932,29,22,7,Mar-19,2,0,0
9184,user_9184,485,20,15,5,May-19,0,0,1
9185,user_9185,22058,116,52,64,May-19,0,1,1
9186,user_9186,8806,75,52,23,May-19,0,1,1
9187,user_9187,3091,201,89,112,May-19,0,1,1
9188,user_9188,8937,156,138,18,Feb-19,3,0,0
9189,user_9189,3957,45,40,5,Apr-19,1,1,0
9190,user_9190,542,18,18,0,Aug-18,9,0,0
9191,user_9191,16,3,3,0,Jul-18,10,0,0
9192,user_9192,7640,321,201,120,May-19,0,1,1
9193,user_9193,17,4,4,0,Jul-18,10,0,0
9194,user_9194,3827,200,161,39,May-19,0,1,1
9195,user_9195,3136,94,35,59,May-19,0,1,1
9196,user_9196,4767,127,127,0,Oct-18,7,0,0
9197,user_9197,18474,345,213,132,May-19,0,1,1
9198,user_9198,212,9,9,0,Aug-18,9,0,0
9199,user_9199,38831,361,255,106,Mar-19,2,0,0
9200,user_9200,34647,552,402,150,May-19,0,1,1
9201,user_9201,25895,153,80,73,May-19,0,1,1
9202,user_9202,121,15,15,0,Oct-18,7,0,0
9205,user_9205,72,12,6,6,Jan-19,4,0,0
9206,user_9206,2728,118,76,42,May-19,0,1,1
9207,user_9207,20319,364,134,230,May-19,0,1,1
9208,user_9208,13583,132,65,67,May-19,0,1,1
9209,user_9209,2410,153,22,131,May-19,0,1,1
9210,user_9210,450,38,38,0,Nov-18,6,0,0
9211,user_9211,9791,182,139,43,May-19,0,1,1
9212,user_9212,4033,57,42,15,Apr-19,1,1,0
9213,user_9213,8547,17,10,7,May-19,0,1,1
9214,user_9214,5340,295,58,237,May-19,0,1,1
9215,user_9215,5649,181,107,74,May-19,0,1,1
9216,user_9216,50980,147,33,114,May-19,0,1,1
9217,user_9217,498,13,4,9,May-19,0,1,1
9218,user_9218,16980,57,9,48,May-19,0,1,1
9219,user_9219,6511,124,124,0,Oct-18,7,0,0
9220,user_9220,5795,86,28,58,May-19,0,1,1
9221,user_9221,4179,104,68,36,May-19,0,1,1
9222,user_9222,21447,990,564,426,May-19,0,1,1
9223,user_9223,15364,1480,679,801,May-19,0,1,1
9224,user_9224,372,6,4,2,Apr-19,1,1,0
9225,user_9225,7737,81,44,37,May-19,0,1,1
9226,user_9226,372,9,9,0,Aug-18,9,0,0
9227,user_9227,19,9,9,0,Oct-18,7,0,0
9228,user_9228,7393,140,96,44,May-19,0,1,1
9229,user_9229,511,4,4,0,Oct-18,7,0,0
9230,user_9230,26421,131,49,82,May-19,0,1,1
9231,user_9231,18302,290,280,10,Feb-19,3,0,0
9232,user_9232,1594,53,53,0,Oct-18,7,0,0
9233,user_9233,1035,20,9,11,Mar-19,2,0,0
9234,user_9234,2656,140,106,34,May-19,0,1,1
9235,user_9235,6,3,3,0,Jul-18,10,0,0
9236,user_9236,18666,180,82,98,May-19,0,1,1
9237,user_9237,2609,31,26,5,Apr-19,1,1,0
9238,user_9238,1857,48,30,18,May-19,0,1,1
9239,user_9239,24382,129,9,120,May-19,0,1,1
9240,user_9240,5201,226,119,107,May-19,0,1,1
9241,user_9241,12610,332,188,144,May-19,0,1,1
9242,user_9242,1534,10,10,0,Jul-18,10,0,0
9243,user_9243,10413,470,285,185,May-19,0,1,1
9244,user_9244,6,2,2,0,Aug-18,9,0,0
9245,user_9245,761,13,13,0,Aug-18,9,0,0
9246,user_9246,1878,101,82,19,May-19,0,0,1
9247,user_9247,11278,171,152,19,Jan-19,4,0,0
9248,user_9248,2548,63,63,0,Nov-18,6,0,0
9249,user_9249,154,25,18,7,May-19,0,1,1
9250,user_9250,136774,244,204,40,May-19,0,1,1
9251,user_9251,1394,60,60,0,Nov-18,6,0,0
9252,user_9252,1539,26,3,23,May-19,0,1,1
9253,user_9253,709,93,16,77,May-19,0,1,1
9254,user_9254,4266,156,122,34,Apr-19,1,1,0
9255,user_9255,859,50,19,31,Apr-19,1,1,0
9256,user_9256,479,53,30,23,Apr-19,1,1,0
9257,user_9257,2670,103,39,64,May-19,0,1,1
9258,user_9258,2301,36,3,33,May-19,0,1,1
9260,user_9260,14,24,24,0,Aug-18,9,0,0
9261,user_9261,3942,64,46,18,Apr-19,1,1,0
9262,user_9262,577,73,52,21,Apr-19,1,1,0
9263,user_9263,6021,505,176,329,May-19,0,1,1
9264,user_9264,3345,108,95,13,Apr-19,1,1,0
9265,user_9265,3277,71,41,30,May-19,0,1,1
9266,user_9266,19651,968,466,502,May-19,0,1,1
9267,user_9267,1748,22,9,13,Apr-19,1,1,0
9268,user_9268,9,2,2,0,Jul-18,10,0,0
9269,user_9269,2919,29,26,3,Feb-19,3,0,0
9270,user_9270,4756,31,14,17,Mar-19,2,0,0
9271,user_9271,1657,200,22,178,May-19,0,1,1
9272,user_9272,11873,370,301,69,Apr-19,1,1,0
9273,user_9273,20988,690,325,365,May-19,0,1,1
9274,user_9274,9,2,2,0,Jul-18,10,0,0
9275,user_9275,55500,1871,795,1076,May-19,0,1,1
9276,user_9276,2496,109,14,95,May-19,0,1,1
9277,user_9277,10,4,4,0,Jul-18,10,0,0
9278,user_9278,2262,66,66,0,Dec-18,5,0,0
9279,user_9279,3003,76,38,38,May-19,0,1,1
9280,user_9280,18654,75,38,37,May-19,0,1,1
9281,user_9281,5914,40,26,14,Mar-19,2,0,0
9282,user_9282,9232,163,84,79,May-19,0,1,1
9283,user_9283,16,3,3,0,Jul-18,10,0,0
9284,user_9284,482,44,12,32,May-19,0,1,1
9285,user_9285,2803,35,11,24,May-19,0,1,1
9286,user_9286,5225,279,132,147,Apr-19,1,1,0
9287,user_9287,1839,61,4,57,Apr-19,1,1,0
9288,user_9288,3228,34,33,1,Jan-19,4,0,0
9289,user_9289,20898,464,233,231,May-19,0,1,1
9290,user_9290,6604,83,62,21,May-19,0,1,1
9291,user_9291,12017,361,129,232,May-19,0,1,1
9292,user_9292,7152,385,179,206,May-19,0,1,1
9293,user_9293,1122,47,37,10,Apr-19,1,1,0
9294,user_9294,6687,113,39,74,May-19,0,1,1
9295,user_9295,4654,132,80,52,May-19,0,1,1
9296,user_9296,1250,40,11,29,May-19,0,1,1
9297,user_9297,1039,20,20,0,Oct-18,7,0,0
9298,user_9298,2252,143,0,143,May-19,0,1,1
9299,user_9299,22800,164,138,26,Feb-19,3,0,0
9300,user_9300,3529,117,32,85,May-19,0,1,1
9301,user_9301,1420,60,49,11,May-19,0,1,1
9302,user_9302,4086,189,92,97,May-19,0,1,1
9303,user_9303,70,11,10,1,Jan-19,4,0,0
9304,user_9304,44189,413,181,232,May-19,0,1,1
9305,user_9305,10588,27,25,2,Jan-19,4,0,0
9306,user_9306,5794,171,145,26,May-19,0,0,1
9307,user_9307,9745,135,134,1,Feb-19,3,0,0
9308,user_9308,9720,250,155,95,May-19,0,1,1
9309,user_9309,2224,67,67,0,Sep-18,8,0,0
9310,user_9310,2794,27,15,12,May-19,0,0,1
9311,user_9311,1396,41,36,5,Jan-19,4,0,0
9312,user_9312,13240,188,159,29,May-19,0,1,1
9313,user_9313,5532,167,85,82,May-19,0,1,1
9314,user_9314,20,2,2,0,Jul-18,10,0,0
9315,user_9315,2247,187,70,117,May-19,0,1,1
9316,user_9316,560,59,29,30,May-19,0,1,1
9317,user_9317,599,19,12,7,May-19,0,1,1
9318,user_9318,12743,123,77,46,Apr-19,1,1,0
9319,user_9319,30,3,3,0,Nov-18,6,0,0
9320,user_9320,45929,1218,520,698,May-19,0,1,1
9321,user_9321,244,9,7,2,Feb-19,3,0,0
9322,user_9322,105,11,8,3,May-19,0,1,1
9323,user_9323,2309,99,68,31,Feb-19,3,0,0
9324,user_9324,3507,320,127,193,May-19,0,1,1
9325,user_9325,4320,330,75,255,May-19,0,1,1
9326,user_9326,1897,49,33,16,Apr-19,1,1,0
9327,user_9327,21,3,2,1,Mar-19,2,0,0
9328,user_9328,3943,72,65,7,May-19,0,0,1
9329,user_9329,3819,17,17,0,Aug-18,9,0,0
9330,user_9330,8682,587,284,303,May-19,0,1,1
9331,user_9331,6355,52,45,7,May-19,0,0,1
9332,user_9332,7348,710,391,319,May-19,0,1,1
9333,user_9333,349,77,49,28,May-19,0,1,1
9334,user_9334,10146,353,333,20,May-19,0,1,1
9335,user_9335,9,2,2,0,Jul-18,10,0,0
9336,user_9336,2227,92,77,15,Apr-19,1,1,0
9337,user_9337,6623,135,57,78,May-19,0,1,1
9338,user_9338,1062,34,34,0,Dec-18,5,0,0
9339,user_9339,4494,149,64,85,Apr-19,1,1,0
9340,user_9340,1744,97,34,63,May-19,0,1,1
9341,user_9341,30175,432,258,174,May-19,0,1,1
9342,user_9342,3590,66,51,15,May-19,0,1,1
9343,user_9343,76208,797,283,514,May-19,0,1,1
9345,user_9345,18153,319,118,201,May-19,0,1,1
9346,user_9346,870,53,22,31,May-19,0,1,1
9347,user_9347,998,20,20,0,Aug-18,9,0,0
9348,user_9348,5047,35,23,12,May-19,0,1,1
9349,user_9349,55,5,4,1,Jan-19,4,0,0
9350,user_9350,2731,79,55,24,May-19,0,1,1
9351,user_9351,986,14,14,0,Aug-18,9,0,0
9352,user_9352,1399,21,21,0,Sep-18,8,0,0
9353,user_9353,11699,273,111,162,May-19,0,1,1
9354,user_9354,1588,57,34,23,Mar-19,2,0,0
9355,user_9355,5516,65,0,65,May-19,0,1,1
9356,user_9356,733,48,48,0,Nov-18,6,0,0
9358,user_9358,0,1,1,0,Jul-18,10,0,0
9359,user_9359,23,3,3,0,Jul-18,10,0,0
9360,user_9360,30638,1432,768,664,May-19,0,1,1
9361,user_9361,37547,146,29,117,May-19,0,1,1
9362,user_9362,13,3,3,0,Jul-18,10,0,0
9363,user_9363,9685,118,87,31,Apr-19,1,1,0
9364,user_9364,502,28,14,14,Apr-19,1,1,0
9365,user_9365,10658,938,442,496,May-19,0,1,1
9366,user_9366,5796,175,105,70,May-19,0,1,1
9367,user_9367,254,15,15,0,Nov-18,6,0,0
9368,user_9368,4897,171,73,98,May-19,0,1,1
9369,user_9369,14882,323,140,183,May-19,0,1,1
9370,user_9370,2118,58,58,0,Sep-18,8,0,0
9371,user_9371,3294,19,16,3,Jan-19,4,0,0
9372,user_9372,735,36,36,0,Dec-18,5,0,0
9373,user_9373,47809,66,21,45,May-19,0,1,1
9374,user_9374,2081,73,47,26,Apr-19,1,1,0
9375,user_9375,40451,666,524,142,May-19,0,1,1
9376,user_9376,1260,69,43,26,Apr-19,1,1,0
9377,user_9377,105,8,8,0,Jul-18,10,0,0
9378,user_9378,4702,226,114,112,May-19,0,1,1
9379,user_9379,3400,89,89,0,Aug-18,9,0,0
9380,user_9380,5677,672,356,316,May-19,0,1,1
9381,user_9381,2328,47,16,31,May-19,0,1,1
9382,user_9382,14183,217,138,79,May-19,0,1,1
9383,user_9383,10,3,3,0,Nov-18,6,0,0
9384,user_9384,25,6,6,0,Jul-18,10,0,0
9385,user_9385,12148,113,93,20,May-19,0,1,1
9386,user_9386,9872,285,164,121,May-19,0,1,1
9387,user_9387,6297,151,129,22,May-19,0,1,1
9388,user_9388,674,18,15,3,May-19,0,0,1
9389,user_9389,17402,810,361,449,May-19,0,1,1
9390,user_9390,2047,45,42,3,Apr-19,1,1,0
9391,user_9391,5707,87,70,17,Jan-19,4,0,0
9392,user_9392,82,14,10,4,Apr-19,1,1,0
9393,user_9393,1560,49,6,43,Apr-19,1,1,0
9394,user_9394,2357,77,54,23,Apr-19,1,1,0
9395,user_9395,4430,337,121,216,May-19,0,1,1
9396,user_9396,29748,352,146,206,May-19,0,1,1
9397,user_9397,15773,211,194,17,Apr-19,1,1,0
9398,user_9398,31764,1040,473,567,May-19,0,1,1
9399,user_9399,94,16,16,0,Jul-18,10,0,0
9400,user_9400,20,6,6,0,Jul-18,10,0,0
9401,user_9401,275,9,9,0,Nov-18,6,0,0
9402,user_9402,6781,87,76,11,Apr-19,1,1,0
9403,user_9403,3634,41,41,0,Sep-18,8,0,0
9404,user_9404,1713,91,47,44,May-19,0,1,1
9405,user_9405,26983,247,183,64,Apr-19,1,1,0
9406,user_9406,3600,96,96,0,Aug-18,9,0,0
9407,user_9407,357,39,39,0,Aug-18,9,0,0
9408,user_9408,1415,155,120,35,Apr-19,1,1,0
9409,user_9409,909,124,62,62,May-19,0,1,1
9410,user_9410,31979,213,131,82,Apr-19,1,1,0
9411,user_9411,676,41,27,14,May-19,0,1,1
9412,user_9412,6593,143,101,42,May-19,0,1,1
9413,user_9413,4268,272,137,135,May-19,0,1,1
9414,user_9414,10232,163,50,113,May-19,0,1,1
9415,user_9415,58,9,3,6,Apr-19,1,1,0
9416,user_9416,8006,710,197,513,May-19,0,1,1
9417,user_9417,4704,170,20,150,May-19,0,1,1
9418,user_9418,708,38,26,12,Apr-19,1,1,0
9419,user_9419,1224,20,20,0,Oct-18,7,0,0
9420,user_9420,18823,350,230,120,May-19,0,1,1
9421,user_9421,3957,115,107,8,Apr-19,1,1,0
9422,user_9422,6318,87,45,42,May-19,0,1,1
9423,user_9423,2163,27,27,0,Aug-18,9,0,0
9424,user_9424,8837,96,87,9,Feb-19,3,0,0
9425,user_9425,682,11,11,0,Sep-18,8,0,0
9426,user_9426,543,26,0,26,Feb-19,3,0,0
9427,user_9427,3519,266,146,120,May-19,0,1,1
9428,user_9428,5322,159,109,50,May-19,0,1,1
9429,user_9429,4164,32,32,0,Oct-18,7,0,0
9430,user_9430,87,4,4,0,Jul-18,10,0,0
9431,user_9431,48022,105,85,20,May-19,0,0,1
9432,user_9432,54336,119,59,60,May-19,0,1,1
9433,user_9433,314,25,3,22,Apr-19,1,1,0
9435,user_9435,7889,399,215,184,May-19,0,1,1
9436,user_9436,2457,21,21,0,Sep-18,8,0,0
9437,user_9437,24642,671,454,217,May-19,0,1,1
9438,user_9438,76,13,10,3,Apr-19,1,1,0
9439,user_9439,1551,80,60,20,Apr-19,1,1,0
9440,user_9440,5158,125,77,48,May-19,0,1,1
9441,user_9441,2174,84,44,40,May-19,0,1,1
9442,user_9442,106,14,14,0,Nov-18,6,0,0
9443,user_9443,1303,46,39,7,May-19,0,1,1
9444,user_9444,6923,109,34,75,Mar-19,2,0,0
9445,user_9445,4648,99,86,13,Apr-19,1,1,0
9446,user_9446,12528,283,238,45,Feb-19,3,0,0
9447,user_9447,9,2,2,0,Jul-18,10,0,0
9448,user_9448,5487,294,178,116,May-19,0,1,1
9449,user_9449,14619,574,264,310,May-19,0,1,1
9450,user_9450,263,19,3,16,Apr-19,1,1,0
9451,user_9451,4910,84,54,30,Mar-19,2,0,0
9452,user_9452,87747,184,179,5,May-19,0,1,1
9453,user_9453,13597,171,106,65,Apr-19,1,1,0
9454,user_9454,278,19,6,13,Apr-19,1,1,0
9455,user_9455,849,20,0,20,Mar-19,2,0,0
9456,user_9456,194,9,7,2,Apr-19,1,1,0
9457,user_9457,12091,242,128,114,May-19,0,1,1
9458,user_9458,3477,168,7,161,May-19,0,1,1
9459,user_9459,17542,18,14,4,Feb-19,3,0,0
9460,user_9460,9119,50,40,10,Feb-19,3,0,0
9461,user_9461,1327,50,39,11,Apr-19,1,1,0
9462,user_9462,4097,159,128,31,Apr-19,1,1,0
9463,user_9463,1236,17,2,15,May-19,0,0,1
9464,user_9464,12225,241,74,167,May-19,0,1,1
9465,user_9465,2910,12,10,2,Jan-19,4,0,0
9466,user_9466,11841,268,68,200,May-19,0,1,1
9467,user_9467,100,5,3,2,Apr-19,1,1,0
9468,user_9468,932,38,25,13,Mar-19,2,0,0
9469,user_9469,1956,260,126,134,May-19,0,1,1
9471,user_9471,5176,64,64,0,Oct-18,7,0,0
9473,user_9473,10436,119,104,15,May-19,0,1,1
9474,user_9474,6514,218,180,38,May-19,0,1,1
9476,user_9476,12040,91,88,3,May-19,0,1,1
9477,user_9477,12212,17,9,8,Mar-19,2,0,0
9478,user_9478,1583,20,20,0,Jul-18,10,0,0
9479,user_9479,6738,81,62,19,May-19,0,1,1
9480,user_9480,26,4,4,0,Jul-18,10,0,0
9481,user_9481,221,26,23,3,Mar-19,2,0,0
9482,user_9482,15825,75,59,16,Apr-19,1,1,0
9483,user_9483,13,4,4,0,Jul-18,10,0,0
9484,user_9484,15613,123,62,61,May-19,0,1,1
9485,user_9485,12176,266,90,176,Apr-19,1,1,0
9486,user_9486,4795,70,21,49,May-19,0,1,1
9487,user_9487,33065,461,313,148,May-19,0,1,1
9488,user_9488,447,8,8,0,Jul-18,10,0,0
9489,user_9489,427,40,10,30,May-19,0,1,1
9490,user_9490,3641,52,52,0,Dec-18,5,0,0
9491,user_9491,25,5,5,0,Jul-18,10,0,0
9492,user_9492,53094,496,245,251,May-19,0,1,1
9493,user_9493,11201,20,17,3,Feb-19,3,0,0
9494,user_9494,173,18,5,13,Apr-19,1,1,0
9495,user_9495,83,14,2,12,May-19,0,1,1
9496,user_9496,4397,61,56,5,May-19,0,0,1
9497,user_9497,14966,416,416,0,Nov-18,6,0,0
9498,user_9498,3038,49,2,47,May-19,0,1,1
9499,user_9499,18935,308,212,96,May-19,0,1,1
9500,user_9500,18642,202,118,84,May-19,0,1,1
9501,user_9501,2030,56,56,0,Dec-18,5,0,0
9502,user_9502,473,26,15,11,Apr-19,1,1,0
9503,user_9503,99,8,7,1,May-19,0,0,1
9504,user_9504,2357,35,32,3,Apr-19,1,1,0
9505,user_9505,125,8,8,0,Dec-18,5,0,0
9506,user_9506,174,32,6,26,May-19,0,1,1
9507,user_9507,4486,86,23,63,May-19,0,1,1
9508,user_9508,409,52,12,40,Mar-19,2,0,0
9509,user_9509,2563,11,11,0,Jul-18,10,0,0
9510,user_9510,9,2,2,0,Aug-18,9,0,0
9511,user_9511,46190,435,93,342,May-19,0,1,1
9512,user_9512,6030,161,161,0,Sep-18,8,0,0
9513,user_9513,1562,14,14,0,Aug-18,9,0,0
9514,user_9514,3791,84,29,55,Apr-19,1,1,0
9515,user_9515,6331,202,92,110,May-19,0,1,1
9516,user_9516,3335,48,32,16,May-19,0,1,1
9517,user_9517,873,65,37,28,May-19,0,1,1
9518,user_9518,5653,154,91,63,May-19,0,1,1
9519,user_9519,7857,391,223,168,May-19,0,1,1
9520,user_9520,28170,199,39,160,May-19,0,1,1
9521,user_9521,9369,222,106,116,May-19,0,1,1
9522,user_9522,863,10,3,7,Feb-19,3,0,0
9523,user_9523,543,20,20,0,Nov-18,6,0,0
9524,user_9524,1474,10,10,0,Oct-18,7,0,0
9525,user_9525,3691,102,52,50,May-19,0,1,1
9526,user_9526,3741,56,56,0,Sep-18,8,0,0
9527,user_9527,2170,131,110,21,Apr-19,1,1,0
9528,user_9528,780,84,84,0,Dec-18,5,0,0
9529,user_9529,6540,55,22,33,May-19,0,1,1
9530,user_9530,37674,690,369,321,May-19,0,1,1
9531,user_9531,7423,291,108,183,May-19,0,1,1
9532,user_9532,232,44,3,41,May-19,0,1,1
9533,user_9533,82237,1222,121,1101,May-19,0,1,1
9534,user_9534,295,7,7,0,Dec-18,5,0,0
9536,user_9536,8693,449,269,180,May-19,0,1,1
9537,user_9537,1511,17,17,0,Sep-18,8,0,0
9539,user_9539,3252,64,58,6,Mar-19,2,0,0
9540,user_9540,3739,109,95,14,May-19,0,1,1
9541,user_9541,3976,76,58,18,May-19,0,0,1
9542,user_9542,2960,62,36,26,Apr-19,1,1,0
9543,user_9543,28939,314,127,187,May-19,0,1,1
9544,user_9544,174,11,8,3,Apr-19,1,1,0
9545,user_9545,1594,99,50,49,May-19,0,1,1
9546,user_9546,3798,441,233,208,May-19,0,1,1
9547,user_9547,4114,205,90,115,May-19,0,1,1
9548,user_9548,16,3,3,0,Jul-18,10,0,0
9549,user_9549,7688,56,27,29,Apr-19,1,1,0
9550,user_9550,14329,32,31,1,Jan-19,4,0,0
9552,user_9552,9316,375,119,256,May-19,0,1,1
9553,user_9553,731,29,21,8,May-19,0,1,1
9554,user_9554,3,3,3,0,Jul-18,10,0,0
9555,user_9555,408,39,4,35,May-19,0,1,1
9556,user_9556,2935,135,59,76,Apr-19,1,1,0
9557,user_9557,29,4,4,0,Aug-18,9,0,0
9558,user_9558,14243,58,40,18,Apr-19,1,1,0
9559,user_9559,12798,395,116,279,May-19,0,1,1
9560,user_9560,35353,377,154,223,May-19,0,1,1
9561,user_9561,176,8,8,0,Jul-18,10,0,0
9562,user_9562,149,16,13,3,Feb-19,3,0,0
9563,user_9563,5545,108,36,72,May-19,0,1,1
9565,user_9565,8867,176,175,1,Jan-19,4,0,0
9566,user_9566,1508,41,41,0,Aug-18,9,0,0
9567,user_9567,21256,96,65,31,May-19,0,1,1
9568,user_9568,72,8,6,2,Feb-19,3,0,0
9569,user_9569,2903,290,3,287,May-19,0,1,1
9570,user_9570,2705,24,11,13,Apr-19,1,1,0
9571,user_9571,3223,170,0,170,May-19,0,1,1
9572,user_9572,3942,143,72,71,May-19,0,1,1
9573,user_9573,15,4,3,1,Mar-19,2,0,0
9574,user_9574,1099,13,6,7,Apr-19,1,1,0
9575,user_9575,15,2,2,0,Jul-18,10,0,0
9576,user_9576,3969,170,164,6,Apr-19,1,1,0
9577,user_9577,9201,124,78,46,May-19,0,1,1
9578,user_9578,964627,948,252,696,May-19,0,1,1
9579,user_9579,5840,336,69,267,May-19,0,1,1
9580,user_9580,3227,18,7,11,Apr-19,1,1,0
9581,user_9581,2173,120,41,79,May-19,0,1,1
9582,user_9582,5845,79,18,61,May-19,0,1,1
9583,user_9583,5010,123,86,37,Apr-19,1,1,0
9584,user_9584,11062,238,237,1,Feb-19,3,0,0
9585,user_9585,6681,228,4,224,May-19,0,1,1
9586,user_9586,11167,326,143,183,May-19,0,1,1
9587,user_9587,11,2,2,0,Jul-18,10,0,0
9588,user_9588,565,19,16,3,Apr-19,1,1,0
9589,user_9589,50,7,7,0,Oct-18,7,0,0
9590,user_9590,17254,145,62,83,Apr-19,1,1,0
9591,user_9591,350,14,14,0,Aug-18,9,0,0
9592,user_9592,972,37,34,3,Apr-19,1,1,0
9593,user_9593,628,48,48,0,Dec-18,5,0,0
9594,user_9594,5489,326,157,169,May-19,0,1,1
9595,user_9595,335,26,3,23,Apr-19,1,1,0
9596,user_9596,742,49,30,19,May-19,0,1,1
9597,user_9597,2865,90,60,30,Apr-19,1,1,0
9598,user_9598,1098,37,37,0,Dec-18,5,0,0
9599,user_9599,3574,105,25,80,Apr-19,1,1,0
9600,user_9600,371,28,28,0,Dec-18,5,0,0
9601,user_9601,1756,217,19,198,May-19,0,1,1
9602,user_9602,8,2,2,0,Jul-18,10,0,0
9603,user_9603,22452,222,107,115,May-19,0,1,1
9604,user_9604,6,3,3,0,Jul-18,10,0,0
9605,user_9605,1542,24,15,9,Apr-19,1,1,0
9606,user_9606,33809,456,165,291,May-19,0,1,1
9607,user_9607,1345,70,33,37,May-19,0,1,1
9608,user_9608,6984,119,71,48,Apr-19,1,1,0
9609,user_9609,11719,54,54,0,Aug-18,9,0,0
9610,user_9610,7205,567,461,106,May-19,0,1,1
9611,user_9611,38,14,14,0,Oct-18,7,0,0
9612,user_9612,1570,30,30,0,Aug-18,9,0,0
9613,user_9613,57772,765,408,357,May-19,0,1,1
9614,user_9614,1936,45,17,28,Apr-19,1,1,0
9615,user_9615,208,10,10,0,Jul-18,10,0,0
9616,user_9616,1856,54,14,40,Apr-19,1,1,0
9617,user_9617,15005,170,56,114,May-19,0,1,1
9618,user_9618,4958,370,59,311,May-19,0,1,1
9619,user_9619,4432,35,12,23,Apr-19,1,1,0
9620,user_9620,1442,30,30,0,Nov-18,6,0,0
9621,user_9621,2632,269,102,167,May-19,0,1,1
9622,user_9622,1961,30,18,12,Mar-19,2,0,0
9623,user_9623,731,35,22,13,May-19,0,0,1
9624,user_9624,10061,381,176,205,May-19,0,1,1
9625,user_9625,68,29,6,23,May-19,0,1,1
9626,user_9626,122,16,16,0,Sep-18,8,0,0
9627,user_9627,1178,69,50,19,Apr-19,1,1,0
9628,user_9628,1550,262,92,170,May-19,0,1,1
9629,user_9629,7277,229,174,55,May-19,0,1,1
9630,user_9630,4477,33,17,16,May-19,0,1,1
9631,user_9631,579,33,26,7,May-19,0,1,1
9632,user_9632,27,3,3,0,Jul-18,10,0,0
9633,user_9633,29874,961,601,360,May-19,0,1,1
9634,user_9634,9,2,2,0,Sep-18,8,0,0
9635,user_9635,4461,263,129,134,May-19,0,1,1
9636,user_9636,800,11,9,2,May-19,0,0,1
9637,user_9637,3569,199,102,97,May-19,0,1,1
9638,user_9638,3909,368,207,161,Apr-19,1,1,0
9639,user_9639,820,69,47,22,May-19,0,1,1
9640,user_9640,645,31,29,2,Apr-19,1,1,0
9642,user_9642,30,1,0,1,Jan-19,4,0,0
9643,user_9643,5425,123,74,49,May-19,0,1,1
9644,user_9644,6059,207,116,91,May-19,0,1,1
9645,user_9645,268,14,14,0,Aug-18,9,0,0
9646,user_9646,2533,205,88,117,May-19,0,1,1
9647,user_9647,13054,760,558,202,May-19,0,1,1
9648,user_9648,10,1,0,1,Mar-19,2,0,0
9649,user_9649,20,1,1,0,Sep-18,8,0,0
9650,user_9650,7729,89,23,66,May-19,0,1,1
9651,user_9651,13875,410,181,229,May-19,0,1,1
9652,user_9652,19561,1115,358,757,May-19,0,1,1
9653,user_9653,580,11,11,0,Dec-18,5,0,0
9654,user_9654,1995,11,11,0,Dec-18,5,0,0
9655,user_9655,5382,832,391,441,May-19,0,1,1
9656,user_9656,35833,1986,1028,958,May-19,0,1,1
9657,user_9657,9038,132,37,95,May-19,0,1,1
9658,user_9658,910,36,36,0,Dec-18,5,0,0
9659,user_9659,17068,215,125,90,May-19,0,1,1
9660,user_9660,17587,446,154,292,May-19,0,1,1
9661,user_9661,11075,1292,438,854,May-19,0,1,1
9662,user_9662,994,29,6,23,May-19,0,1,1
9663,user_9663,2420,207,176,31,May-19,0,0,1
9664,user_9664,655,17,8,9,Mar-19,2,0,0
9665,user_9665,327,17,17,0,Sep-18,8,0,0
9666,user_9666,20,3,3,0,Aug-18,9,0,0
9667,user_9667,2847,73,52,21,Apr-19,1,1,0
9668,user_9668,330,6,6,0,Nov-18,6,0,0
9669,user_9669,438,47,35,12,May-19,0,1,1
9670,user_9670,9,2,2,0,Jul-18,10,0,0
9671,user_9671,14,3,3,0,Aug-18,9,0,0
9672,user_9672,7439,278,77,201,May-19,0,1,1
9673,user_9673,2700,45,19,26,Apr-19,1,1,0
9674,user_9674,1542,41,26,15,May-19,0,1,1
9675,user_9675,4050,13,12,1,Mar-19,2,0,0
9676,user_9676,411,47,22,25,Apr-19,1,1,0
9677,user_9677,10080,195,70,125,May-19,0,1,1
9678,user_9678,71,17,11,6,Apr-19,1,1,0
9679,user_9679,16347,432,164,268,May-19,0,1,1
9680,user_9680,4268,61,57,4,Jan-19,4,0,0
9681,user_9681,6897,475,168,307,May-19,0,1,1
9682,user_9682,18,4,4,0,Aug-18,9,0,0
9683,user_9683,2788,132,95,37,May-19,0,1,1
9684,user_9684,969,4,4,0,Nov-18,6,0,0
9685,user_9685,86,11,10,1,Apr-19,1,1,0
9686,user_9686,977,40,40,0,Aug-18,9,0,0
9687,user_9687,5668,55,41,14,Apr-19,1,1,0
9688,user_9688,214,28,22,6,Mar-19,2,0,0
9689,user_9689,8121,114,70,44,May-19,0,1,1
9690,user_9690,8517,182,107,75,May-19,0,1,1
9691,user_9691,3854,42,30,12,Apr-19,1,1,0
9692,user_9692,6926,29,3,26,May-19,0,1,1
9693,user_9693,78833,907,424,483,May-19,0,1,1
9694,user_9694,2309,47,31,16,Mar-19,2,0,0
9695,user_9695,11,2,2,0,Jul-18,10,0,0
9696,user_9696,13563,93,44,49,May-19,0,1,1
9697,user_9697,339,24,14,10,May-19,0,1,1
9698,user_9698,34412,290,147,143,May-19,0,1,1
9699,user_9699,3157,83,65,18,May-19,0,1,1
9700,user_9700,1288,82,44,38,Mar-19,2,0,0
9701,user_9701,6727,314,110,204,May-19,0,1,1
9702,user_9702,14032,174,51,123,May-19,0,1,1
9703,user_9703,10541,391,221,170,May-19,0,1,1
9704,user_9704,5095,69,61,8,May-19,0,1,1
9705,user_9705,4429,53,28,25,May-19,0,1,1
9706,user_9706,4332,108,84,24,May-19,0,1,1
9707,user_9707,4153,210,110,100,May-19,0,1,1
9708,user_9708,8443,271,148,123,May-19,0,1,1
9709,user_9709,2986,387,151,236,May-19,0,1,1
9710,user_9710,58642,27,22,5,Mar-19,2,0,0
9711,user_9711,11080,275,88,187,May-19,0,1,1
9712,user_9712,12424,221,94,127,May-19,0,1,1
9713,user_9713,5508,171,147,24,May-19,0,1,1
9714,user_9714,30,11,5,6,Apr-19,1,1,0
9715,user_9715,2316,41,37,4,Mar-19,2,0,0
9716,user_9716,27626,316,185,131,May-19,0,1,1
9717,user_9717,6673,220,132,88,May-19,0,1,1
9718,user_9718,500,77,36,41,Mar-19,2,0,0
9719,user_9719,8559,138,77,61,May-19,0,1,1
9720,user_9720,2555,145,115,30,May-19,0,1,1
9721,user_9721,81,20,16,4,Feb-19,3,0,0
9722,user_9722,1971,119,37,82,Apr-19,1,1,0
9723,user_9723,200,2,2,0,Jul-18,10,0,0
9724,user_9724,3264,44,21,23,May-19,0,1,1
9725,user_9725,429,21,21,0,Oct-18,7,0,0
9726,user_9726,781,116,79,37,May-19,0,1,1
9727,user_9727,9003,84,72,12,Apr-19,1,1,0
9728,user_9728,64249,577,282,295,May-19,0,1,1
9729,user_9729,138,12,12,0,Dec-18,5,0,0
9730,user_9730,14,3,0,3,Jan-19,4,0,0
9731,user_9731,3377,107,13,94,May-19,0,1,1
9732,user_9732,2451,174,96,78,May-19,0,1,1
9733,user_9733,4242,67,36,31,Mar-19,2,0,0
9734,user_9734,8076,489,233,256,May-19,0,1,1
9735,user_9735,607,6,6,0,Aug-18,9,0,0
9736,user_9736,60,7,7,0,Jul-18,10,0,0
9737,user_9737,25800,898,565,333,May-19,0,1,1
9738,user_9738,511,13,13,0,Sep-18,8,0,0
9739,user_9739,142470,1232,466,766,May-19,0,1,1
9740,user_9740,15507,94,68,26,Feb-19,3,0,0
9741,user_9741,2257,35,0,35,May-19,0,1,1
9742,user_9742,171,3,3,0,Sep-18,8,0,0
9743,user_9743,997,104,70,34,May-19,0,0,1
9744,user_9744,14249,579,452,127,Feb-19,3,0,0
9745,user_9745,110,8,8,0,Sep-18,8,0,0
9746,user_9746,35662,2551,1112,1439,May-19,0,1,1
9747,user_9747,708,33,18,15,May-19,0,1,1
9748,user_9748,1508,14,14,0,Dec-18,5,0,0
9749,user_9749,1884,66,45,21,Apr-19,1,1,0
9750,user_9750,16632,553,234,319,May-19,0,1,1
9751,user_9751,555,7,5,2,May-19,0,1,1
9752,user_9752,14660,18,15,3,Jan-19,4,0,0
9753,user_9753,729,7,7,0,Jul-18,10,0,0
9754,user_9754,22,5,5,0,Aug-18,9,0,0
9755,user_9755,10554,988,378,610,Apr-19,1,1,0
9756,user_9756,648,14,5,9,Apr-19,1,1,0
9757,user_9757,1572,185,0,185,May-19,0,1,1
9758,user_9758,9,2,2,0,Oct-18,7,0,0
9759,user_9759,16,3,3,0,Aug-18,9,0,0
9760,user_9760,88,11,11,0,Sep-18,8,0,0
9761,user_9761,419,18,3,15,Feb-19,3,0,0
9762,user_9762,94900,418,163,255,May-19,0,1,1
9763,user_9763,10628,120,92,28,May-19,0,0,1
9764,user_9764,250,58,40,18,May-19,0,1,1
9765,user_9765,644,121,34,87,May-19,0,1,1
9766,user_9766,4594,221,107,114,May-19,0,1,1
9767,user_9767,535,41,39,2,Feb-19,3,0,0
9768,user_9768,16522,724,62,662,May-19,0,1,1
9769,user_9769,510,54,7,47,May-19,0,1,1
9770,user_9770,23,3,0,3,Mar-19,2,0,0
9771,user_9771,40,13,10,3,Apr-19,1,1,0
9772,user_9772,3129,134,38,96,May-19,0,1,1
9773,user_9773,162,6,6,0,Sep-18,8,0,0
9774,user_9774,2987,19,2,17,Apr-19,1,1,0
9775,user_9775,5960,53,47,6,Apr-19,1,1,0
9776,user_9776,2503,47,41,6,May-19,0,1,1
9777,user_9777,2245,115,83,32,Apr-19,1,1,0
9778,user_9778,7052,828,373,455,May-19,0,1,1
9779,user_9779,2351,39,34,5,May-19,0,0,1
9780,user_9780,1997,119,39,80,May-19,0,1,1
9781,user_9781,5245,248,189,59,Mar-19,2,0,0
9782,user_9782,6318,46,21,25,Feb-19,3,0,0
9785,user_9785,4763,94,29,65,Apr-19,1,1,0
9786,user_9786,9,2,2,0,Aug-18,9,0,0
9787,user_9787,402,89,51,38,May-19,0,1,1
9788,user_9788,14776,348,3,345,May-19,0,1,1
9789,user_9789,1208,41,7,34,Apr-19,1,1,0
9790,user_9790,17,3,3,0,Oct-18,7,0,0
9791,user_9791,12895,240,149,91,Apr-19,1,1,0
9792,user_9792,1200,8,8,0,Sep-18,8,0,0
9793,user_9793,30,6,6,0,Nov-18,6,0,0
9794,user_9794,43,4,4,0,Aug-18,9,0,0
9795,user_9795,94108,703,197,506,May-19,0,1,1
9796,user_9796,693,47,17,30,Apr-19,1,1,0
9797,user_9797,5480,125,125,0,Dec-18,5,0,0
9799,user_9799,36472,157,99,58,May-19,0,1,1
9800,user_9800,3354,99,81,18,May-19,0,1,1
9801,user_9801,20039,377,225,152,May-19,0,1,1
9802,user_9802,11988,757,361,396,May-19,0,1,1
9803,user_9803,879,50,9,41,May-19,0,1,1
9804,user_9804,2832,13,6,7,Apr-19,1,1,0
9805,user_9805,42,6,6,0,Aug-18,9,0,0
9806,user_9806,33847,145,49,96,May-19,0,1,1
9807,user_9807,158,11,11,0,Nov-18,6,0,0
9808,user_9808,19120,371,165,206,May-19,0,1,1
9809,user_9809,4999,5,5,0,Dec-18,5,0,0
9810,user_9810,4252,39,28,11,Apr-19,1,1,0
9811,user_9811,51789,99,43,56,Apr-19,1,1,0
9812,user_9812,11724,631,251,380,May-19,0,1,1
9813,user_9813,1706,78,62,16,Mar-19,2,0,0
9814,user_9814,9564,162,20,142,May-19,0,1,1
9815,user_9815,560,18,9,9,Feb-19,3,0,0
9816,user_9816,911,50,47,3,Jan-19,4,0,0
9817,user_9817,231,16,9,7,May-19,0,1,1
9818,user_9818,41,3,3,0,Aug-18,9,0,0
9819,user_9819,15,3,3,0,Sep-18,8,0,0
9820,user_9820,1001,12,9,3,Mar-19,2,0,0
9821,user_9821,15471,1076,444,632,May-19,0,1,1
9822,user_9822,803,193,91,102,May-19,0,1,1
9823,user_9823,686,23,8,15,Apr-19,1,1,0
9824,user_9824,20,2,2,0,Oct-18,7,0,0
9825,user_9825,4659,160,117,43,Mar-19,2,0,0
9826,user_9826,9,2,0,2,Mar-19,2,0,0
9827,user_9827,200686,76,27,49,May-19,0,1,1
9828,user_9828,6084,35,35,0,Oct-18,7,0,0
9829,user_9829,8083,271,159,112,May-19,0,1,1
9830,user_9830,6456,142,72,70,Mar-19,2,0,0
9831,user_9831,10,1,1,0,Aug-18,9,0,0
9832,user_9832,7050,124,55,69,May-19,0,1,1
9833,user_9833,9,1,1,0,Oct-18,7,0,0
9834,user_9834,636,27,21,6,May-19,0,1,1
9835,user_9835,5115,92,23,69,Apr-19,1,1,0
9836,user_9836,6733,117,57,60,May-19,0,1,1
9837,user_9837,2604,135,72,63,May-19,0,1,1
9838,user_9838,227,10,5,5,May-19,0,0,1
9839,user_9839,14703,598,34,564,May-19,0,1,1
9840,user_9840,15154,297,131,166,May-19,0,1,1
9841,user_9841,1650,18,15,3,Feb-19,3,0,0
9842,user_9842,21243,123,93,30,Apr-19,1,1,0
9843,user_9843,4636,59,29,30,Apr-19,1,1,0
9844,user_9844,43128,625,284,341,May-19,0,1,1
9845,user_9845,1734,78,10,68,Apr-19,1,1,0
9846,user_9846,8466,953,502,451,May-19,0,1,1
9847,user_9847,9601,560,288,272,May-19,0,1,1
9848,user_9848,11014,225,147,78,May-19,0,1,1
9849,user_9849,10,1,1,0,Aug-18,9,0,0
9850,user_9850,2998,242,20,222,May-19,0,1,1
9851,user_9851,94512,66,43,23,Apr-19,1,1,0
9852,user_9852,1258,89,26,63,Apr-19,1,1,0
9853,user_9853,11140,19,7,12,May-19,0,1,1
9854,user_9854,142815,218,135,83,Apr-19,1,1,0
9855,user_9855,4368,102,93,9,Jan-19,4,0,0
9856,user_9856,22338,236,55,181,May-19,0,1,1
9857,user_9857,8236,279,69,210,Apr-19,1,1,0
9858,user_9858,111,16,13,3,Apr-19,1,1,0
9859,user_9859,16086,393,171,222,May-19,0,1,1
9860,user_9860,796,13,8,5,Apr-19,1,1,0
9861,user_9861,551,25,25,0,Dec-18,5,0,0
9862,user_9862,63,15,15,0,Oct-18,7,0,0
9863,user_9863,30,4,4,0,Oct-18,7,0,0
9864,user_9864,1287,21,16,5,May-19,0,1,1
9865,user_9865,1,1,1,0,Aug-18,9,0,0
9866,user_9866,23437,103,35,68,May-19,0,1,1
9867,user_9867,0,1,1,0,Aug-18,9,0,0
9868,user_9868,12,4,4,0,Aug-18,9,0,0
9869,user_9869,33,4,4,0,Aug-18,9,0,0
9870,user_9870,5185,255,103,152,May-19,0,1,1
9871,user_9871,8948,653,359,294,May-19,0,1,1
9872,user_9872,3741,215,123,92,May-19,0,1,1
9873,user_9873,999,57,38,19,May-19,0,1,1
9874,user_9874,4568,470,398,72,Mar-19,2,0,0
9875,user_9875,801,56,15,41,Apr-19,1,1,0
9876,user_9876,103,10,5,5,Feb-19,3,0,0
9877,user_9877,414,7,7,0,Nov-18,6,0,0
9878,user_9878,11505,145,97,48,Apr-19,1,1,0
9879,user_9879,5211,127,18,109,May-19,0,1,1
9880,user_9880,85,2,2,0,Dec-18,5,0,0
9881,user_9881,55165,529,219,310,May-19,0,1,1
9882,user_9882,200,13,1,12,Apr-19,1,1,0
9883,user_9883,2223,214,23,191,May-19,0,1,1
9884,user_9884,3324,23,13,10,Mar-19,2,0,0
9885,user_9885,991,24,21,3,Jan-19,4,0,0
9886,user_9886,2613,6,4,2,Jan-19,4,0,0
9887,user_9887,82,6,6,0,Dec-18,5,0,0
9888,user_9888,17982,107,51,56,May-19,0,1,1
9889,user_9889,662,56,18,38,Apr-19,1,1,0
9890,user_9890,9235,163,68,95,May-19,0,1,1
9891,user_9891,1789,49,49,0,Sep-18,8,0,0
9892,user_9892,5824,350,139,211,May-19,0,1,1
9893,user_9893,60,3,0,3,Apr-19,1,1,0
9894,user_9894,599,18,10,8,Apr-19,1,1,0
9895,user_9895,1,2,2,0,Oct-18,7,0,0
9896,user_9896,15446,427,72,355,May-19,0,1,1
9897,user_9897,700,35,35,0,Oct-18,7,0,0
9898,user_9898,4404,88,50,38,Apr-19,1,1,0
9899,user_9899,8057,165,112,53,May-19,0,1,1
9900,user_9900,248,34,19,15,Feb-19,3,0,0
9903,user_9903,642,67,27,40,Mar-19,2,0,0
9904,user_9904,27378,735,212,523,May-19,0,1,1
9905,user_9905,243,19,15,4,Feb-19,3,0,0
9906,user_9906,47391,609,138,471,May-19,0,1,1
9907,user_9907,15223,241,203,38,May-19,0,1,1
9909,user_9909,542942,537,292,245,May-19,0,1,1
9910,user_9910,96306,826,370,456,May-19,0,1,1
9911,user_9911,1564,86,13,73,May-19,0,1,1
9912,user_9912,18,3,3,0,Sep-18,8,0,0
9913,user_9913,12524,414,147,267,Apr-19,1,1,0
9914,user_9914,3149,30,30,0,Nov-18,6,0,0
9915,user_9915,3353,176,118,58,May-19,0,1,1
9916,user_9916,23,4,4,0,Aug-18,9,0,0
9917,user_9917,8845,195,175,20,May-19,0,1,1
9918,user_9918,7766,290,95,195,May-19,0,1,1
9919,user_9919,12134,269,111,158,May-19,0,0,1
9920,user_9920,2268,66,33,33,May-19,0,0,1
9921,user_9921,499,5,4,1,Jan-19,4,0,0
9922,user_9922,43,1,1,0,Oct-18,7,0,0
9923,user_9923,11581,101,101,0,Oct-18,7,0,0
9924,user_9924,1625,75,60,15,Apr-19,1,1,0
9925,user_9925,4868,95,57,38,May-19,0,1,1
9926,user_9926,257,4,2,2,Jan-19,4,0,0
9927,user_9927,7245,207,88,119,May-19,0,1,1
9928,user_9928,1651,107,92,15,Apr-19,1,1,0
9929,user_9929,4146,209,3,206,May-19,0,1,1
9930,user_9930,9,2,2,0,Sep-18,8,0,0
9931,user_9931,8159,87,47,40,May-19,0,1,1
9932,user_9932,162,11,11,0,Sep-18,8,0,0
9933,user_9933,14822,302,250,52,Apr-19,1,1,0
9934,user_9934,1941,88,51,37,May-19,0,1,1
9935,user_9935,3120,30,23,7,May-19,0,0,1
9936,user_9936,63,10,10,0,Oct-18,7,0,0
9937,user_9937,2974,45,38,7,May-19,0,1,1
9938,user_9938,2241,54,54,0,Dec-18,5,0,0
9939,user_9939,4036,197,112,85,May-19,0,1,1
9940,user_9940,47550,811,384,427,May-19,0,1,1
9941,user_9941,3164,97,52,45,May-19,0,1,1
9942,user_9942,3295,87,54,33,May-19,0,1,1
9944,user_9944,16,3,3,0,Aug-18,9,0,0
9945,user_9945,16,3,0,3,Mar-19,2,0,0
9946,user_9946,1699,62,11,51,Apr-19,1,1,0
9947,user_9947,20054,62,34,28,Mar-19,2,0,0
9948,user_9948,1013,13,9,4,May-19,0,0,1
9949,user_9949,635,44,18,26,Apr-19,1,1,0
9950,user_9950,751,19,19,0,Sep-18,8,0,0
9951,user_9951,172,5,5,0,Aug-18,9,0,0
9952,user_9952,15,2,2,0,Aug-18,9,0,0
9953,user_9953,4697,167,54,113,May-19,0,1,1
9954,user_9954,148,15,5,10,Feb-19,3,0,0
9955,user_9955,249,11,8,3,May-19,0,1,1
9956,user_9956,102,3,0,3,May-19,0,1,1
9957,user_9957,10745,103,26,77,May-19,0,1,1
9958,user_9958,54,2,2,0,Nov-18,6,0,0
9959,user_9959,51,7,0,7,May-19,0,1,1
9960,user_9960,2359,58,29,29,Mar-19,2,0,0
9961,user_9961,3264,253,26,227,Apr-19,1,1,0
9962,user_9962,10174,474,33,441,May-19,0,1,1
9963,user_9963,7057,631,185,446,May-19,0,1,1
9964,user_9964,891,45,23,22,Apr-19,1,1,0
9965,user_9965,7017,121,106,15,May-19,0,1,1
9966,user_9966,9374,36,23,13,May-19,0,1,1
9967,user_9967,1808,53,24,29,Apr-19,1,1,0
9968,user_9968,1846,71,45,26,May-19,0,1,1
9969,user_9969,13,2,2,0,Aug-18,9,0,0
9970,user_9970,41300,446,185,261,May-19,0,1,1
9971,user_9971,1420,53,40,13,May-19,0,1,1
9972,user_9972,7557,416,167,249,May-19,0,1,1
9973,user_9973,25,6,5,1,Feb-19,3,0,0
9974,user_9974,87,3,3,0,Aug-18,9,0,0
9975,user_9975,463,18,16,2,Mar-19,2,0,0
9976,user_9976,1432,83,82,1,Feb-19,3,0,0
9977,user_9977,2118,111,63,48,Apr-19,1,1,0
9978,user_9978,1287,58,35,23,May-19,0,1,1
9979,user_9979,3920,126,24,102,May-19,0,1,1
9980,user_9980,601,85,5,80,May-19,0,1,1
9981,user_9981,2610,14,14,0,Nov-18,6,0,0
9982,user_9982,2324,26,10,16,Apr-19,1,1,0
9983,user_9983,6277,152,75,77,May-19,0,1,1
9984,user_9984,9522,597,362,235,May-19,0,1,1
9985,user_9985,521,56,6,50,May-19,0,1,1
9987,user_9987,60,7,0,7,May-19,0,1,1
9988,user_9988,132822,1129,453,676,May-19,0,1,1
9989,user_9989,21056,176,63,113,Mar-19,2,0,0
9990,user_9990,655,18,18,0,Sep-18,8,0,0
9991,user_9991,12463,43,28,15,May-19,0,1,1
9992,user_9992,1481,38,12,26,May-19,0,1,1
9993,user_9993,298,16,2,14,May-19,0,1,1
9994,user_9994,1461,105,50,55,May-19,0,1,1
9995,user_9995,45988,984,493,491,May-19,0,1,1
9996,user_9996,16694,240,134,106,Apr-19,1,1,0
9997,user_9997,911,83,40,43,Apr-19,1,1,0
9998,user_9998,10,8,8,0,Oct-18,7,0,0
9999,user_9999,973,82,46,36,May-19,0,1,1
10000,user_10000,18375,144,59,85,May-19,0,1,1
10001,user_10001,3030,35,34,1,Feb-19,3,0,0
10002,user_10002,20904,89,81,8,Apr-19,1,1,0
10004,user_10004,1895,173,100,73,May-19,0,1,1
10005,user_10005,1968,70,44,26,Apr-19,1,1,0
10006,user_10006,657,38,38,0,Dec-18,5,0,0
10007,user_10007,2558,64,38,26,May-19,0,1,1
10008,user_10008,2650,43,43,0,Nov-18,6,0,0
10009,user_10009,16882,1216,776,440,May-19,0,1,1
10010,user_10010,5559,59,58,1,Mar-19,2,0,0
10011,user_10011,11523,170,76,94,Apr-19,1,1,0
10012,user_10012,3318,393,381,12,Apr-19,1,1,0
10013,user_10013,917,71,3,68,May-19,0,1,1
10014,user_10014,5558,75,8,67,May-19,0,1,1
10015,user_10015,4449,45,29,16,Apr-19,1,1,0
10016,user_10016,14523,373,316,57,Feb-19,3,0,0
10017,user_10017,5239,88,72,16,Apr-19,1,1,0
10018,user_10018,3605,263,61,202,May-19,0,1,1
10019,user_10019,39211,513,502,11,May-19,0,0,1
10020,user_10020,61,12,6,6,Jan-19,4,0,0
10021,user_10021,6325,68,27,41,May-19,0,1,1
10022,user_10022,2597,92,4,88,May-19,0,1,1
10023,user_10023,2274,68,68,0,Oct-18,7,0,0
10024,user_10024,806,22,3,19,Mar-19,2,0,0
10025,user_10025,15959,42,31,11,May-19,0,1,1
10026,user_10026,2238,75,49,26,Apr-19,1,1,0
10027,user_10027,6418,48,3,45,Apr-19,1,1,0
10028,user_10028,40,4,4,0,Aug-18,9,0,0
10029,user_10029,7939,424,179,245,May-19,0,1,1
10030,user_10030,2298,166,67,99,May-19,0,1,1
10031,user_10031,773,66,16,50,Apr-19,1,1,0
10032,user_10032,6206,69,39,30,May-19,0,1,1
10033,user_10033,239,3,3,0,Aug-18,9,0,0
10034,user_10034,1365,105,51,54,May-19,0,1,1
10035,user_10035,32848,656,316,340,May-19,0,1,1
10036,user_10036,1694,23,23,0,Dec-18,5,0,0
10037,user_10037,4,2,2,0,Aug-18,9,0,0
10038,user_10038,33971,89,25,64,Apr-19,1,1,0
10039,user_10039,332,18,14,4,Feb-19,3,0,0
10040,user_10040,7730,237,148,89,Apr-19,1,1,0
10041,user_10041,27309,230,160,70,May-19,0,1,1
10042,user_10042,63016,15,15,0,Nov-18,6,0,0
10043,user_10043,969,42,9,33,Apr-19,1,1,0
10044,user_10044,5602,66,16,50,May-19,0,1,1
10045,user_10045,975,17,17,0,Oct-18,7,0,0
10046,user_10046,2900,79,66,13,Apr-19,1,1,0
10047,user_10047,2126,129,78,51,May-19,0,0,1
10048,user_10048,4259,48,33,15,Apr-19,1,1,0
10049,user_10049,28,6,5,1,Feb-19,3,0,0
10050,user_10050,403,41,25,16,Mar-19,2,0,0
10051,user_10051,8651,160,65,95,May-19,0,1,1
10052,user_10052,1,1,1,0,Aug-18,9,0,0
10053,user_10053,32,11,11,0,Oct-18,7,0,0
10054,user_10054,2271,15,10,5,Apr-19,1,1,0
10055,user_10055,21100,53,30,23,Mar-19,2,0,0
10056,user_10056,36512,750,237,513,May-19,0,1,1
10057,user_10057,10283,106,102,4,Apr-19,1,1,0
10058,user_10058,9303,232,114,118,May-19,0,1,1
10060,user_10060,1581,46,0,46,May-19,0,1,1
10061,user_10061,1052,38,38,0,Nov-18,6,0,0
10062,user_10062,2596,35,35,0,Dec-18,5,0,0
10063,user_10063,1265,29,29,0,Oct-18,7,0,0
10064,user_10064,17,5,3,2,Jan-19,4,0,0
10065,user_10065,3892,60,36,24,May-19,0,0,1
10066,user_10066,3687,79,79,0,Dec-18,5,0,0
10067,user_10067,1655,105,74,31,Mar-19,2,0,0
10068,user_10068,1463,94,49,45,May-19,0,1,1
10069,user_10069,81,12,11,1,Mar-19,2,0,0
10070,user_10070,3644,62,29,33,Apr-19,1,1,0
10071,user_10071,241,45,45,0,Nov-18,6,0,0
10072,user_10072,32448,52,21,31,May-19,0,1,1
10073,user_10073,16,3,3,0,Aug-18,9,0,0
10074,user_10074,863,21,7,14,May-19,0,1,1
10075,user_10075,6964,389,179,210,May-19,0,1,1
10076,user_10076,16554,122,107,15,May-19,0,0,1
10077,user_10077,3247,95,88,7,May-19,0,1,1
10078,user_10078,21446,277,184,93,Apr-19,1,1,0
10079,user_10079,1904,25,16,9,Feb-19,3,0,0
10080,user_10080,1558,13,13,0,Nov-18,6,0,0
10081,user_10081,437,28,21,7,May-19,0,0,1
10082,user_10082,1101,22,16,6,Mar-19,2,0,0
10083,user_10083,24308,562,402,160,May-19,0,1,1
10084,user_10084,16263,73,51,22,May-19,0,1,1
10085,user_10085,106979,1015,572,443,May-19,0,1,1
10086,user_10086,734,26,24,2,Feb-19,3,0,0
10087,user_10087,102,5,5,0,Sep-18,8,0,0
10088,user_10088,11917,613,252,361,May-19,0,1,1
10089,user_10089,26,7,7,0,Aug-18,9,0,0
10090,user_10090,852778,52,11,41,May-19,0,1,1
10091,user_10091,15815,192,110,82,May-19,0,1,1
10092,user_10092,55,6,6,0,Sep-18,8,0,0
10093,user_10093,2590,92,41,51,May-19,0,1,1
10094,user_10094,3918,94,61,33,May-19,0,1,1
10095,user_10095,3939,327,0,327,May-19,0,1,1
10096,user_10096,287,25,5,20,Apr-19,1,1,0
10097,user_10097,5777,83,69,14,Apr-19,1,1,0
10098,user_10098,41,3,3,0,Aug-18,9,0,0
10099,user_10099,878,25,11,14,May-19,0,1,1
10101,user_10101,222,36,36,0,Dec-18,5,0,0
10102,user_10102,6731,89,89,0,Dec-18,5,0,0
10103,user_10103,10,4,4,0,Aug-18,9,0,0
10104,user_10104,1974,74,74,0,Nov-18,6,0,0
10105,user_10105,114,19,17,2,Mar-19,2,0,0
10106,user_10106,5712,38,7,31,May-19,0,1,1
10107,user_10107,8181,208,160,48,Apr-19,1,1,0
10108,user_10108,2861,104,94,10,Apr-19,1,1,0
10109,user_10109,86,5,5,0,Dec-18,5,0,0
10110,user_10110,20042,96,59,37,Mar-19,2,0,0
10111,user_10111,124,16,13,3,Feb-19,3,0,0
10112,user_10112,4651,104,50,54,May-19,0,1,1
10113,user_10113,12113,70,20,50,Apr-19,1,1,0
10114,user_10114,6174,227,136,91,May-19,0,1,1
10116,user_10116,2714,56,23,33,May-19,0,1,1
10117,user_10117,15600,622,244,378,May-19,0,1,1
10118,user_10118,22234,1582,1059,523,Apr-19,1,1,0
10119,user_10119,15610,198,30,168,May-19,0,1,1
10120,user_10120,10057,130,56,74,Apr-19,1,1,0
10121,user_10121,6709,93,27,66,Feb-19,3,0,0
10122,user_10122,11254,304,265,39,Mar-19,2,0,0
10123,user_10123,1122,23,17,6,Mar-19,2,0,0
10124,user_10124,10392,159,98,61,Apr-19,1,1,0
10125,user_10125,354,20,19,1,Mar-19,2,0,0
10126,user_10126,15119,154,83,71,May-19,0,1,1
10127,user_10127,2032,41,41,0,Aug-18,9,0,0
10128,user_10128,2372,57,35,22,Apr-19,1,1,0
10129,user_10129,11,2,2,0,Aug-18,9,0,0
10130,user_10130,14147,349,178,171,May-19,0,1,1
10131,user_10131,22964,342,134,208,May-19,0,1,1
10132,user_10132,8,5,5,0,Aug-18,9,0,0
10133,user_10133,3681,119,56,63,May-19,0,1,1
10134,user_10134,18319,802,541,261,May-19,0,1,1
10135,user_10135,3091,28,21,7,Apr-19,1,1,0
10136,user_10136,1204,62,42,20,Apr-19,1,1,0
10137,user_10137,277,4,4,0,Aug-18,9,0,0
10138,user_10138,35611,480,349,131,May-19,0,1,1
10139,user_10139,45661,474,221,253,May-19,0,1,1
10140,user_10140,437,48,6,42,May-19,0,1,1
10141,user_10141,916,69,69,0,Nov-18,6,0,0
10142,user_10142,1325,48,48,0,Nov-18,6,0,0
10143,user_10143,18,3,3,0,Aug-18,9,0,0
10144,user_10144,444,52,5,47,Apr-19,1,1,0
10145,user_10145,11480,190,86,104,Apr-19,1,1,0
10146,user_10146,196,14,14,0,Sep-18,8,0,0
10147,user_10147,490,30,3,27,Apr-19,1,1,0
10148,user_10148,448,40,5,35,May-19,0,1,1
10149,user_10149,258,20,5,15,May-19,0,1,1
10150,user_10150,1541,7,5,2,Feb-19,3,0,0
10151,user_10151,17283,1316,822,494,May-19,0,1,1
10152,user_10152,2096,61,21,40,Apr-19,1,1,0
10153,user_10153,9367,50,32,18,Apr-19,1,1,0
10154,user_10154,2691,23,2,21,Apr-19,1,1,0
10155,user_10155,2,2,1,1,May-19,0,0,1
10156,user_10156,36,4,4,0,Aug-18,9,0,0
10157,user_10157,63,15,7,8,May-19,0,0,1
10158,user_10158,3738,128,101,27,May-19,0,1,1
10159,user_10159,1,1,1,0,Aug-18,9,0,0
10160,user_10160,1040,28,9,19,Apr-19,1,1,0
10161,user_10161,685,42,30,12,May-19,0,1,1
10162,user_10162,93,20,12,8,Feb-19,3,0,0
10163,user_10163,261,12,7,5,Feb-19,3,0,0
10164,user_10164,435,10,10,0,Dec-18,5,0,0
10165,user_10165,478,13,7,6,Mar-19,2,0,0
10166,user_10166,13443,833,285,548,May-19,0,1,1
10167,user_10167,2365,39,33,6,Apr-19,1,1,0
10168,user_10168,1276,23,21,2,Jan-19,4,0,0
10169,user_10169,13737,650,180,470,May-19,0,1,1
10170,user_10170,18,2,2,0,Aug-18,9,0,0
10171,user_10171,405,4,4,0,Oct-18,7,0,0
10172,user_10172,7598,321,0,321,May-19,0,1,1
10173,user_10173,53938,83,43,40,May-19,0,1,1
10174,user_10174,1457,131,75,56,May-19,0,1,1
10175,user_10175,154,17,11,6,May-19,0,0,1
10176,user_10176,1771,38,17,21,Apr-19,1,1,0
10177,user_10177,3399,84,30,54,May-19,0,1,1
10178,user_10178,7369,91,50,41,May-19,0,1,1
10179,user_10179,6001,57,47,10,Jan-19,4,0,0
10180,user_10180,101,31,28,3,Feb-19,3,0,0
10181,user_10181,14,3,3,0,Sep-18,8,0,0
10182,user_10182,24460,330,222,108,May-19,0,1,1
10183,user_10183,11243,295,279,16,May-19,0,1,1
10184,user_10184,118,16,16,0,Dec-18,5,0,0
10185,user_10185,21,3,3,0,Oct-18,7,0,0
10186,user_10186,4597,48,46,2,May-19,0,0,1
10187,user_10187,12005,604,351,253,May-19,0,1,1
10188,user_10188,1328,73,42,31,Apr-19,1,1,0
10189,user_10189,1087,25,19,6,Feb-19,3,0,0
10190,user_10190,15418,141,95,46,May-19,0,1,1
10191,user_10191,166,9,9,0,Nov-18,6,0,0
10193,user_10193,4,2,2,0,Aug-18,9,0,0
10194,user_10194,1099,69,29,40,May-19,0,1,1
10195,user_10195,10,3,3,0,Aug-18,9,0,0
10196,user_10196,1027,190,114,76,May-19,0,1,1
10197,user_10197,2302,38,14,24,May-19,0,1,1
10198,user_10198,1901,34,1,33,May-19,0,1,1
10199,user_10199,26652,534,434,100,Apr-19,1,1,0
10200,user_10200,3555,132,101,31,Apr-19,1,1,0
10201,user_10201,1537,33,23,10,May-19,0,1,1
10202,user_10202,4166,59,52,7,Apr-19,1,1,0
10203,user_10203,3090,181,55,126,May-19,0,1,1
10204,user_10204,21632,862,254,608,May-19,0,1,1
10205,user_10205,380,16,16,0,Nov-18,6,0,0
10206,user_10206,3731,137,104,33,Apr-19,1,1,0
10207,user_10207,13089,312,39,273,May-19,0,1,1
10208,user_10208,1528,93,46,47,May-19,0,1,1
10209,user_10209,7729,164,43,121,Apr-19,1,1,0
10210,user_10210,290,55,30,25,Mar-19,2,0,0
10211,user_10211,810,56,33,23,Apr-19,1,1,0
10212,user_10212,2020,138,32,106,May-19,0,1,1
10213,user_10213,252,26,26,0,Oct-18,7,0,0
10214,user_10214,297,20,12,8,May-19,0,1,1
10215,user_10215,3821,23,21,2,May-19,0,0,1
10216,user_10216,13,3,2,1,Mar-19,2,0,0
10217,user_10217,14,3,3,0,Sep-18,8,0,0
10218,user_10218,1157,26,26,0,Nov-18,6,0,0
10219,user_10219,7603,629,278,351,May-19,0,1,1
10220,user_10220,12085,59,59,0,Nov-18,6,0,0
10221,user_10221,1699,22,22,0,Nov-18,6,0,0
10222,user_10222,111,7,2,5,Mar-19,2,0,0
10223,user_10223,1740,94,63,31,May-19,0,1,1
10224,user_10224,18,3,3,0,Aug-18,9,0,0
10226,user_10226,16,5,2,3,Jan-19,4,0,0
10227,user_10227,6805,433,220,213,May-19,0,1,1
10228,user_10228,4716,226,67,159,May-19,0,1,1
10229,user_10229,1396,201,99,102,May-19,0,1,1
10230,user_10230,1125,22,22,0,Sep-18,8,0,0
10231,user_10231,632,13,12,1,Feb-19,3,0,0
10232,user_10232,12,6,4,2,Apr-19,1,1,0
10233,user_10233,3052,93,48,45,Apr-19,1,1,0
10234,user_10234,4447,47,10,37,May-19,0,1,1
10235,user_10235,91,3,3,0,Sep-18,8,0,0
10236,user_10236,11062,242,93,149,May-19,0,1,1
10237,user_10237,1494,14,13,1,Mar-19,2,0,0
10238,user_10238,9,6,6,0,Sep-18,8,0,0
10239,user_10239,23356,786,418,368,May-19,0,1,1
10240,user_10240,50,6,6,0,Sep-18,8,0,0
10241,user_10241,1271,87,32,55,May-19,0,1,1
10242,user_10242,25972,358,143,215,May-19,0,1,1
10243,user_10243,2880,95,83,12,Apr-19,1,1,0
10244,user_10244,83687,1021,389,632,May-19,0,1,1
10245,user_10245,25884,543,329,214,May-19,0,1,1
10246,user_10246,3323,54,10,44,May-19,0,1,1
10247,user_10247,303,16,10,6,Apr-19,1,1,0
10248,user_10248,666,73,71,2,Jan-19,4,0,0
10249,user_10249,1226,229,225,4,Jan-19,4,0,0
10250,user_10250,1867,46,46,0,Dec-18,5,0,0
10251,user_10251,6,4,4,0,Aug-18,9,0,0
10252,user_10252,1315,38,33,5,May-19,0,0,1
10253,user_10253,1655,73,27,46,May-19,0,1,1
10255,user_10255,14155,104,33,71,Apr-19,1,1,0
10256,user_10256,214,21,11,10,May-19,0,1,1
10257,user_10257,3946,144,90,54,May-19,0,1,1
10258,user_10258,5149,162,57,105,May-19,0,1,1
10259,user_10259,2332,67,38,29,May-19,0,1,1
10260,user_10260,13162,546,433,113,May-19,0,1,1
10261,user_10261,20,2,2,0,Oct-18,7,0,0
10262,user_10262,2259,51,46,5,May-19,0,1,1
10263,user_10263,19219,928,325,603,May-19,0,1,1
10264,user_10264,5197,423,224,199,May-19,0,1,1
10266,user_10266,2946,160,99,61,Apr-19,1,1,0
10267,user_10267,2694,49,18,31,May-19,0,1,1
10269,user_10269,52252,382,124,258,May-19,0,1,1
10270,user_10270,60244,1132,195,937,May-19,0,1,1
10271,user_10271,915,57,37,20,May-19,0,1,1
10272,user_10272,214,35,16,19,May-19,0,1,1
10273,user_10273,1780,92,47,45,May-19,0,1,1
10274,user_10274,2053,78,60,18,May-19,0,1,1
10275,user_10275,3450,72,64,8,Feb-19,3,0,0
10276,user_10276,4087,215,105,110,Apr-19,1,1,0
10277,user_10277,11399,49,49,0,Sep-18,8,0,0
10278,user_10278,14,3,3,0,Aug-18,9,0,0
10279,user_10279,1956,46,17,29,May-19,0,1,1
10280,user_10280,6383,73,55,18,May-19,0,1,1
10281,user_10281,4168,266,3,263,May-19,0,1,1
10282,user_10282,5572,191,102,89,May-19,0,1,1
10283,user_10283,17,4,0,4,Feb-19,3,0,0
10284,user_10284,968,27,25,2,Mar-19,2,0,0
10285,user_10285,14,3,3,0,Aug-18,9,0,0
10286,user_10286,1827,127,58,69,May-19,0,1,1
10287,user_10287,1586,75,71,4,Mar-19,2,0,0
10288,user_10288,6040,124,94,30,May-19,0,1,1
10289,user_10289,18871,197,116,81,May-19,0,1,1
10290,user_10290,3171,25,25,0,Nov-18,6,0,0
10291,user_10291,9874,704,242,462,May-19,0,1,1
10292,user_10292,45,17,13,4,May-19,0,0,1
10293,user_10293,19,4,3,1,Jan-19,4,0,0
10294,user_10294,11718,224,82,142,May-19,0,1,1
10295,user_10295,48,7,7,0,Aug-18,9,0,0
10296,user_10296,17600,230,212,18,Mar-19,2,0,0
10297,user_10297,2166,141,48,93,May-19,0,1,1
10298,user_10298,21882,130,102,28,Apr-19,1,1,0
10299,user_10299,25708,882,343,539,May-19,0,1,1
10300,user_10300,563,24,24,0,Sep-18,8,0,0
10301,user_10301,1520,66,3,63,Apr-19,1,1,0
10302,user_10302,4455,40,4,36,May-19,0,1,1
10303,user_10303,3430,78,6,72,May-19,0,1,1
10304,user_10304,3736,37,33,4,Feb-19,3,0,0
10305,user_10305,10023,77,40,37,May-19,0,1,1
10306,user_10306,102,14,9,5,Apr-19,1,1,0
10307,user_10307,1943,132,89,43,May-19,0,1,1
10308,user_10308,1230,27,27,0,Oct-18,7,0,0
10309,user_10309,6483,158,73,85,Apr-19,1,1,0
10310,user_10310,1097,71,71,0,Sep-18,8,0,0
10311,user_10311,3124,72,70,2,Mar-19,2,0,0
10312,user_10312,4087,73,51,22,Apr-19,1,1,0
10313,user_10313,17444,208,77,131,May-19,0,1,1
10314,user_10314,2129,64,8,56,May-19,0,1,1
10315,user_10315,39188,978,446,532,May-19,0,1,1
10316,user_10316,3315,56,56,0,Dec-18,5,0,0
10317,user_10317,50735,1794,896,898,May-19,0,1,1
10318,user_10318,30,4,4,0,Aug-18,9,0,0
10319,user_10319,6593,397,48,349,May-19,0,1,1
10320,user_10320,4235,126,107,19,Apr-19,1,1,0
10321,user_10321,10284,171,69,102,May-19,0,1,1
10322,user_10322,18,3,3,0,Aug-18,9,0,0
10323,user_10323,268,2,0,2,May-19,0,0,1
10324,user_10324,6761,197,70,127,May-19,0,1,1
10325,user_10325,9815,1097,554,543,May-19,0,1,1
10326,user_10326,15,4,4,0,Aug-18,9,0,0
10327,user_10327,2557,103,1,102,May-19,0,1,1
10328,user_10328,23017,383,181,202,May-19,0,1,1
10329,user_10329,77,12,8,4,Apr-19,1,1,0
10330,user_10330,42,6,6,0,Aug-18,9,0,0
10331,user_10331,8848,100,55,45,May-19,0,1,1
10332,user_10332,85,4,4,0,Dec-18,5,0,0
10333,user_10333,110017,54,23,31,May-19,0,1,1
10334,user_10334,28,6,6,0,Aug-18,9,0,0
10335,user_10335,15245,126,59,67,May-19,0,1,1
10336,user_10336,815,14,11,3,Feb-19,3,0,0
10337,user_10337,8,3,3,0,Aug-18,9,0,0
10338,user_10338,1636,70,51,19,Apr-19,1,1,0
10339,user_10339,884,20,20,0,Nov-18,6,0,0
10340,user_10340,7889,227,129,98,May-19,0,1,1
10341,user_10341,7448,130,17,113,Apr-19,1,1,0
10342,user_10342,4,2,2,0,Aug-18,9,0,0
10343,user_10343,344,26,20,6,Mar-19,2,0,0
10344,user_10344,747,22,21,1,Apr-19,1,1,0
10345,user_10345,1673,50,41,9,Apr-19,1,1,0
10346,user_10346,5218,67,64,3,Mar-19,2,0,0
10347,user_10347,2493,49,39,10,May-19,0,0,1
10348,user_10348,110,7,0,7,May-19,0,1,1
10349,user_10349,1245,24,15,9,Apr-19,1,1,0
10350,user_10350,3295,170,63,107,May-19,0,1,1
10351,user_10351,4224,348,172,176,May-19,0,1,1
10352,user_10352,999,14,3,11,Mar-19,2,0,0
10353,user_10353,16951,52,46,6,Apr-19,1,1,0
10354,user_10354,5831,60,20,40,May-19,0,1,1
10355,user_10355,16897,436,209,227,May-19,0,1,1
10356,user_10356,2552,118,89,29,Mar-19,2,0,0
10357,user_10357,2500,91,60,31,May-19,0,0,1
10358,user_10358,1988,25,19,6,Mar-19,2,0,0
10359,user_10359,3440,159,66,93,May-19,0,1,1
10360,user_10360,74817,22,3,19,Mar-19,2,0,0
10361,user_10361,5114,143,90,53,May-19,0,1,1
10362,user_10362,411,41,21,20,May-19,0,1,1
10363,user_10363,343,13,4,9,May-19,0,0,1
10364,user_10364,20984,688,341,347,May-19,0,1,1
10365,user_10365,244,17,10,7,May-19,0,1,1
10366,user_10366,156050,101,79,22,May-19,0,1,1
10367,user_10367,1188,88,43,45,May-19,0,1,1
10368,user_10368,18766,1242,638,604,May-19,0,1,1
10369,user_10369,1001,58,24,34,May-19,0,1,1
10370,user_10370,987,55,38,17,Apr-19,1,1,0
10371,user_10371,1336,17,14,3,May-19,0,1,1
10372,user_10372,2719,49,44,5,Feb-19,3,0,0
10373,user_10373,269,108,0,108,May-19,0,1,1
10375,user_10375,5020,168,134,34,Mar-19,2,0,0
10376,user_10376,4872,72,45,27,Apr-19,1,1,0
10377,user_10377,24909,521,218,303,May-19,0,1,1
10378,user_10378,6626,354,148,206,May-19,0,1,1
10379,user_10379,23747,459,183,276,May-19,0,1,1
10380,user_10380,9298,355,304,51,Apr-19,1,1,0
10381,user_10381,9,2,2,0,Aug-18,9,0,0
10382,user_10382,1754,52,43,9,Apr-19,1,1,0
10383,user_10383,3029,39,22,17,May-19,0,1,1
10384,user_10384,444,11,4,7,Apr-19,1,1,0
10385,user_10385,367,13,12,1,Mar-19,2,0,0
10386,user_10386,31385,120,65,55,May-19,0,1,1
10387,user_10387,7395,89,40,49,May-19,0,1,1
10388,user_10388,3042,102,29,73,May-19,0,1,1
10389,user_10389,16830,69,13,56,Apr-19,1,1,0
10390,user_10390,2529,57,57,0,Aug-18,9,0,0
10391,user_10391,2404,109,64,45,May-19,0,1,1
10392,user_10392,21239,742,448,294,Apr-19,1,1,0
10393,user_10393,2377,138,118,20,Feb-19,3,0,0
10395,user_10395,39,8,8,0,Sep-18,8,0,0
10396,user_10396,1860,21,12,9,May-19,0,1,1
10397,user_10397,109006,75,33,42,May-19,0,1,1
10398,user_10398,5987,353,267,86,Apr-19,1,1,0
10399,user_10399,11475,270,107,163,May-19,0,1,1
10400,user_10400,11,2,2,0,Aug-18,9,0,0
10401,user_10401,19820,117,49,68,Mar-19,2,0,0
10402,user_10402,21725,55,4,51,May-19,0,1,1
10403,user_10403,9882,112,62,50,Apr-19,1,1,0
10404,user_10404,3191,90,27,63,May-19,0,0,1
10405,user_10405,9283,206,69,137,May-19,0,1,1
10406,user_10406,13351,1214,601,613,May-19,0,1,1
10407,user_10407,22581,876,321,555,May-19,0,1,1
10408,user_10408,2351,34,19,15,May-19,0,1,1
10409,user_10409,21833,456,279,177,May-19,0,1,1
10410,user_10410,4150,72,3,69,May-19,0,1,1
10412,user_10412,16,3,3,0,Aug-18,9,0,0
10413,user_10413,6558,476,289,187,May-19,0,1,1
10414,user_10414,2431,266,101,165,May-19,0,1,1
10415,user_10415,10334,288,37,251,May-19,0,1,1
10416,user_10416,8426,82,38,44,May-19,0,1,1
10417,user_10417,1222,18,17,1,Mar-19,2,0,0
10418,user_10418,18417,35,11,24,May-19,0,1,1
10419,user_10419,5899,144,138,6,Apr-19,1,1,0
10420,user_10420,2213,45,5,40,Apr-19,1,1,0
10421,user_10421,2564,21,17,4,Apr-19,1,1,0
10422,user_10422,2084,49,24,25,May-19,0,1,1
10423,user_10423,2241,119,53,66,May-19,0,1,1
10424,user_10424,552,11,11,0,Sep-18,8,0,0
10425,user_10425,1831,42,34,8,Mar-19,2,0,0
10426,user_10426,11919,70,56,14,Apr-19,1,1,0
10427,user_10427,1730,39,30,9,May-19,0,0,1
10428,user_10428,27,5,5,0,Aug-18,9,0,0
10429,user_10429,20,3,3,0,Oct-18,7,0,0
10430,user_10430,6264,198,90,108,May-19,0,1,1
10432,user_10432,351,13,5,8,Apr-19,1,1,0
10433,user_10433,1237,11,9,2,Jan-19,4,0,0
10434,user_10434,17001,966,365,601,May-19,0,1,1
10435,user_10435,4665,84,16,68,May-19,0,1,1
10436,user_10436,877860,1414,579,835,May-19,0,1,1
10437,user_10437,82,6,5,1,Jan-19,4,0,0
10438,user_10438,10777,327,196,131,May-19,0,1,1
10439,user_10439,4053,148,105,43,Apr-19,1,1,0
10440,user_10440,203,33,32,1,Jan-19,4,0,0
10441,user_10441,4838,132,126,6,Mar-19,2,0,0
10442,user_10442,18595,184,93,91,May-19,0,1,1
10443,user_10443,3621,67,39,28,May-19,0,1,1
10444,user_10444,6097,157,93,64,May-19,0,1,1
10445,user_10445,58,5,5,0,Sep-18,8,0,0
10446,user_10446,3410,86,47,39,May-19,0,1,1
10447,user_10447,8596,373,240,133,May-19,0,1,1
10449,user_10449,888,57,21,36,Apr-19,1,1,0
10450,user_10450,5852,432,220,212,May-19,0,1,1
10451,user_10451,258,6,4,2,Feb-19,3,0,0
10452,user_10452,5783,99,56,43,Apr-19,1,1,0
10453,user_10453,47,3,3,0,Oct-18,7,0,0
10455,user_10455,298,18,18,0,Nov-18,6,0,0
10456,user_10456,5356,152,75,77,May-19,0,1,1
10457,user_10457,60913,632,276,356,May-19,0,1,1
10458,user_10458,2840,77,21,56,May-19,0,1,1
10459,user_10459,1001,28,4,24,May-19,0,1,1
10460,user_10460,9978,693,170,523,May-19,0,1,1
10461,user_10461,220,31,26,5,Apr-19,1,1,0
10462,user_10462,3952,78,13,65,May-19,0,0,1
10463,user_10463,3305,50,40,10,Mar-19,2,0,0
10464,user_10464,559,37,24,13,Feb-19,3,0,0
10465,user_10465,23914,387,152,235,May-19,0,1,1
10466,user_10466,6098,665,287,378,May-19,0,1,1
10467,user_10467,292,74,48,26,May-19,0,1,1
10468,user_10468,996,55,45,10,May-19,0,0,1
10469,user_10469,40547,362,156,206,May-19,0,1,1
10470,user_10470,11,2,2,0,Aug-18,9,0,0
10471,user_10471,11224,251,142,109,May-19,0,1,1
10472,user_10472,4,1,1,0,Aug-18,9,0,0
10473,user_10473,2255,77,47,30,Mar-19,2,0,0
10474,user_10474,1333,84,84,0,Nov-18,6,0,0
10475,user_10475,7949,179,23,156,May-19,0,1,1
10476,user_10476,95,16,7,9,May-19,0,1,1
10477,user_10477,64,5,0,5,Jan-19,4,0,0
10478,user_10478,183681,241,149,92,May-19,0,1,1
10479,user_10479,4740,102,56,46,Apr-19,1,1,0
10480,user_10480,27,6,6,0,Sep-18,8,0,0
10481,user_10481,5358,249,135,114,May-19,0,1,1
10482,user_10482,7966,148,32,116,May-19,0,1,1
10483,user_10483,1124,44,32,12,May-19,0,1,1
10485,user_10485,5246,189,180,9,May-19,0,0,1
10486,user_10486,7829,122,77,45,May-19,0,1,1
10487,user_10487,14,2,2,0,Aug-18,9,0,0
10488,user_10488,459,4,3,1,Feb-19,3,0,0
10489,user_10489,17294,434,257,177,May-19,0,1,1
10490,user_10490,32,6,6,0,Oct-18,7,0,0
10491,user_10491,1831,90,62,28,Apr-19,1,1,0
10492,user_10492,5765,306,116,190,May-19,0,1,1
10493,user_10493,9,1,1,0,Aug-18,9,0,0
10494,user_10494,1387,46,22,24,May-19,0,1,1
10495,user_10495,399,45,16,29,May-19,0,1,1
10496,user_10496,6086,235,129,106,Apr-19,1,1,0
10497,user_10497,3104,91,44,47,May-19,0,1,1
10498,user_10498,8233,262,135,127,May-19,0,1,1
10499,user_10499,51,3,3,0,Aug-18,9,0,0
10500,user_10500,8204,55,40,15,Mar-19,2,0,0
10501,user_10501,515,28,19,9,Mar-19,2,0,0
10502,user_10502,7907,241,120,121,May-19,0,1,1
10503,user_10503,22517,860,285,575,May-19,0,1,1
10504,user_10504,4290,34,13,21,Apr-19,1,1,0
10505,user_10505,3871,89,60,29,May-19,0,0,1
10506,user_10506,2624,45,34,11,Mar-19,2,0,0
10507,user_10507,22784,201,37,164,May-19,0,1,1
10508,user_10508,12368,91,10,81,May-19,0,1,1
10509,user_10509,204,23,23,0,Nov-18,6,0,0
10511,user_10511,3978,100,48,52,Feb-19,3,0,0
10512,user_10512,12248,108,54,54,Mar-19,2,0,0
10513,user_10513,1528,61,12,49,May-19,0,1,1
10514,user_10514,681,32,29,3,Jan-19,4,0,0
10515,user_10515,92,12,12,0,Oct-18,7,0,0
10516,user_10516,2095,54,49,5,Mar-19,2,0,0
10517,user_10517,13347,153,31,122,May-19,0,1,1
10518,user_10518,2887,150,86,64,May-19,0,1,1
10519,user_10519,187,29,12,17,Apr-19,1,1,0
10520,user_10520,5101,282,32,250,May-19,0,1,1
10521,user_10521,3225,21,21,0,Aug-18,9,0,0
10522,user_10522,142250,82,27,55,May-19,0,1,1
10523,user_10523,291,32,32,0,Oct-18,7,0,0
10524,user_10524,4,1,1,0,Aug-18,9,0,0
10525,user_10525,808,2,2,0,Aug-18,9,0,0
10526,user_10526,17377,366,148,218,May-19,0,1,1
10527,user_10527,277,10,10,0,Sep-18,8,0,0
10528,user_10528,907,73,72,1,Jan-19,4,0,0
10529,user_10529,1703,25,11,14,Apr-19,1,1,0
10530,user_10530,28,4,2,2,Mar-19,2,0,0
10531,user_10531,43,2,1,1,Jan-19,4,0,0
10532,user_10532,1324,82,82,0,Sep-18,8,0,0
10533,user_10533,10881,145,70,75,May-19,0,1,1
10534,user_10534,3185,209,147,62,May-19,0,1,1
10535,user_10535,111,9,8,1,Mar-19,2,0,0
10536,user_10536,3019,83,78,5,Apr-19,1,1,0
10537,user_10537,5572,190,96,94,May-19,0,1,1
10538,user_10538,863,57,35,22,Apr-19,1,1,0
10539,user_10539,441,40,9,31,May-19,0,1,1
10540,user_10540,12079,1244,538,706,May-19,0,1,1
10541,user_10541,193,6,6,0,Sep-18,8,0,0
10542,user_10542,2976,90,3,87,May-19,0,1,1
10543,user_10543,971,78,8,70,May-19,0,1,1
10544,user_10544,96,11,9,2,Apr-19,1,1,0
10545,user_10545,2181,64,59,5,Jan-19,4,0,0
10546,user_10546,4,1,1,0,Nov-18,6,0,0
10547,user_10547,7,4,2,2,Apr-19,1,1,0
10548,user_10548,13549,33,9,24,Apr-19,1,1,0
10549,user_10549,480,18,9,9,Apr-19,1,1,0
10550,user_10550,4519,133,79,54,May-19,0,1,1
10551,user_10551,4445,42,38,4,Apr-19,1,1,0
10552,user_10552,224,8,4,4,May-19,0,1,1
10554,user_10554,116,17,15,2,Feb-19,3,0,0
10555,user_10555,1207,170,104,66,May-19,0,1,1
10556,user_10556,8292,210,129,81,May-19,0,1,1
10557,user_10557,268,6,6,0,Aug-18,9,0,0
10558,user_10558,160,22,15,7,Apr-19,1,1,0
10559,user_10559,1052,20,11,9,May-19,0,1,1
10560,user_10560,717,30,27,3,Mar-19,2,0,0
10561,user_10561,1953,10,7,3,May-19,0,0,1
10562,user_10562,5874,146,69,77,May-19,0,1,1
10563,user_10563,439,31,31,0,Dec-18,5,0,0
10564,user_10564,14,3,3,0,Aug-18,9,0,0
10565,user_10565,1463,40,35,5,Mar-19,2,0,0
10566,user_10566,3065,68,17,51,May-19,0,1,1
10567,user_10567,7416,560,51,509,May-19,0,1,1
10568,user_10568,22454,993,545,448,May-19,0,1,1
10569,user_10569,11420,225,114,111,May-19,0,1,1
10570,user_10570,908,43,39,4,Feb-19,3,0,0
10571,user_10571,85,6,6,0,Dec-18,5,0,0
10572,user_10572,4850,159,152,7,Jan-19,4,0,0
10573,user_10573,17904,33,12,21,May-19,0,1,1
10574,user_10574,2003,46,46,0,Nov-18,6,0,0
10575,user_10575,1122,21,21,0,Sep-18,8,0,0
10576,user_10576,9,2,2,0,Aug-18,9,0,0
10577,user_10577,34557,62,18,44,May-19,0,1,1
10578,user_10578,11754,352,144,208,May-19,0,1,1
10579,user_10579,6610,287,181,106,May-19,0,1,1
10580,user_10580,2365,103,0,103,May-19,0,1,1
10581,user_10581,5050,74,67,7,Apr-19,1,1,0
10582,user_10582,23481,383,169,214,May-19,0,1,1
10583,user_10583,6015,182,95,87,May-19,0,1,1
10585,user_10585,12596,122,64,58,Mar-19,2,0,0
10586,user_10586,504,9,0,9,Apr-19,1,1,0
10587,user_10587,1662,213,49,164,May-19,0,1,1
10588,user_10588,4899,88,84,4,May-19,0,0,1
10589,user_10589,17,6,4,2,Jan-19,4,0,0
10590,user_10590,58,19,2,17,Mar-19,2,0,0
10591,user_10591,6595,228,109,119,May-19,0,1,1
10592,user_10592,3029,73,3,70,May-19,0,1,1
10593,user_10593,358,6,6,0,Sep-18,8,0,0
10594,user_10594,210579,112,56,56,Mar-19,2,0,0
10595,user_10595,74,8,8,0,Dec-18,5,0,0
10596,user_10596,7510,273,144,129,May-19,0,1,1
10597,user_10597,49,6,6,0,Oct-18,7,0,0
10598,user_10598,373,28,17,11,Feb-19,3,0,0
10599,user_10599,18,3,3,0,Aug-18,9,0,0
10600,user_10600,179162,2611,1257,1354,May-19,0,1,1
10601,user_10601,31,3,3,0,Oct-18,7,0,0
10602,user_10602,5390,29,6,23,May-19,0,1,1
10603,user_10603,11587,114,87,27,May-19,0,0,1
10604,user_10604,25293,247,204,43,May-19,0,1,1
10605,user_10605,472,22,12,10,Mar-19,2,0,0
10606,user_10606,4046,90,90,0,Dec-18,5,0,0
10607,user_10607,6050,283,151,132,May-19,0,1,1
10609,user_10609,11747,196,38,158,May-19,0,1,1
10610,user_10610,9,2,2,0,Oct-18,7,0,0
10612,user_10612,490,28,16,12,Apr-19,1,1,0
10613,user_10613,153392,179,60,119,May-19,0,1,1
10614,user_10614,21,1,0,1,Feb-19,3,0,0
10615,user_10615,1,1,1,0,Aug-18,9,0,0
10616,user_10616,10386,8,5,3,Feb-19,3,0,0
10617,user_10617,375,42,24,18,Apr-19,1,1,0
10618,user_10618,138,7,5,2,May-19,0,0,1
10619,user_10619,6221,68,0,68,May-19,0,1,1
10620,user_10620,8340,63,40,23,Apr-19,1,1,0
10621,user_10621,2174,93,26,67,Apr-19,1,1,0
10622,user_10622,94,4,3,1,Jan-19,4,0,0
10623,user_10623,1968,223,172,51,May-19,0,1,1
10624,user_10624,8234,560,228,332,May-19,0,1,1
10625,user_10625,7976,120,13,107,May-19,0,1,1
10626,user_10626,1431,86,41,45,May-19,0,1,1
10627,user_10627,14,3,3,0,Aug-18,9,0,0
10628,user_10628,8214,115,103,12,May-19,0,1,1
10629,user_10629,9,2,2,0,Aug-18,9,0,0
10630,user_10630,975,43,43,0,Oct-18,7,0,0
10631,user_10631,712,19,1,18,Apr-19,1,1,0
10632,user_10632,20,3,3,0,Sep-18,8,0,0
10633,user_10633,6,3,3,0,Aug-18,9,0,0
10634,user_10634,95,7,5,2,Mar-19,2,0,0
10635,user_10635,12,2,2,0,Aug-18,9,0,0
10636,user_10636,4764,81,65,16,Mar-19,2,0,0
10637,user_10637,12739,70,44,26,Mar-19,2,0,0
10638,user_10638,195,23,0,23,May-19,0,1,1
10639,user_10639,4693,57,25,32,May-19,0,1,1
10640,user_10640,1115,68,48,20,May-19,0,1,1
10641,user_10641,5351,363,117,246,May-19,0,1,1
10642,user_10642,3349,104,86,18,May-19,0,1,1
10643,user_10643,13197,434,116,318,May-19,0,1,1
10644,user_10644,92,9,9,0,Sep-18,8,0,0
10645,user_10645,277,7,7,0,Sep-18,8,0,0
10646,user_10646,2936,46,46,0,Sep-18,8,0,0
10647,user_10647,4789,21,8,13,May-19,0,1,1
10648,user_10648,4517,74,36,38,May-19,0,1,1
10649,user_10649,825,22,4,18,May-19,0,1,1
10650,user_10650,981,115,75,40,May-19,0,1,1
10651,user_10651,3296,101,0,101,May-19,0,1,1
10652,user_10652,230,15,15,0,Oct-18,7,0,0
10653,user_10653,5221,75,30,45,Apr-19,1,1,0
10654,user_10654,9,8,8,0,Sep-18,8,0,0
10655,user_10655,163,10,0,10,Mar-19,2,0,0
10656,user_10656,13960,83,59,24,May-19,0,1,1
10657,user_10657,157,16,11,5,Apr-19,1,1,0
10658,user_10658,9,2,2,0,Sep-18,8,0,0
10659,user_10659,1446,17,14,3,May-19,0,0,1
10660,user_10660,23299,91,4,87,May-19,0,1,1
10661,user_10661,26083,359,123,236,May-19,0,1,1
10662,user_10662,3021,73,51,22,May-19,0,1,1
10663,user_10663,7092,218,120,98,May-19,0,1,1
10664,user_10664,43908,383,184,199,May-19,0,1,1
10665,user_10665,2928,242,241,1,Jan-19,4,0,0
10666,user_10666,21,3,3,0,Aug-18,9,0,0
10667,user_10667,3523,53,53,0,Sep-18,8,0,0
10668,user_10668,3105,207,205,2,Mar-19,2,0,0
10669,user_10669,246,11,11,0,Sep-18,8,0,0
10670,user_10670,1813,35,35,0,Sep-18,8,0,0
10672,user_10672,1812,39,19,20,May-19,0,1,1
10673,user_10673,748,28,2,26,May-19,0,1,1
10674,user_10674,197,19,19,0,Nov-18,6,0,0
10676,user_10676,5916,48,35,13,Mar-19,2,0,0
10677,user_10677,6211,185,8,177,May-19,0,1,1
10678,user_10678,1239,90,44,46,May-19,0,1,1
10679,user_10679,793,21,17,4,Jan-19,4,0,0
10680,user_10680,518,44,42,2,May-19,0,0,1
10681,user_10681,1770,9,9,0,Aug-18,9,0,0
10682,user_10682,6149,268,92,176,May-19,0,1,1
10683,user_10683,3071,44,39,5,Jan-19,4,0,0
10684,user_10684,3157,287,178,109,May-19,0,1,1
10685,user_10685,6727,105,45,60,May-19,0,1,1
10686,user_10686,16,10,9,1,Jan-19,4,0,0
10687,user_10687,29418,522,154,368,May-19,0,1,1
10688,user_10688,21529,629,115,514,May-19,0,1,1
10689,user_10689,89,8,8,0,Sep-18,8,0,0
10690,user_10690,5402,136,58,78,May-19,0,1,1
10691,user_10691,835,24,18,6,May-19,0,0,1
10692,user_10692,901,67,34,33,May-19,0,1,1
10693,user_10693,3654,517,350,167,May-19,0,1,1
10694,user_10694,4732,277,271,6,Jan-19,4,0,0
10695,user_10695,128225,133,25,108,May-19,0,1,1
10696,user_10696,81,4,2,2,Jan-19,4,0,0
10697,user_10697,237,19,9,10,Mar-19,2,0,0
10698,user_10698,2591,83,9,74,May-19,0,1,1
10699,user_10699,4757,138,85,53,May-19,0,1,1
10700,user_10700,11169,448,313,135,May-19,0,1,1
10701,user_10701,2912,50,39,11,May-19,0,1,1
10702,user_10702,7243,72,31,41,Apr-19,1,1,0
10703,user_10703,622,19,15,4,May-19,0,0,1
10704,user_10704,566,68,55,13,Apr-19,1,1,0
10705,user_10705,15757,66,40,26,Apr-19,1,1,0
10706,user_10706,2928,91,7,84,May-19,0,1,1
10707,user_10707,91,15,12,3,Jan-19,4,0,0
10708,user_10708,17842,48,17,31,May-19,0,0,1
10709,user_10709,38848,158,139,19,Apr-19,1,1,0
10710,user_10710,5046,357,185,172,May-19,0,1,1
10711,user_10711,0,1,0,1,Jan-19,4,0,0
10712,user_10712,6782,94,0,94,May-19,0,1,1
10713,user_10713,29159,277,99,178,May-19,0,1,1
10714,user_10714,2483,48,0,48,May-19,0,1,1
10715,user_10715,1158,28,23,5,Mar-19,2,0,0
10716,user_10716,3640,128,37,91,May-19,0,1,1
10717,user_10717,372396,517,397,120,May-19,0,1,1
10718,user_10718,1019,110,71,39,May-19,0,1,1
10719,user_10719,8471,708,441,267,May-19,0,1,1
10720,user_10720,7090,131,56,75,May-19,0,1,1
10721,user_10721,4304,47,4,43,May-19,0,1,1
10722,user_10722,3193,105,73,32,Apr-19,1,1,0
10723,user_10723,9,2,2,0,Dec-18,5,0,0
10724,user_10724,3035,139,49,90,May-19,0,1,1
10725,user_10725,16186,384,217,167,May-19,0,1,1
10726,user_10726,15,2,2,0,Aug-18,9,0,0
10727,user_10727,4925,232,12,220,May-19,0,1,1
10728,user_10728,2074,106,93,13,May-19,0,1,1
10729,user_10729,9147,808,427,381,May-19,0,1,1
10730,user_10730,9132,407,284,123,May-19,0,1,1
10731,user_10731,6770,176,131,45,May-19,0,1,1
10732,user_10732,6062,164,89,75,May-19,0,1,1
10733,user_10733,822,34,34,0,Sep-18,8,0,0
10734,user_10734,23,4,4,0,Aug-18,9,0,0
10735,user_10735,5809,259,58,201,May-19,0,1,1
10736,user_10736,1827,21,18,3,Jan-19,4,0,0
10738,user_10738,16147,124,60,64,May-19,0,1,1
10739,user_10739,6,6,6,0,Aug-18,9,0,0
10740,user_10740,3185,109,27,82,May-19,0,1,1
10741,user_10741,25350,216,13,203,May-19,0,1,1
10742,user_10742,1827,13,8,5,Apr-19,1,1,0
10743,user_10743,15002,289,179,110,May-19,0,1,1
10744,user_10744,869,16,16,0,Nov-18,6,0,0
10745,user_10745,1893,21,15,6,Feb-19,3,0,0
10746,user_10746,6083,132,99,33,Mar-19,2,0,0
10747,user_10747,1003,81,20,61,Apr-19,1,1,0
10748,user_10748,6900,94,17,77,May-19,0,1,1
10749,user_10749,4829,435,164,271,May-19,0,1,1
10750,user_10750,939,52,36,16,May-19,0,1,1
10751,user_10751,818,18,18,0,Oct-18,7,0,0
10752,user_10752,43,5,5,0,Sep-18,8,0,0
10753,user_10753,41,9,2,7,Apr-19,1,1,0
10754,user_10754,105,10,7,3,May-19,0,0,1
10755,user_10755,18236,922,260,662,May-19,0,1,1
10756,user_10756,1578,35,24,11,May-19,0,1,1
10757,user_10757,10142,137,34,103,May-19,0,1,1
10758,user_10758,11,2,2,0,Aug-18,9,0,0
10760,user_10760,2256,52,26,26,Mar-19,2,0,0
10761,user_10761,3103,75,30,45,May-19,0,1,1
10762,user_10762,1994,141,12,129,Apr-19,1,1,0
10764,user_10764,11780,40,25,15,May-19,0,1,1
10765,user_10765,3245,87,44,43,May-19,0,1,1
10766,user_10766,1398,3,3,0,Aug-18,9,0,0
10768,user_10768,153,11,11,0,Sep-18,8,0,0
10769,user_10769,764,19,19,0,Oct-18,7,0,0
10770,user_10770,4896,37,6,31,May-19,0,1,1
10771,user_10771,4119,329,104,225,May-19,0,1,1
10772,user_10772,4933,71,62,9,Apr-19,1,1,0
10773,user_10773,6605,162,58,104,May-19,0,1,1
10775,user_10775,10905,166,110,56,May-19,0,1,1
10776,user_10776,12087,176,97,79,Apr-19,1,1,0
10777,user_10777,40,5,4,1,Jan-19,4,0,0
10778,user_10778,879,93,47,46,May-19,0,1,1
10779,user_10779,56,3,0,3,Mar-19,2,0,0
10780,user_10780,233,5,5,0,Nov-18,6,0,0
10781,user_10781,1692,42,42,0,Sep-18,8,0,0
10782,user_10782,3748,85,52,33,May-19,0,1,1
10783,user_10783,4,2,2,0,Aug-18,9,0,0
10784,user_10784,293428,31,10,21,May-19,0,1,1
10785,user_10785,1219,30,24,6,May-19,0,0,1
10786,user_10786,23719,382,123,259,May-19,0,1,1
10787,user_10787,6478,68,14,54,May-19,0,1,1
10788,user_10788,4,1,1,0,Sep-18,8,0,0
10789,user_10789,4341,235,112,123,May-19,0,1,1
10790,user_10790,5934,118,44,74,May-19,0,1,1
10791,user_10791,10251,294,132,162,May-19,0,1,1
10792,user_10792,23938,287,170,117,May-19,0,1,1
10793,user_10793,1167,94,37,57,May-19,0,1,1
10794,user_10794,72645,3223,1184,2039,May-19,0,1,1
10795,user_10795,5416,238,104,134,May-19,0,1,1
10796,user_10796,444,16,16,0,Aug-18,9,0,0
10797,user_10797,8387,332,165,167,May-19,0,1,1
10798,user_10798,15042,265,121,144,May-19,0,1,1
10799,user_10799,522,10,8,2,Apr-19,1,1,0
10800,user_10800,44630,600,293,307,May-19,0,1,1
10801,user_10801,7350,121,67,54,May-19,0,1,1
10803,user_10803,15588,406,10,396,May-19,0,1,1
10804,user_10804,2621,71,17,54,Apr-19,1,1,0
10805,user_10805,3801,73,66,7,Apr-19,1,1,0
10806,user_10806,7877,273,121,152,May-19,0,1,1
10807,user_10807,11441,29,13,16,May-19,0,0,1
10808,user_10808,11,2,2,0,Aug-18,9,0,0
10809,user_10809,9929,423,28,395,May-19,0,1,1
10810,user_10810,33,4,4,0,Aug-18,9,0,0
10811,user_10811,432,8,8,0,Sep-18,8,0,0
10812,user_10812,79,18,12,6,Apr-19,1,1,0
10813,user_10813,657,29,21,8,Feb-19,3,0,0
10814,user_10814,105,10,7,3,May-19,0,1,1
10815,user_10815,6119,64,48,16,Mar-19,2,0,0
10816,user_10816,366,18,13,5,Mar-19,2,0,0
10818,user_10818,20,5,4,1,Mar-19,2,0,0
10819,user_10819,42739,431,410,21,May-19,0,1,1
10820,user_10820,7043,188,47,141,May-19,0,1,1
10821,user_10821,2878,81,55,26,Apr-19,1,1,0
10822,user_10822,1211,43,43,0,Sep-18,8,0,0
10823,user_10823,462,17,17,0,Sep-18,8,0,0
10824,user_10824,10,3,3,0,Aug-18,9,0,0
10825,user_10825,395,27,0,27,Apr-19,1,1,0
10826,user_10826,446,13,7,6,Feb-19,3,0,0
10827,user_10827,12589,424,299,125,May-19,0,1,1
10828,user_10828,1533,85,82,3,Mar-19,2,0,0
10829,user_10829,57459,232,64,168,May-19,0,1,1
10830,user_10830,15381,10,10,0,Nov-18,6,0,0
10831,user_10831,7234,116,61,55,May-19,0,1,1
10832,user_10832,574,12,10,2,Feb-19,3,0,0
10833,user_10833,9214,156,7,149,May-19,0,1,1
10834,user_10834,394,53,26,27,Apr-19,1,1,0
10835,user_10835,51402,328,230,98,May-19,0,1,1
10836,user_10836,22639,178,102,76,May-19,0,1,1
10837,user_10837,2933,94,64,30,Apr-19,1,1,0
10838,user_10838,2143,34,34,0,Sep-18,8,0,0
10839,user_10839,68,4,4,0,Oct-18,7,0,0
10840,user_10840,7065,256,107,149,May-19,0,1,1
10841,user_10841,3885,68,44,24,Apr-19,1,1,0
10842,user_10842,4822,247,134,113,Apr-19,1,1,0
10843,user_10843,6414,85,67,18,May-19,0,1,1
10844,user_10844,2279,41,12,29,Feb-19,3,0,0
10845,user_10845,3805,334,171,163,May-19,0,1,1
10846,user_10846,21,3,3,0,Aug-18,9,0,0
10847,user_10847,4539,113,78,35,May-19,0,1,1
10849,user_10849,48704,556,224,332,May-19,0,1,1
10850,user_10850,2085,72,34,38,Feb-19,3,0,0
10851,user_10851,4965,735,228,507,May-19,0,1,1
10852,user_10852,337,6,6,0,Aug-18,9,0,0
10853,user_10853,5260,90,11,79,May-19,0,1,1
10855,user_10855,27485,532,272,260,May-19,0,1,1
10856,user_10856,15,2,2,0,Aug-18,9,0,0
10857,user_10857,5901,525,66,459,May-19,0,1,1
10858,user_10858,3,1,0,1,Mar-19,2,0,0
10859,user_10859,1187,20,15,5,Jan-19,4,0,0
10860,user_10860,2338,45,27,18,Apr-19,1,1,0
10861,user_10861,14236,543,269,274,May-19,0,1,1
10862,user_10862,20230,201,131,70,May-19,0,1,1
10863,user_10863,6609,487,273,214,May-19,0,1,1
10864,user_10864,21115,434,197,237,May-19,0,1,1
10866,user_10866,11860,178,150,28,May-19,0,1,1
10867,user_10867,1197,40,30,10,Jan-19,4,0,0
10868,user_10868,333,62,41,21,Apr-19,1,1,0
10869,user_10869,97529,2913,1377,1536,May-19,0,1,1
10871,user_10871,37414,647,204,443,May-19,0,1,1
10872,user_10872,15906,1084,688,396,May-19,0,1,1
10873,user_10873,2666,14,14,0,Nov-18,6,0,0
10874,user_10874,36921,494,201,293,May-19,0,1,1
10875,user_10875,7830,177,75,102,May-19,0,1,1
10876,user_10876,6087,196,133,63,Feb-19,3,0,0
10877,user_10877,2802,328,48,280,May-19,0,1,1
10878,user_10878,8702,182,135,47,May-19,0,1,1
10879,user_10879,1737,37,2,35,Apr-19,1,1,0
10880,user_10880,1915,25,6,19,Mar-19,2,0,0
10882,user_10882,5111,135,77,58,May-19,0,1,1
10883,user_10883,1052,31,26,5,May-19,0,1,1
10884,user_10884,792,85,56,29,Apr-19,1,1,0
10885,user_10885,1595,174,84,90,Apr-19,1,1,0
10886,user_10886,4041,271,105,166,May-19,0,1,1
10887,user_10887,2192,75,33,42,May-19,0,1,1
10888,user_10888,13,3,3,0,Oct-18,7,0,0
10889,user_10889,9325,332,215,117,May-19,0,1,1
10890,user_10890,1192,70,50,20,Apr-19,1,1,0
10891,user_10891,6494,80,8,72,Feb-19,3,0,0
10892,user_10892,9355,162,92,70,May-19,0,1,1
10893,user_10893,706,119,58,61,May-19,0,1,1
10894,user_10894,2366,30,24,6,May-19,0,1,1
10896,user_10896,8201,79,79,0,Dec-18,5,0,0
10897,user_10897,16,3,3,0,Aug-18,9,0,0
10898,user_10898,2638,58,32,26,Apr-19,1,1,0
10899,user_10899,2551,31,6,25,Apr-19,1,1,0
10900,user_10900,287,16,4,12,Apr-19,1,1,0
10901,user_10901,1182,55,9,46,Apr-19,1,1,0
10902,user_10902,5,1,1,0,Aug-18,9,0,0
10903,user_10903,1277,93,44,49,May-19,0,1,1
10904,user_10904,1224,52,14,38,May-19,0,1,1
10905,user_10905,1198,28,15,13,May-19,0,1,1
10906,user_10906,20,4,4,0,Aug-18,9,0,0
10907,user_10907,344,24,8,16,Apr-19,1,1,0
10908,user_10908,9738,596,232,364,May-19,0,1,1
10909,user_10909,24,7,7,0,Sep-18,8,0,0
10910,user_10910,715,8,4,4,Mar-19,2,0,0
10911,user_10911,3739,127,48,79,May-19,0,1,1
10912,user_10912,13532,602,105,497,Apr-19,1,1,0
10913,user_10913,17993,59,24,35,Apr-19,1,1,0
10914,user_10914,4550,6,0,6,Mar-19,2,0,0
10916,user_10916,9,2,2,0,Sep-18,8,0,0
10917,user_10917,6380,62,62,0,Sep-18,8,0,0
10918,user_10918,24384,505,230,275,May-19,0,1,1
10919,user_10919,322117,162,64,98,May-19,0,0,1
10920,user_10920,3660,200,108,92,May-19,0,1,1
10921,user_10921,2246,55,45,10,May-19,0,1,1
10922,user_10922,3002,40,28,12,Apr-19,1,1,0
10923,user_10923,3651,41,41,0,Oct-18,7,0,0
10924,user_10924,3122,105,46,59,May-19,0,1,1
10925,user_10925,9,2,2,0,Aug-18,9,0,0
10926,user_10926,119,9,5,4,Jan-19,4,0,0
10927,user_10927,663,102,45,57,May-19,0,1,1
10928,user_10928,39299,760,373,387,May-19,0,1,1
10929,user_10929,2215,24,14,10,May-19,0,0,1
10931,user_10931,3680,170,105,65,May-19,0,1,1
10932,user_10932,4569,86,42,44,May-19,0,1,1
10933,user_10933,11530,131,57,74,May-19,0,1,1
10934,user_10934,92839,105,15,90,May-19,0,1,1
10935,user_10935,342,14,13,1,Jan-19,4,0,0
10936,user_10936,16077,113,59,54,May-19,0,1,1
10937,user_10937,223,13,1,12,Feb-19,3,0,0
10938,user_10938,393,26,21,5,May-19,0,0,1
10939,user_10939,5724,235,234,1,Feb-19,3,0,0
10940,user_10940,2879,88,15,73,May-19,0,1,1
10941,user_10941,6800,682,330,352,May-19,0,1,1
10942,user_10942,8314,92,55,37,May-19,0,1,1
10943,user_10943,6411,403,135,268,May-19,0,1,1
10944,user_10944,85783,124,50,74,May-19,0,1,1
10946,user_10946,4064,177,127,50,Apr-19,1,1,0
10947,user_10947,6503,252,36,216,May-19,0,1,1
10948,user_10948,3125,75,35,40,Jan-19,4,0,0
10949,user_10949,7594,197,41,156,May-19,0,1,1
10950,user_10950,2295,75,50,25,May-19,0,1,1
10951,user_10951,6429,134,101,33,Apr-19,1,1,0
10952,user_10952,789,19,19,0,Aug-18,9,0,0
10953,user_10953,3746,40,13,27,May-19,0,1,1
10954,user_10954,14360,231,115,116,May-19,0,1,1
10955,user_10955,13738,556,253,303,Apr-19,1,1,0
10956,user_10956,7955,88,44,44,May-19,0,1,1
10957,user_10957,134339,152,82,70,May-19,0,1,1
10958,user_10958,3122,83,82,1,May-19,0,0,1
10960,user_10960,2579,80,21,59,May-19,0,0,1
10961,user_10961,136,34,34,0,Nov-18,6,0,0
10962,user_10962,15122,199,18,181,May-19,0,1,1
10963,user_10963,3925,79,58,21,Apr-19,1,1,0
10964,user_10964,1147,31,26,5,Apr-19,1,1,0
10965,user_10965,11,2,2,0,Aug-18,9,0,0
10966,user_10966,5529,71,55,16,Mar-19,2,0,0
10967,user_10967,483,29,10,19,Mar-19,2,0,0
10969,user_10969,370,25,16,9,Apr-19,1,1,0
10970,user_10970,7027,230,78,152,May-19,0,1,1
10971,user_10971,3654,28,3,25,May-19,0,1,1
10972,user_10972,12921,65,32,33,May-19,0,1,1
10973,user_10973,14214,193,55,138,May-19,0,1,1
10974,user_10974,37300,25,14,11,May-19,0,1,1
10975,user_10975,298,20,19,1,Feb-19,3,0,0
10976,user_10976,16280,49,36,13,Apr-19,1,1,0
10977,user_10977,17509,437,211,226,May-19,0,1,1
10978,user_10978,8,4,4,0,Sep-18,8,0,0
10979,user_10979,1749,44,37,7,Apr-19,1,1,0
10980,user_10980,437,30,18,12,Mar-19,2,0,0
10981,user_10981,3245,114,57,57,May-19,0,1,1
10983,user_10983,33279,294,140,154,May-19,0,1,1
10984,user_10984,7443,195,66,129,May-19,0,1,1
10985,user_10985,4714,435,260,175,Apr-19,1,1,0
10986,user_10986,100,22,18,4,Jan-19,4,0,0
10987,user_10987,24625,330,163,167,May-19,0,1,1
10988,user_10988,818,13,7,6,Mar-19,2,0,0
10989,user_10989,1324,36,36,0,Nov-18,6,0,0
10990,user_10990,497,11,2,9,Mar-19,2,0,0
10991,user_10991,54,12,2,10,Feb-19,3,0,0
10992,user_10992,2219,193,51,142,May-19,0,1,1
10994,user_10994,7820,109,68,41,Apr-19,1,1,0
10995,user_10995,592,16,14,2,May-19,0,1,1
10996,user_10996,4759,79,42,37,Apr-19,1,1,0
10997,user_10997,3581,26,26,0,Nov-18,6,0,0
10998,user_10998,9209,17,0,17,Mar-19,2,0,0
10999,user_10999,9,2,2,0,Aug-18,9,0,0
11000,user_11000,6074,104,79,25,May-19,0,1,1
11001,user_11001,3607,184,100,84,May-19,0,1,1
11002,user_11002,289,17,9,8,Jan-19,4,0,0
11003,user_11003,32,7,1,6,Apr-19,1,1,0
11004,user_11004,65940,57,45,12,Apr-19,1,1,0
11005,user_11005,30,2,0,2,Mar-19,2,0,0
11006,user_11006,7712,95,63,32,Apr-19,1,1,0
11007,user_11007,173,3,3,0,Aug-18,9,0,0
11008,user_11008,55706,1271,685,586,May-19,0,1,1
11009,user_11009,30029,607,39,568,May-19,0,1,1
11010,user_11010,3837,285,129,156,May-19,0,1,1
11011,user_11011,2507,60,37,23,Mar-19,2,0,0
11012,user_11012,16178,117,16,101,May-19,0,1,1
11013,user_11013,14381,612,561,51,Feb-19,3,0,0
11014,user_11014,111,14,8,6,Mar-19,2,0,0
11015,user_11015,268,21,3,18,Apr-19,1,1,0
11016,user_11016,37,14,10,4,Apr-19,1,1,0
11017,user_11017,21891,257,116,141,May-19,0,1,1
11019,user_11019,3270,44,37,7,Feb-19,3,0,0
11020,user_11020,1633,43,40,3,Apr-19,1,1,0
11022,user_11022,35,2,2,0,Aug-18,9,0,0
11023,user_11023,8723,44,38,6,Apr-19,1,1,0
11024,user_11024,4,2,2,0,Aug-18,9,0,0
11025,user_11025,70,11,2,9,Apr-19,1,1,0
11026,user_11026,2004,89,73,16,May-19,0,1,1
11027,user_11027,129,6,6,0,Oct-18,7,0,0
11028,user_11028,665,46,17,29,May-19,0,1,1
11029,user_11029,1744,139,107,32,Jan-19,4,0,0
11030,user_11030,5363,145,103,42,May-19,0,1,1
11031,user_11031,4500,82,26,56,May-19,0,1,1
11032,user_11032,7537,15,7,8,May-19,0,1,1
11033,user_11033,879,58,22,36,May-19,0,1,1
11034,user_11034,3348,91,3,88,May-19,0,1,1
11036,user_11036,34,1,1,0,Aug-18,9,0,0
11037,user_11037,22228,46,28,18,Mar-19,2,0,0
11038,user_11038,26,4,4,0,Sep-18,8,0,0
11039,user_11039,4312,136,53,83,May-19,0,1,1
11040,user_11040,21,2,2,0,Oct-18,7,0,0
11041,user_11041,10967,728,78,650,May-19,0,1,1
11042,user_11042,2431,63,40,23,May-19,0,0,1
11043,user_11043,13,6,6,0,Aug-18,9,0,0
11044,user_11044,9639,162,103,59,Apr-19,1,1,0
11045,user_11045,14336,698,214,484,May-19,0,1,1
11046,user_11046,498,36,35,1,Feb-19,3,0,0
11047,user_11047,55,5,5,0,Aug-18,9,0,0
11048,user_11048,6454,229,34,195,May-19,0,1,1
11049,user_11049,9622,414,250,164,May-19,0,1,1
11050,user_11050,2592,73,73,0,Oct-18,7,0,0
11051,user_11051,2624,74,40,34,May-19,0,1,1
11052,user_11052,2142,51,43,8,Apr-19,1,1,0
11053,user_11053,4846,125,45,80,Apr-19,1,1,0
11054,user_11054,7575,817,322,495,May-19,0,1,1
11055,user_11055,845,15,13,2,May-19,0,0,1
11057,user_11057,4687,275,170,105,May-19,0,1,1
11058,user_11058,1734,107,83,24,Apr-19,1,1,0
11059,user_11059,6166,41,18,23,Apr-19,1,1,0
11060,user_11060,94859,37,0,37,Apr-19,1,1,0
11061,user_11061,48991,208,134,74,Apr-19,1,1,0
11062,user_11062,334,58,25,33,May-19,0,1,1
11063,user_11063,10445,190,99,91,Mar-19,2,0,0
11064,user_11064,2445,112,75,37,May-19,0,1,1
11065,user_11065,1982,41,41,0,Sep-18,8,0,0
11066,user_11066,16177,971,223,748,May-19,0,1,1
11067,user_11067,3422,60,58,2,Mar-19,2,0,0
11068,user_11068,10,2,2,0,Aug-18,9,0,0
11069,user_11069,940,45,31,14,May-19,0,0,1
11071,user_11071,4063,42,20,22,May-19,0,0,1
11072,user_11072,13470,193,75,118,May-19,0,1,1
11073,user_11073,3416,79,25,54,May-19,0,1,1
11074,user_11074,12288,354,194,160,May-19,0,1,1
11075,user_11075,34459,665,269,396,May-19,0,1,1
11076,user_11076,23824,303,160,143,May-19,0,1,1
11077,user_11077,384555,687,416,271,May-19,0,1,1
11078,user_11078,14360,227,48,179,May-19,0,1,1
11079,user_11079,8947,784,265,519,May-19,0,1,1
11080,user_11080,4780,78,59,19,Apr-19,1,1,0
11081,user_11081,965,32,9,23,Apr-19,1,1,0
11082,user_11082,761,39,35,4,Apr-19,1,1,0
11083,user_11083,16,6,6,0,Sep-18,8,0,0
11084,user_11084,1274,81,50,31,May-19,0,1,1
11085,user_11085,14,3,3,0,Aug-18,9,0,0
11086,user_11086,5210,175,78,97,May-19,0,1,1
11087,user_11087,1389,64,29,35,Mar-19,2,0,0
11088,user_11088,527,38,19,19,Apr-19,1,1,0
11089,user_11089,71,5,5,0,Sep-18,8,0,0
11090,user_11090,7349,111,104,7,Apr-19,1,1,0
11091,user_11091,105730,352,269,83,May-19,0,1,1
11092,user_11092,1790,47,38,9,May-19,0,0,1
11094,user_11094,9859,145,85,60,May-19,0,1,1
11095,user_11095,649,9,3,6,Jan-19,4,0,0
11096,user_11096,2800,120,74,46,May-19,0,1,1
11097,user_11097,9,2,2,0,Aug-18,9,0,0
11098,user_11098,17,4,4,0,Sep-18,8,0,0
11099,user_11099,1940,46,34,12,Apr-19,1,1,0
11100,user_11100,2264,110,69,41,Apr-19,1,1,0
11101,user_11101,14314,411,167,244,May-19,0,1,1
11102,user_11102,4992,407,329,78,May-19,0,1,1
11103,user_11103,1169,11,6,5,May-19,0,1,1
11104,user_11104,16,3,3,0,Aug-18,9,0,0
11105,user_11105,16554,503,313,190,May-19,0,1,1
11106,user_11106,9797,45,17,28,Apr-19,1,1,0
11107,user_11107,95,14,14,0,Nov-18,6,0,0
11108,user_11108,1152,51,42,9,May-19,0,1,1
11110,user_11110,7416,153,110,43,May-19,0,1,1
11111,user_11111,206,15,14,1,Apr-19,1,1,0
11112,user_11112,2548,79,24,55,May-19,0,1,1
11113,user_11113,9981,193,190,3,Feb-19,3,0,0
11114,user_11114,7913,101,1,100,May-19,0,1,1
11115,user_11115,998,13,12,1,Mar-19,2,0,0
11116,user_11116,25160,67,42,25,May-19,0,1,1
11117,user_11117,7941,278,142,136,May-19,0,1,1
11118,user_11118,4740,354,262,92,Feb-19,3,0,0
11119,user_11119,12613,49,32,17,May-19,0,0,1
11121,user_11121,43,4,1,3,Mar-19,2,0,0
11122,user_11122,2056,50,40,10,Apr-19,1,1,0
11123,user_11123,19665,331,233,98,May-19,0,1,1
11124,user_11124,3124,49,48,1,Feb-19,3,0,0
11125,user_11125,24580,192,92,100,May-19,0,1,1
11126,user_11126,16,5,4,1,Mar-19,2,0,0
11127,user_11127,6772,45,42,3,Feb-19,3,0,0
11128,user_11128,165,37,35,2,Apr-19,1,1,0
11129,user_11129,16031,391,320,71,May-19,0,1,1
11130,user_11130,4408,329,160,169,May-19,0,1,1
11131,user_11131,21,3,3,0,Aug-18,9,0,0
11132,user_11132,115,20,19,1,Jan-19,4,0,0
11133,user_11133,2964,130,130,0,Sep-18,8,0,0
11134,user_11134,2222,55,21,34,Feb-19,3,0,0
11135,user_11135,27106,628,488,140,May-19,0,1,1
11136,user_11136,62,13,2,11,Feb-19,3,0,0
11137,user_11137,471,78,1,77,May-19,0,1,1
11138,user_11138,1243,19,14,5,May-19,0,0,1
11139,user_11139,18686,333,65,268,May-19,0,1,1
11140,user_11140,24236,244,62,182,May-19,0,1,1
11141,user_11141,36,7,6,1,Mar-19,2,0,0
11143,user_11143,15011,89,60,29,May-19,0,1,1
11144,user_11144,9044,302,144,158,May-19,0,1,1
11145,user_11145,350,4,3,1,Feb-19,3,0,0
11146,user_11146,109,18,7,11,Apr-19,1,1,0
11147,user_11147,7971,67,66,1,Jan-19,4,0,0
11148,user_11148,158,14,8,6,Feb-19,3,0,0
11149,user_11149,2242,164,135,29,May-19,0,1,1
11150,user_11150,9529,261,3,258,May-19,0,1,1
11151,user_11151,395,4,4,0,Aug-18,9,0,0
11152,user_11152,7740,98,0,98,May-19,0,1,1
11153,user_11153,8446,85,83,2,Mar-19,2,0,0
11154,user_11154,10747,58,14,44,May-19,0,1,1
11155,user_11155,3419,108,82,26,Apr-19,1,1,0
11156,user_11156,910,32,25,7,Mar-19,2,0,0
11157,user_11157,13234,419,340,79,Apr-19,1,1,0
11158,user_11158,11,6,4,2,Mar-19,2,0,0
11159,user_11159,5611,126,60,66,May-19,0,0,1
11160,user_11160,18394,20,3,17,May-19,0,1,1
11161,user_11161,2090,76,31,45,May-19,0,1,1
11162,user_11162,3598,193,128,65,May-19,0,1,1
11163,user_11163,6820,70,47,23,Apr-19,1,1,0
11164,user_11164,4828,29,19,10,Apr-19,1,1,0
11165,user_11165,5520,65,34,31,Apr-19,1,1,0
11166,user_11166,344,17,17,0,Sep-18,8,0,0
11167,user_11167,4571,328,102,226,May-19,0,1,1
11168,user_11168,444,23,16,7,Apr-19,1,1,0
11169,user_11169,4699,290,180,110,May-19,0,1,1
11170,user_11170,51,2,2,0,Aug-18,9,0,0
11171,user_11171,423,10,10,0,Sep-18,8,0,0
11172,user_11172,1858,16,12,4,Apr-19,1,1,0
11173,user_11173,22,5,5,0,Dec-18,5,0,0
11174,user_11174,7501,114,38,76,Apr-19,1,1,0
11175,user_11175,13592,86,46,40,Apr-19,1,1,0
11176,user_11176,2539,32,27,5,Apr-19,1,1,0
11177,user_11177,86,9,7,2,May-19,0,1,1
11178,user_11178,6095,133,75,58,Mar-19,2,0,0
11179,user_11179,1217,25,19,6,Jan-19,4,0,0
11181,user_11181,1266,79,38,41,Apr-19,1,1,0
11182,user_11182,1243,69,51,18,May-19,0,1,1
11183,user_11183,55,10,10,0,Oct-18,7,0,0
11184,user_11184,1810,74,52,22,May-19,0,1,1
11185,user_11185,10374,182,81,101,May-19,0,1,1
11186,user_11186,3122,265,117,148,May-19,0,1,1
11187,user_11187,49318,355,97,258,May-19,0,1,1
11188,user_11188,6040,189,128,61,Apr-19,1,1,0
11189,user_11189,7862,518,307,211,May-19,0,1,1
11190,user_11190,2648,104,28,76,May-19,0,1,1
11191,user_11191,2669,389,221,168,May-19,0,1,1
11193,user_11193,8,3,3,0,Aug-18,9,0,0
11195,user_11195,115,4,4,0,Aug-18,9,0,0
11196,user_11196,6032,120,120,0,Oct-18,7,0,0
11197,user_11197,1225,31,30,1,Jan-19,4,0,0
11198,user_11198,20191,55,42,13,May-19,0,1,1
11199,user_11199,97,7,3,4,Apr-19,1,1,0
11200,user_11200,963,154,46,108,May-19,0,1,1
11201,user_11201,75,1,1,0,Aug-18,9,0,0
11202,user_11202,2584,54,33,21,Apr-19,1,1,0
11203,user_11203,631358,558,237,321,May-19,0,1,1
11204,user_11204,13513,286,194,92,May-19,0,1,1
11205,user_11205,361,43,30,13,Mar-19,2,0,0
11206,user_11206,982,32,2,30,May-19,0,1,1
11207,user_11207,31,1,1,0,Sep-18,8,0,0
11208,user_11208,363,5,5,0,Sep-18,8,0,0
11209,user_11209,34257,406,230,176,May-19,0,1,1
11210,user_11210,89126,90,57,33,May-19,0,1,1
11211,user_11211,4835,136,3,133,May-19,0,1,1
11212,user_11212,15207,224,93,131,May-19,0,1,1
11213,user_11213,6226,104,48,56,May-19,0,1,1
11214,user_11214,9,5,0,5,May-19,0,1,1
11215,user_11215,52614,426,102,324,Apr-19,1,1,0
11216,user_11216,454,43,43,0,Dec-18,5,0,0
11217,user_11217,1103,15,12,3,May-19,0,1,1
11218,user_11218,1017,34,0,34,May-19,0,1,1
11219,user_11219,30104,442,162,280,May-19,0,1,1
11221,user_11221,0,1,1,0,Sep-18,8,0,0
11222,user_11222,147,13,8,5,May-19,0,1,1
11223,user_11223,209,13,12,1,Feb-19,3,0,0
11224,user_11224,48401,261,93,168,May-19,0,1,1
11225,user_11225,4350,102,66,36,Apr-19,1,1,0
11226,user_11226,2388,43,16,27,May-19,0,1,1
11227,user_11227,46,9,8,1,Apr-19,1,1,0
11228,user_11228,644,33,20,13,Apr-19,1,1,0
11229,user_11229,38962,693,376,317,May-19,0,1,1
11230,user_11230,11227,115,57,58,May-19,0,1,1
11231,user_11231,2807,105,46,59,May-19,0,1,1
11232,user_11232,4322,73,68,5,May-19,0,0,1
11233,user_11233,297,25,24,1,Feb-19,3,0,0
11234,user_11234,3134,99,23,76,Apr-19,1,1,0
11235,user_11235,1405,47,33,14,Jan-19,4,0,0
11236,user_11236,9703,186,147,39,May-19,0,1,1
11238,user_11238,306,29,21,8,Apr-19,1,1,0
11239,user_11239,9542,289,59,230,May-19,0,1,1
11240,user_11240,2036,89,66,23,Mar-19,2,0,0
11241,user_11241,18508,571,86,485,May-19,0,1,1
11242,user_11242,156501,148,90,58,Apr-19,1,1,0
11243,user_11243,1514,44,17,27,May-19,0,1,1
11244,user_11244,6641,299,279,20,Apr-19,1,1,0
11245,user_11245,15333,15,3,12,Apr-19,1,1,0
11246,user_11246,2571,10,8,2,Mar-19,2,0,0
11247,user_11247,4,2,2,0,Aug-18,9,0,0
11248,user_11248,1674,42,19,23,Mar-19,2,0,0
11249,user_11249,4418,86,38,48,May-19,0,1,1
11250,user_11250,235,16,11,5,May-19,0,0,1
11251,user_11251,9754,882,444,438,May-19,0,1,1
11252,user_11252,28584,1263,373,890,May-19,0,1,1
11253,user_11253,5228,378,156,222,May-19,0,1,1
11254,user_11254,1388,46,4,42,Apr-19,1,1,0
11255,user_11255,1189,46,22,24,May-19,0,1,1
11256,user_11256,15043,146,80,66,Apr-19,1,1,0
11257,user_11257,387,13,13,0,Dec-18,5,0,0
11258,user_11258,4826,277,117,160,May-19,0,1,1
11259,user_11259,98009,529,225,304,May-19,0,1,1
11260,user_11260,2392,118,84,34,Apr-19,1,1,0
11261,user_11261,23690,54,52,2,Jan-19,4,0,0
11262,user_11262,80151,1376,499,877,May-19,0,1,1
11263,user_11263,3594,233,22,211,Apr-19,1,1,0
11264,user_11264,506,43,40,3,Mar-19,2,0,0
11265,user_11265,3080,52,21,31,May-19,0,1,1
11266,user_11266,28,3,3,0,Dec-18,5,0,0
11267,user_11267,2813,458,315,143,Apr-19,1,1,0
11268,user_11268,212,8,8,0,Dec-18,5,0,0
11269,user_11269,3428,36,26,10,Mar-19,2,0,0
11270,user_11270,178,9,9,0,Oct-18,7,0,0
11271,user_11271,43,7,7,0,Sep-18,8,0,0
11272,user_11272,4253,126,80,46,Apr-19,1,1,0
11273,user_11273,44,7,6,1,Apr-19,1,1,0
11274,user_11274,1083,20,8,12,Jan-19,4,0,0
11275,user_11275,4679,74,48,26,Mar-19,2,0,0
11276,user_11276,42,6,6,0,Dec-18,5,0,0
11277,user_11277,1282,70,35,35,Mar-19,2,0,0
11278,user_11278,16496,143,15,128,May-19,0,1,1
11279,user_11279,4077,39,30,9,Feb-19,3,0,0
11280,user_11280,11481,206,160,46,May-19,0,0,1
11281,user_11281,14436,352,141,211,May-19,0,1,1
11282,user_11282,2312,15,15,0,Oct-18,7,0,0
11283,user_11283,27248,280,24,256,May-19,0,1,1
11284,user_11284,25222,918,519,399,May-19,0,1,1
11285,user_11285,2522,145,68,77,May-19,0,1,1
11286,user_11286,1199,19,14,5,Jan-19,4,0,0
11287,user_11287,5094,58,58,0,Nov-18,6,0,0
11288,user_11288,562,26,11,15,May-19,0,1,1
11289,user_11289,2170,293,178,115,May-19,0,1,1
11290,user_11290,2552,35,34,1,Jan-19,4,0,0
11291,user_11291,566,21,9,12,Feb-19,3,0,0
11292,user_11292,175,31,25,6,May-19,0,1,1
11293,user_11293,25899,456,157,299,May-19,0,1,1
11294,user_11294,947,223,123,100,May-19,0,1,1
11295,user_11295,2088,107,73,34,May-19,0,1,1
11296,user_11296,9,1,1,0,Aug-18,9,0,0
11297,user_11297,2877,40,40,0,Sep-18,8,0,0
11298,user_11298,9,1,1,0,Aug-18,9,0,0
11299,user_11299,2574,59,15,44,Apr-19,1,1,0
11300,user_11300,9303,426,230,196,May-19,0,1,1
11301,user_11301,651,19,1,18,Mar-19,2,0,0
11302,user_11302,8,4,4,0,Aug-18,9,0,0
11303,user_11303,1339,14,12,2,Jan-19,4,0,0
11304,user_11304,502,21,17,4,Jan-19,4,0,0
11305,user_11305,116,4,3,1,May-19,0,0,1
11306,user_11306,16,3,3,0,Sep-18,8,0,0
11307,user_11307,139,6,6,0,Sep-18,8,0,0
11308,user_11308,26136,392,40,352,May-19,0,1,1
11309,user_11309,17045,819,391,428,May-19,0,1,1
11310,user_11310,10423,317,85,232,May-19,0,1,1
11311,user_11311,4291,43,43,0,Sep-18,8,0,0
11312,user_11312,57436,36,16,20,May-19,0,1,1
11313,user_11313,3655,110,55,55,Apr-19,1,1,0
11314,user_11314,10345,481,238,243,May-19,0,1,1
11315,user_11315,10166,134,133,1,Mar-19,2,0,0
11316,user_11316,3496,55,54,1,Feb-19,3,0,0
11317,user_11317,15,2,2,0,Aug-18,9,0,0
11318,user_11318,21,3,3,0,Aug-18,9,0,0
11319,user_11319,22796,341,93,248,May-19,0,1,1
11320,user_11320,14380,31,8,23,Apr-19,1,1,0
11321,user_11321,3740,84,14,70,May-19,0,1,1
11322,user_11322,1614,54,54,0,Oct-18,7,0,0
11323,user_11323,2625,203,115,88,May-19,0,1,1
11324,user_11324,4134,72,36,36,May-19,0,1,1
11325,user_11325,58437,1064,145,919,May-19,0,1,1
11326,user_11326,263,40,37,3,Jan-19,4,0,0
11327,user_11327,22629,420,320,100,May-19,0,1,1
11329,user_11329,2043,261,148,113,May-19,0,1,1
11330,user_11330,18817,819,0,819,May-19,0,1,1
11332,user_11332,19011,630,387,243,May-19,0,1,1
11333,user_11333,1564,43,43,0,Dec-18,5,0,0
11334,user_11334,20,24,24,0,Oct-18,7,0,0
11335,user_11335,726,54,47,7,Apr-19,1,1,0
11336,user_11336,125,9,9,0,Sep-18,8,0,0
11337,user_11337,12,2,2,0,Aug-18,9,0,0
11338,user_11338,2643,687,75,612,May-19,0,1,1
11339,user_11339,632,9,3,6,Apr-19,1,1,0
11340,user_11340,1700,73,60,13,Apr-19,1,1,0
11341,user_11341,730,25,21,4,Apr-19,1,1,0
11342,user_11342,342,43,0,43,May-19,0,1,1
11343,user_11343,176,13,13,0,Aug-18,9,0,0
11344,user_11344,4388,220,74,146,May-19,0,1,1
11345,user_11345,4583,69,69,0,Dec-18,5,0,0
11346,user_11346,700,46,22,24,Apr-19,1,1,0
11347,user_11347,6962,147,125,22,Apr-19,1,1,0
11348,user_11348,2450,154,94,60,Apr-19,1,1,0
11349,user_11349,2511,61,21,40,Apr-19,1,1,0
11350,user_11350,4115,247,131,116,Apr-19,1,1,0
11351,user_11351,18635,288,236,52,May-19,0,1,1
11352,user_11352,191,18,11,7,Mar-19,2,0,0
11353,user_11353,12207,152,119,33,Apr-19,1,1,0
11354,user_11354,1770,21,21,0,Nov-18,6,0,0
11355,user_11355,2635,120,56,64,May-19,0,1,1
11356,user_11356,2739,56,36,20,Jan-19,4,0,0
11357,user_11357,1476,84,5,79,Apr-19,1,1,0
11358,user_11358,518,49,17,32,May-19,0,1,1
11359,user_11359,2641,44,37,7,May-19,0,0,1
11360,user_11360,9557,28,2,26,May-19,0,1,1
11361,user_11361,526,20,13,7,Apr-19,1,1,0
11362,user_11362,3679,72,45,27,Mar-19,2,0,0
11363,user_11363,9760,253,103,150,May-19,0,1,1
11365,user_11365,8315,61,20,41,May-19,0,1,1
11366,user_11366,3829,81,81,0,Nov-18,6,0,0
11367,user_11367,93,4,4,0,Sep-18,8,0,0
11368,user_11368,3466,90,89,1,Jan-19,4,0,0
11369,user_11369,152,19,16,3,Mar-19,2,0,0
11370,user_11370,15675,362,45,317,May-19,0,1,1
11371,user_11371,93,12,12,0,Nov-18,6,0,0
11372,user_11372,91,6,6,0,Sep-18,8,0,0
11373,user_11373,14933,53,41,12,Apr-19,1,1,0
11374,user_11374,5646,72,27,45,May-19,0,1,1
11375,user_11375,1025,65,38,27,May-19,0,1,1
11376,user_11376,50282,60,18,42,May-19,0,1,1
11377,user_11377,1504,43,34,9,May-19,0,1,1
11378,user_11378,6967,147,83,64,Apr-19,1,1,0
11379,user_11379,2105,56,38,18,May-19,0,1,1
11380,user_11380,6064,549,289,260,May-19,0,1,1
11381,user_11381,1608,54,48,6,Feb-19,3,0,0
11383,user_11383,21,3,3,0,Aug-18,9,0,0
11384,user_11384,22,2,2,0,Aug-18,9,0,0
11385,user_11385,6077,83,26,57,May-19,0,1,1
11386,user_11386,32,6,4,2,Feb-19,3,0,0
11387,user_11387,2811,55,15,40,Apr-19,1,1,0
11388,user_11388,332,31,23,8,May-19,0,1,1
11389,user_11389,1516,77,60,17,May-19,0,1,1
11390,user_11390,753,42,36,6,Mar-19,2,0,0
11391,user_11391,8263,83,37,46,May-19,0,1,1
11392,user_11392,8288,111,66,45,May-19,0,1,1
11393,user_11393,13914,41,37,4,Jan-19,4,0,0
11394,user_11394,96,2,2,0,Dec-18,5,0,0
11395,user_11395,9336,603,193,410,May-19,0,1,1
11396,user_11396,157,41,24,17,Apr-19,1,1,0
11397,user_11397,30,6,6,0,Dec-18,5,0,0
11398,user_11398,56997,1173,502,671,May-19,0,1,1
11399,user_11399,11020,146,60,86,May-19,0,1,1
11400,user_11400,4762,360,68,292,May-19,0,1,1
11401,user_11401,6283,119,93,26,Mar-19,2,0,0
11402,user_11402,4947,65,43,22,May-19,0,1,1
11403,user_11403,2246,67,52,15,Apr-19,1,1,0
11405,user_11405,1051,53,18,35,May-19,0,1,1
11406,user_11406,21,3,3,0,Sep-18,8,0,0
11407,user_11407,103,10,8,2,Apr-19,1,1,0
11408,user_11408,12476,156,105,51,May-19,0,1,1
11409,user_11409,9370,518,293,225,May-19,0,1,1
11410,user_11410,26627,23,23,0,Sep-18,8,0,0
11411,user_11411,27003,268,167,101,May-19,0,1,1
11412,user_11412,248,14,10,4,Apr-19,1,1,0
11413,user_11413,2190,176,121,55,May-19,0,0,1
11414,user_11414,1095,50,45,5,Jan-19,4,0,0
11415,user_11415,9619,734,357,377,May-19,0,1,1
11416,user_11416,509,6,6,0,Oct-18,7,0,0
11417,user_11417,10405,271,68,203,May-19,0,1,1
11418,user_11418,202,44,22,22,May-19,0,1,1
11419,user_11419,11658,559,87,472,May-19,0,1,1
11420,user_11420,406,32,26,6,Mar-19,2,0,0
11421,user_11421,887,17,16,1,Feb-19,3,0,0
11422,user_11422,28,5,5,0,Oct-18,7,0,0
11423,user_11423,3023,110,58,52,Apr-19,1,1,0
11424,user_11424,762454,175,124,51,May-19,0,1,1
11425,user_11425,2580,23,3,20,May-19,0,0,1
11426,user_11426,2986,97,54,43,May-19,0,1,1
11427,user_11427,1170,44,37,7,Mar-19,2,0,0
11428,user_11428,7,4,4,0,Aug-18,9,0,0
11429,user_11429,14868,455,213,242,May-19,0,1,1
11430,user_11430,6152,132,2,130,May-19,0,1,1
11431,user_11431,959,103,3,100,May-19,0,1,1
11433,user_11433,1047,12,2,10,May-19,0,0,1
11434,user_11434,2043,58,40,18,May-19,0,1,1
11435,user_11435,5290,483,375,108,May-19,0,1,1
11436,user_11436,1219,36,31,5,Apr-19,1,1,0
11437,user_11437,6862,114,44,70,May-19,0,1,1
11438,user_11438,31,16,16,0,Oct-18,7,0,0
11440,user_11440,127,7,3,4,Apr-19,1,1,0
11441,user_11441,3596,90,34,56,May-19,0,1,1
11442,user_11442,81,6,5,1,Mar-19,2,0,0
11443,user_11443,24060,698,235,463,May-19,0,1,1
11444,user_11444,1036,29,29,0,Oct-18,7,0,0
11445,user_11445,445,32,3,29,May-19,0,1,1
11446,user_11446,566,28,28,0,Sep-18,8,0,0
11447,user_11447,26831,474,157,317,May-19,0,1,1
11448,user_11448,4023,62,42,20,May-19,0,1,1
11449,user_11449,16310,1088,687,401,May-19,0,1,1
11450,user_11450,2076,36,36,0,Sep-18,8,0,0
11451,user_11451,1003,80,31,49,May-19,0,1,1
11453,user_11453,1505,159,54,105,May-19,0,1,1
11454,user_11454,750,17,8,9,Apr-19,1,1,0
11455,user_11455,4211,218,119,99,Apr-19,1,1,0
11456,user_11456,9460,429,227,202,May-19,0,1,1
11457,user_11457,4055,99,96,3,Apr-19,1,1,0
11458,user_11458,4298,157,52,105,May-19,0,1,1
11459,user_11459,119931,104,4,100,May-19,0,1,1
11460,user_11460,12142,392,343,49,Feb-19,3,0,0
11461,user_11461,40372,199,105,94,May-19,0,1,1
11462,user_11462,2230,84,3,81,May-19,0,1,1
11463,user_11463,9597,155,76,79,May-19,0,1,1
11464,user_11464,7511,225,132,93,Apr-19,1,1,0
11465,user_11465,2,1,1,0,Aug-18,9,0,0
11466,user_11466,21174,120,68,52,May-19,0,1,1
11468,user_11468,5368,29,12,17,May-19,0,1,1
11469,user_11469,5744,655,241,414,May-19,0,1,1
11470,user_11470,1738,244,203,41,May-19,0,1,1
11471,user_11471,1485,44,44,0,Oct-18,7,0,0
11472,user_11472,4757,220,151,69,Apr-19,1,1,0
11473,user_11473,214,8,8,0,Sep-18,8,0,0
11474,user_11474,1666,90,90,0,Dec-18,5,0,0
11475,user_11475,31002,294,131,163,May-19,0,1,1
11476,user_11476,2,2,2,0,Oct-18,7,0,0
11477,user_11477,10833,138,5,133,May-19,0,0,1
11478,user_11478,11248,185,121,64,May-19,0,1,1
11479,user_11479,6801,635,125,510,May-19,0,1,1
11480,user_11480,4,3,3,0,Aug-18,9,0,0
11481,user_11481,57733,188,132,56,May-19,0,1,1
11482,user_11482,11,2,2,0,Aug-18,9,0,0
11483,user_11483,899,46,32,14,Apr-19,1,1,0
11484,user_11484,2015,87,43,44,May-19,0,1,1
11485,user_11485,3264,227,120,107,May-19,0,1,1
11486,user_11486,1377,64,36,28,May-19,0,1,1
11487,user_11487,4342,26,13,13,May-19,0,1,1
11488,user_11488,5954,1339,864,475,Apr-19,1,1,0
11489,user_11489,3352,178,77,101,May-19,0,1,1
11490,user_11490,2699,105,100,5,May-19,0,0,1
11491,user_11491,3920,24,24,0,Aug-18,9,0,0
11492,user_11492,20871,671,3,668,May-19,0,1,1
11493,user_11493,1019,36,34,2,Feb-19,3,0,0
11494,user_11494,41,5,4,1,Mar-19,2,0,0
11495,user_11495,11524,121,84,37,May-19,0,1,1
11496,user_11496,12851,352,148,204,May-19,0,1,1
11497,user_11497,7347,129,49,80,May-19,0,1,1
11498,user_11498,16093,262,154,108,May-19,0,1,1
11501,user_11501,13568,393,372,21,Mar-19,2,0,0
11502,user_11502,270,7,7,0,Oct-18,7,0,0
11503,user_11503,2583,199,66,133,May-19,0,1,1
11504,user_11504,485,23,21,2,Mar-19,2,0,0
11505,user_11505,403,22,13,9,Apr-19,1,1,0
11506,user_11506,13052,1055,307,748,May-19,0,1,1
11507,user_11507,1586,50,48,2,May-19,0,0,1
11508,user_11508,4168,72,41,31,May-19,0,1,1
11509,user_11509,154,18,11,7,May-19,0,1,1
11510,user_11510,471,55,37,18,May-19,0,1,1
11511,user_11511,24548,105,90,15,Mar-19,2,0,0
11513,user_11513,10271,207,127,80,May-19,0,1,1
11515,user_11515,10821,246,68,178,May-19,0,1,1
11516,user_11516,10,1,1,0,Aug-18,9,0,0
11517,user_11517,1557,54,14,40,May-19,0,1,1
11518,user_11518,4164,52,20,32,May-19,0,0,1
11519,user_11519,6,5,5,0,Aug-18,9,0,0
11520,user_11520,10,1,1,0,Aug-18,9,0,0
11521,user_11521,2972,127,62,65,May-19,0,1,1
11522,user_11522,4597,240,12,228,May-19,0,1,1
11523,user_11523,1208,67,67,0,Sep-18,8,0,0
11524,user_11524,5191,119,73,46,Apr-19,1,1,0
11525,user_11525,64903,343,77,266,May-19,0,1,1
11526,user_11526,9109,1041,373,668,May-19,0,1,1
11527,user_11527,556,149,98,51,May-19,0,1,1
11528,user_11528,5587,215,144,71,Apr-19,1,1,0
11529,user_11529,120,5,5,0,Sep-18,8,0,0
11530,user_11530,20054,9,6,3,Apr-19,1,1,0
11531,user_11531,11470,462,248,214,May-19,0,1,1
11532,user_11532,1312,19,10,9,Apr-19,1,1,0
11533,user_11533,89,9,8,1,Feb-19,3,0,0
11534,user_11534,1728,152,149,3,Apr-19,1,1,0
11535,user_11535,26126,457,254,203,May-19,0,1,1
11536,user_11536,2453,70,34,36,Feb-19,3,0,0
11537,user_11537,1210,63,63,0,Dec-18,5,0,0
11538,user_11538,349,38,24,14,Apr-19,1,1,0
11539,user_11539,9,1,1,0,Sep-18,8,0,0
11540,user_11540,136,9,5,4,Feb-19,3,0,0
11541,user_11541,18,3,3,0,Sep-18,8,0,0
11542,user_11542,4919,125,86,39,May-19,0,1,1
11543,user_11543,5905,89,75,14,May-19,0,1,1
11544,user_11544,1737,42,1,41,May-19,0,1,1
11545,user_11545,159,6,6,0,Sep-18,8,0,0
11546,user_11546,5183,17,8,9,Apr-19,1,1,0
11547,user_11547,9,2,2,0,Sep-18,8,0,0
11548,user_11548,1753,26,21,5,Apr-19,1,1,0
11549,user_11549,260,15,12,3,Apr-19,1,1,0
11550,user_11550,17062,382,176,206,Apr-19,1,1,0
11551,user_11551,446,29,29,0,Sep-18,8,0,0
11552,user_11552,713,48,28,20,May-19,0,1,1
11553,user_11553,622,30,25,5,Feb-19,3,0,0
11554,user_11554,150,6,6,0,Oct-18,7,0,0
11555,user_11555,11836,184,48,136,May-19,0,1,1
11556,user_11556,2905,92,54,38,Mar-19,2,0,0
11557,user_11557,225,37,2,35,Apr-19,1,1,0
11558,user_11558,1335,50,48,2,Feb-19,3,0,0
11559,user_11559,1448,9,0,9,Apr-19,1,1,0
11560,user_11560,9,2,2,0,Sep-18,8,0,0
11561,user_11561,305,3,3,0,Sep-18,8,0,0
11562,user_11562,4262,136,110,26,Apr-19,1,1,0
11563,user_11563,25594,483,179,304,May-19,0,1,1
11564,user_11564,1079,93,31,62,May-19,0,1,1
11565,user_11565,8907,352,146,206,May-19,0,1,1
11566,user_11566,23,8,6,2,Jan-19,4,0,0
11567,user_11567,2591,59,58,1,Apr-19,1,1,0
11569,user_11569,2097,65,51,14,Feb-19,3,0,0
11570,user_11570,17030,415,248,167,Mar-19,2,0,0
11571,user_11571,749,54,9,45,May-19,0,1,1
11572,user_11572,228,24,18,6,Mar-19,2,0,0
11573,user_11573,318,4,4,0,Dec-18,5,0,0
11574,user_11574,589,17,16,1,Apr-19,1,1,0
11575,user_11575,25116,76,37,39,May-19,0,1,1
11576,user_11576,1658,39,23,16,May-19,0,1,1
11577,user_11577,198,10,10,0,Sep-18,8,0,0
11578,user_11578,35,14,14,0,Nov-18,6,0,0
11579,user_11579,5808,67,9,58,May-19,0,1,1
11580,user_11580,22047,338,159,179,Apr-19,1,1,0
11581,user_11581,4306,204,12,192,May-19,0,1,1
11582,user_11582,2769,116,61,55,May-19,0,1,1
11583,user_11583,1118,51,42,9,Apr-19,1,1,0
11584,user_11584,5906,8,6,2,May-19,0,0,1
11585,user_11585,2046,29,29,0,Nov-18,6,0,0
11586,user_11586,37579,752,378,374,May-19,0,1,1
11587,user_11587,8077,134,127,7,May-19,0,0,1
11588,user_11588,928,32,15,17,Apr-19,1,1,0
11589,user_11589,10793,139,52,87,May-19,0,1,1
11590,user_11590,23468,340,170,170,May-19,0,1,1
11591,user_11591,2848,72,39,33,May-19,0,1,1
11592,user_11592,14598,276,253,23,May-19,0,1,1
11593,user_11593,648,37,6,31,May-19,0,1,1
11594,user_11594,4159,25,18,7,Apr-19,1,1,0
11595,user_11595,3689,90,29,61,May-19,0,1,1
11596,user_11596,31341,552,176,376,May-19,0,1,1
11597,user_11597,104609,523,180,343,May-19,0,1,1
11598,user_11598,1263,48,0,48,Mar-19,2,0,0
11599,user_11599,1365,38,26,12,May-19,0,1,1
11600,user_11600,8721,224,81,143,May-19,0,1,1
11601,user_11601,6281,304,55,249,May-19,0,1,1
11602,user_11602,4858,118,73,45,May-19,0,1,1
11603,user_11603,4157,190,96,94,May-19,0,1,1
11604,user_11604,10,7,0,7,Mar-19,2,0,0
11605,user_11605,4307,485,198,287,May-19,0,1,1
11606,user_11606,16996,250,43,207,May-19,0,1,1
11607,user_11607,9580,194,136,58,May-19,0,1,1
11608,user_11608,9112,527,268,259,May-19,0,1,1
11609,user_11609,2692,77,41,36,May-19,0,1,1
11610,user_11610,877,26,17,9,May-19,0,1,1
11611,user_11611,29620,682,1,681,May-19,0,1,1
11612,user_11612,214,4,2,2,Apr-19,1,1,0
11613,user_11613,3242,107,66,41,May-19,0,1,1
11614,user_11614,1743,43,30,13,Mar-19,2,0,0
11615,user_11615,13577,103,25,78,May-19,0,1,1
11616,user_11616,22536,304,166,138,May-19,0,1,1
11617,user_11617,1860,29,14,15,Mar-19,2,0,0
11618,user_11618,6442,170,29,141,May-19,0,1,1
11619,user_11619,1091,116,69,47,May-19,0,1,1
11620,user_11620,3479,19,0,19,Apr-19,1,1,0
11621,user_11621,1144,119,9,110,May-19,0,1,1
11622,user_11622,227,13,2,11,May-19,0,1,1
11623,user_11623,11336,27,13,14,May-19,0,1,1
11624,user_11624,13230,63,19,44,May-19,0,1,1
11626,user_11626,237,57,40,17,Apr-19,1,1,0
11627,user_11627,23,15,15,0,Nov-18,6,0,0
11628,user_11628,15509,194,97,97,May-19,0,1,1
11629,user_11629,1084,61,18,43,May-19,0,1,1
11630,user_11630,56882,355,121,234,May-19,0,1,1
11631,user_11631,12064,37,19,18,May-19,0,1,1
11632,user_11632,4448,132,52,80,May-19,0,1,1
11633,user_11633,1785,46,13,33,Apr-19,1,1,0
11634,user_11634,951,29,29,0,Dec-18,5,0,0
11635,user_11635,22781,396,173,223,May-19,0,1,1
11636,user_11636,1784,71,52,19,Apr-19,1,1,0
11637,user_11637,27394,366,115,251,May-19,0,1,1
11638,user_11638,416,29,4,25,May-19,0,1,1
11639,user_11639,3511,105,57,48,May-19,0,1,1
11640,user_11640,673,29,26,3,Mar-19,2,0,0
11641,user_11641,19660,42,26,16,Mar-19,2,0,0
11642,user_11642,969,14,3,11,Apr-19,1,1,0
11643,user_11643,25,1,1,0,Sep-18,8,0,0
11644,user_11644,152,5,5,0,Dec-18,5,0,0
11645,user_11645,27,4,4,0,Oct-18,7,0,0
11646,user_11646,6883,232,142,90,May-19,0,1,1
11647,user_11647,4064,65,65,0,Nov-18,6,0,0
11648,user_11648,3914,74,29,45,May-19,0,1,1
11649,user_11649,33346,527,232,295,May-19,0,1,1
11650,user_11650,17574,203,106,97,May-19,0,1,1
11651,user_11651,411,23,8,15,Apr-19,1,1,0
11652,user_11652,8808,205,140,65,Jan-19,4,0,0
11653,user_11653,136,5,3,2,Mar-19,2,0,0
11654,user_11654,1029,65,9,56,May-19,0,1,1
11655,user_11655,3092,87,38,49,May-19,0,1,1
11656,user_11656,16,3,3,0,Sep-18,8,0,0
11657,user_11657,1840,123,39,84,May-19,0,1,1
11658,user_11658,114,11,6,5,May-19,0,1,1
11659,user_11659,8353,213,143,70,Mar-19,2,0,0
11661,user_11661,1289,126,93,33,May-19,0,1,1
11662,user_11662,262,33,11,22,May-19,0,1,1
11663,user_11663,4,1,1,0,Sep-18,8,0,0
11665,user_11665,193,5,3,2,Jan-19,4,0,0
11666,user_11666,69,6,6,0,Oct-18,7,0,0
11667,user_11667,870,30,23,7,Apr-19,1,1,0
11669,user_11669,2162,144,77,67,May-19,0,1,1
11670,user_11670,13830,236,197,39,May-19,0,1,1
11671,user_11671,2656,64,38,26,May-19,0,1,1
11672,user_11672,542,47,23,24,May-19,0,1,1
11673,user_11673,48236,133,71,62,Apr-19,1,1,0
11674,user_11674,1172,66,66,0,Dec-18,5,0,0
11676,user_11676,187,12,8,4,Apr-19,1,1,0
11677,user_11677,2096,40,36,4,Jan-19,4,0,0
11678,user_11678,1747,29,22,7,May-19,0,1,1
11679,user_11679,9979,171,111,60,May-19,0,1,1
11680,user_11680,1352,71,0,71,May-19,0,1,1
11681,user_11681,3524,15,15,0,Nov-18,6,0,0
11682,user_11682,5474,13,3,10,Mar-19,2,0,0
11683,user_11683,797,62,20,42,May-19,0,1,1
11684,user_11684,9703,705,221,484,May-19,0,1,1
11685,user_11685,8776,83,7,76,May-19,0,1,1
11686,user_11686,11890,72,61,11,Apr-19,1,1,0
11687,user_11687,515,14,14,0,Oct-18,7,0,0
11688,user_11688,14,3,3,0,Sep-18,8,0,0
11689,user_11689,3192,105,85,20,Apr-19,1,1,0
11690,user_11690,19021,614,200,414,May-19,0,1,1
11691,user_11691,8942,370,42,328,May-19,0,1,1
11692,user_11692,3368,117,47,70,May-19,0,1,1
11693,user_11693,12502,468,268,200,May-19,0,1,1
11694,user_11694,161,14,14,0,Nov-18,6,0,0
11695,user_11695,1818,118,22,96,May-19,0,1,1
11696,user_11696,2419,47,35,12,Mar-19,2,0,0
11697,user_11697,6206,301,131,170,May-19,0,1,1
11698,user_11698,1476,231,74,157,May-19,0,1,1
11700,user_11700,4811,185,126,59,Apr-19,1,1,0
11701,user_11701,798,37,3,34,May-19,0,1,1
11703,user_11703,19569,103,8,95,May-19,0,1,1
11704,user_11704,28101,321,117,204,May-19,0,1,1
11705,user_11705,328380,1835,624,1211,May-19,0,1,1
11706,user_11706,730,28,19,9,May-19,0,0,1
11707,user_11707,610,43,25,18,Apr-19,1,1,0
11708,user_11708,395,10,3,7,Mar-19,2,0,0
11709,user_11709,2391,58,23,35,May-19,0,1,1
11710,user_11710,6400,115,54,61,Apr-19,1,1,0
11711,user_11711,97,11,5,6,Mar-19,2,0,0
11712,user_11712,2256,60,0,60,Mar-19,2,0,0
11713,user_11713,8260,115,53,62,May-19,0,1,1
11714,user_11714,1175,25,15,10,Apr-19,1,1,0
11715,user_11715,207220,86,59,27,Feb-19,3,0,0
11716,user_11716,4226,471,251,220,May-19,0,1,1
11717,user_11717,3490,117,60,57,May-19,0,1,1
11718,user_11718,9038,507,131,376,May-19,0,1,1
11719,user_11719,43,2,2,0,Sep-18,8,0,0
11721,user_11721,3072,72,59,13,Apr-19,1,1,0
11723,user_11723,210,34,1,33,Apr-19,1,1,0
11724,user_11724,31896,217,57,160,Apr-19,1,1,0
11725,user_11725,2611,45,34,11,May-19,0,1,1
11726,user_11726,675,119,42,77,May-19,0,1,1
11727,user_11727,136,2,2,0,Oct-18,7,0,0
11728,user_11728,15,2,2,0,Sep-18,8,0,0
11729,user_11729,2797,98,64,34,Apr-19,1,1,0
11730,user_11730,57,1,1,0,Sep-18,8,0,0
11731,user_11731,4605,87,11,76,May-19,0,1,1
11732,user_11732,72,5,5,0,Sep-18,8,0,0
11733,user_11733,9,2,2,0,Sep-18,8,0,0
11734,user_11734,4006,11,7,4,Feb-19,3,0,0
11735,user_11735,39,7,7,0,Oct-18,7,0,0
11736,user_11736,41738,379,185,194,May-19,0,1,1
11737,user_11737,3389,94,90,4,Mar-19,2,0,0
11738,user_11738,28,1,0,1,Mar-19,2,0,0
11739,user_11739,2501,238,92,146,May-19,0,1,1
11740,user_11740,22,4,4,0,Sep-18,8,0,0
11741,user_11741,9832,145,54,91,May-19,0,1,1
11742,user_11742,2265,73,56,17,Apr-19,1,1,0
11743,user_11743,1806,17,0,17,May-19,0,1,1
11744,user_11744,3850,141,116,25,Feb-19,3,0,0
11745,user_11745,14,3,3,0,Sep-18,8,0,0
11746,user_11746,286,7,7,0,Oct-18,7,0,0
11747,user_11747,3947,27,13,14,Apr-19,1,1,0
11748,user_11748,272,32,10,22,May-19,0,1,1
11749,user_11749,898,75,39,36,Mar-19,2,0,0
11750,user_11750,69,14,11,3,Jan-19,4,0,0
11751,user_11751,11338,62,53,9,Apr-19,1,1,0
11752,user_11752,40,4,4,0,Oct-18,7,0,0
11753,user_11753,15,2,2,0,Sep-18,8,0,0
11754,user_11754,498,43,43,0,Nov-18,6,0,0
11755,user_11755,6722,84,66,18,Mar-19,2,0,0
11756,user_11756,238,18,18,0,Nov-18,6,0,0
11757,user_11757,22,5,5,0,Nov-18,6,0,0
11758,user_11758,509,15,8,7,Apr-19,1,1,0
11759,user_11759,3345,41,41,0,Nov-18,6,0,0
11760,user_11760,11237,438,240,198,May-19,0,1,1
11761,user_11761,365,32,7,25,Mar-19,2,0,0
11762,user_11762,14995,112,47,65,Apr-19,1,1,0
11763,user_11763,324,132,97,35,May-19,0,1,1
11764,user_11764,4196,168,94,74,May-19,0,1,1
11765,user_11765,1286,27,9,18,Feb-19,3,0,0
11766,user_11766,874,17,15,2,Jan-19,4,0,0
11767,user_11767,10356,70,10,60,May-19,0,1,1
11768,user_11768,7938,27,19,8,Apr-19,1,1,0
11769,user_11769,64794,200,54,146,May-19,0,1,1
11770,user_11770,51228,935,571,364,May-19,0,1,1
11771,user_11771,18,3,3,0,Sep-18,8,0,0
11772,user_11772,282,14,6,8,Jan-19,4,0,0
11773,user_11773,8,2,2,0,Sep-18,8,0,0
11775,user_11775,3722,46,5,41,May-19,0,1,1
11776,user_11776,237,6,6,0,Sep-18,8,0,0
11777,user_11777,3653,46,34,12,Apr-19,1,1,0
11778,user_11778,12136,619,460,159,Apr-19,1,1,0
11779,user_11779,7498,474,282,192,Apr-19,1,1,0
11780,user_11780,52455,445,60,385,May-19,0,1,1
11781,user_11781,4848,37,20,17,May-19,0,1,1
11782,user_11782,13375,250,85,165,May-19,0,1,1
11783,user_11783,353,19,19,0,Nov-18,6,0,0
11784,user_11784,3590,44,37,7,Apr-19,1,1,0
11785,user_11785,1013,39,5,34,Apr-19,1,1,0
11786,user_11786,656,7,0,7,May-19,0,0,1
11787,user_11787,30,12,8,4,Mar-19,2,0,0
11788,user_11788,4471,47,40,7,Feb-19,3,0,0
11789,user_11789,3052,85,52,33,May-19,0,1,1
11790,user_11790,23,4,4,0,Oct-18,7,0,0
11791,user_11791,711,14,7,7,Feb-19,3,0,0
11792,user_11792,850,21,0,21,Apr-19,1,1,0
11793,user_11793,251,4,4,0,Sep-18,8,0,0
11794,user_11794,3413,104,76,28,May-19,0,1,1
11795,user_11795,171,8,8,0,Nov-18,6,0,0
11796,user_11796,1222,33,3,30,Apr-19,1,1,0
11797,user_11797,15113,434,187,247,May-19,0,1,1
11798,user_11798,401,3,3,0,Oct-18,7,0,0
11799,user_11799,28356,296,8,288,May-19,0,1,1
11800,user_11800,6200,60,36,24,May-19,0,1,1
11801,user_11801,1127,78,76,2,Feb-19,3,0,0
11802,user_11802,5294,99,69,30,May-19,0,1,1
11803,user_11803,6630,161,161,0,Nov-18,6,0,0
11804,user_11804,5241,240,120,120,Feb-19,3,0,0
11805,user_11805,20397,356,304,52,May-19,0,1,1
11806,user_11806,33278,536,7,529,May-19,0,1,1
11808,user_11808,1424,116,50,66,Apr-19,1,1,0
11810,user_11810,163,16,12,4,May-19,0,1,1
11811,user_11811,5012,57,45,12,May-19,0,1,1
11812,user_11812,177,9,7,2,Jan-19,4,0,0
11813,user_11813,6089,217,187,30,Apr-19,1,1,0
11814,user_11814,6803,85,40,45,May-19,0,1,1
11815,user_11815,11205,738,420,318,May-19,0,1,1
11816,user_11816,1114,36,22,14,Apr-19,1,1,0
11817,user_11817,15745,706,582,124,May-19,0,1,1
11818,user_11818,22798,276,127,149,Apr-19,1,1,0
11819,user_11819,2460,30,25,5,May-19,0,1,1
11820,user_11820,143,4,4,0,Nov-18,6,0,0
11821,user_11821,531,8,5,3,Apr-19,1,1,0
11822,user_11822,1225,53,46,7,Apr-19,1,1,0
11823,user_11823,8482,121,91,30,May-19,0,1,1
11824,user_11824,11864,485,241,244,May-19,0,1,1
11825,user_11825,101,8,8,0,Dec-18,5,0,0
11826,user_11826,6345,338,217,121,May-19,0,1,1
11827,user_11827,525,18,3,15,Feb-19,3,0,0
11828,user_11828,13273,5,5,0,Dec-18,5,0,0
11829,user_11829,8,4,4,0,Nov-18,6,0,0
11830,user_11830,24546,190,123,67,May-19,0,1,1
11831,user_11831,8037,427,137,290,May-19,0,1,1
11832,user_11832,99,19,14,5,Jan-19,4,0,0
11833,user_11833,5785,683,398,285,May-19,0,1,1
11834,user_11834,7102,83,19,64,May-19,0,1,1
11835,user_11835,1226,43,4,39,May-19,0,1,1
11836,user_11836,21811,452,153,299,May-19,0,1,1
11837,user_11837,814,98,13,85,Apr-19,1,1,0
11838,user_11838,81653,61,39,22,Apr-19,1,1,0
11839,user_11839,4742,91,19,72,May-19,0,1,1
11840,user_11840,17682,104,34,70,May-19,0,1,1
11841,user_11841,7175,53,22,31,May-19,0,1,1
11842,user_11842,525,36,9,27,May-19,0,1,1
11843,user_11843,2555,87,38,49,May-19,0,1,1
11844,user_11844,300,48,34,14,May-19,0,0,1
11845,user_11845,9407,436,36,400,May-19,0,1,1
11846,user_11846,1432,13,7,6,Apr-19,1,1,0
11847,user_11847,253,15,6,9,Apr-19,1,1,0
11848,user_11848,12756,28,11,17,Apr-19,1,1,0
11849,user_11849,55695,763,354,409,May-19,0,1,1
11850,user_11850,946,25,17,8,Jan-19,4,0,0
11851,user_11851,549,13,10,3,May-19,0,1,1
11852,user_11852,2501,84,27,57,May-19,0,1,1
11853,user_11853,549,25,17,8,Apr-19,1,1,0
11854,user_11854,37,6,6,0,Sep-18,8,0,0
11855,user_11855,5259,281,70,211,May-19,0,1,1
11856,user_11856,26,3,3,0,Sep-18,8,0,0
11857,user_11857,15522,335,226,109,May-19,0,1,1
11858,user_11858,501,13,13,0,Nov-18,6,0,0
11859,user_11859,1388,57,46,11,May-19,0,1,1
11861,user_11861,100,19,11,8,Feb-19,3,0,0
11862,user_11862,1970,46,46,0,Nov-18,6,0,0
11863,user_11863,845,12,3,9,Mar-19,2,0,0
11864,user_11864,4255,43,31,12,May-19,0,1,1
11865,user_11865,17205,507,168,339,May-19,0,1,1
11866,user_11866,15142,387,126,261,May-19,0,1,1
11867,user_11867,989,13,8,5,Apr-19,1,1,0
11868,user_11868,17,3,3,0,Oct-18,7,0,0
11869,user_11869,9,2,2,0,Sep-18,8,0,0
11870,user_11870,1273,73,21,52,May-19,0,1,1
11871,user_11871,57,22,12,10,Mar-19,2,0,0
11872,user_11872,7952,260,60,200,May-19,0,1,1
11873,user_11873,663,59,32,27,Apr-19,1,1,0
11874,user_11874,1571,328,275,53,Apr-19,1,1,0
11876,user_11876,9,2,2,0,Oct-18,7,0,0
11877,user_11877,211678,494,328,166,May-19,0,0,1
11878,user_11878,2089,105,59,46,May-19,0,0,1
11879,user_11879,31100,471,184,287,May-19,0,1,1
11880,user_11880,19558,679,293,386,Apr-19,1,1,0
11881,user_11881,5594,128,111,17,Feb-19,3,0,0
11883,user_11883,1247,56,31,25,May-19,0,1,1
11884,user_11884,56222,109,29,80,Apr-19,1,1,0
11885,user_11885,11,2,2,0,Sep-18,8,0,0
11887,user_11887,25,3,2,1,Feb-19,3,0,0
11888,user_11888,340,6,6,0,Sep-18,8,0,0
11889,user_11889,4197,57,41,16,Mar-19,2,0,0
11890,user_11890,5726,79,7,72,Apr-19,1,1,0
11891,user_11891,103,3,3,0,Sep-18,8,0,0
11892,user_11892,3619,188,48,140,May-19,0,1,1
11894,user_11894,1327,9,7,2,Feb-19,3,0,0
11895,user_11895,6622,204,147,57,May-19,0,1,1
11896,user_11896,2766,16,10,6,May-19,0,1,1
11897,user_11897,2081,161,62,99,May-19,0,1,1
11898,user_11898,1525,41,27,14,Jan-19,4,0,0
11899,user_11899,1685,41,29,12,May-19,0,0,1
11901,user_11901,782,14,14,0,Dec-18,5,0,0
11902,user_11902,1187,77,56,21,Apr-19,1,1,0
11903,user_11903,4820,121,0,121,May-19,0,1,1
11904,user_11904,7770,36,33,3,Mar-19,2,0,0
11905,user_11905,3685,21,20,1,Jan-19,4,0,0
11906,user_11906,6406,236,183,53,May-19,0,1,1
11907,user_11907,44,8,8,0,Nov-18,6,0,0
11908,user_11908,892,23,23,0,Nov-18,6,0,0
11909,user_11909,6453,229,72,157,May-19,0,1,1
11910,user_11910,1046,81,10,71,May-19,0,1,1
11911,user_11911,780,75,59,16,May-19,0,0,1
11912,user_11912,16,7,7,0,Sep-18,8,0,0
11913,user_11913,1663,52,49,3,Jan-19,4,0,0
11914,user_11914,1066,55,9,46,May-19,0,1,1
11915,user_11915,64,32,11,21,May-19,0,1,1
11916,user_11916,3488,219,2,217,May-19,0,1,1
11917,user_11917,6734,139,56,83,May-19,0,1,1
11918,user_11918,1108,28,26,2,Mar-19,2,0,0
11919,user_11919,50,7,7,0,Dec-18,5,0,0
11920,user_11920,107,23,3,20,Apr-19,1,1,0
11921,user_11921,2430,132,69,63,May-19,0,1,1
11922,user_11922,19760,1343,371,972,May-19,0,1,1
11923,user_11923,14751,20,17,3,May-19,0,0,1
11924,user_11924,9,1,1,0,Oct-18,7,0,0
11925,user_11925,2533,75,2,73,Mar-19,2,0,0
11926,user_11926,91,18,8,10,May-19,0,1,1
11927,user_11927,1889,47,11,36,May-19,0,1,1
11928,user_11928,22064,428,191,237,May-19,0,1,1
11929,user_11929,52,8,3,5,Apr-19,1,1,0
11930,user_11930,150,6,5,1,Feb-19,3,0,0
11931,user_11931,797,36,16,20,May-19,0,1,1
11932,user_11932,4465,294,181,113,May-19,0,1,1
11933,user_11933,2149,89,70,19,May-19,0,1,1
11934,user_11934,12912,110,35,75,May-19,0,1,1
11935,user_11935,1986,83,16,67,May-19,0,1,1
11936,user_11936,4951,357,0,357,May-19,0,1,1
11937,user_11937,2486,44,44,0,Sep-18,8,0,0
11938,user_11938,1610,25,25,0,Oct-18,7,0,0
11939,user_11939,2832,40,3,37,May-19,0,1,1
11940,user_11940,6231,41,32,9,May-19,0,1,1
11942,user_11942,62704,436,93,343,May-19,0,1,1
11943,user_11943,326,51,40,11,May-19,0,0,1
11944,user_11944,293,80,0,80,May-19,0,1,1
11945,user_11945,1698,51,51,0,Dec-18,5,0,0
11946,user_11946,32073,77,32,45,Apr-19,1,1,0
11947,user_11947,3133,49,0,49,Apr-19,1,1,0
11948,user_11948,14641,356,183,173,May-19,0,1,1
11949,user_11949,3948,57,35,22,May-19,0,1,1
11950,user_11950,119,19,4,15,May-19,0,0,1
11951,user_11951,1077,46,32,14,May-19,0,1,1
11953,user_11953,19849,535,4,531,May-19,0,1,1
11954,user_11954,2556,44,21,23,May-19,0,1,1
11955,user_11955,295,40,22,18,May-19,0,1,1
11956,user_11956,488,36,26,10,Feb-19,3,0,0
11957,user_11957,68,8,8,0,Sep-18,8,0,0
11958,user_11958,756,23,21,2,Mar-19,2,0,0
11959,user_11959,2090,33,15,18,May-19,0,1,1
11960,user_11960,2994,12,12,0,Sep-18,8,0,0
11961,user_11961,2344,58,34,24,Apr-19,1,1,0
11962,user_11962,335,9,5,4,May-19,0,0,1
11963,user_11963,9304,99,11,88,May-19,0,1,1
11964,user_11964,2716,111,26,85,May-19,0,1,1
11965,user_11965,189,21,21,0,Dec-18,5,0,0
11966,user_11966,20,2,0,2,Apr-19,1,1,0
11967,user_11967,5750,192,20,172,May-19,0,1,1
11968,user_11968,8085,265,112,153,May-19,0,1,1
11969,user_11969,9689,91,80,11,Apr-19,1,1,0
11970,user_11970,18,3,3,0,Sep-18,8,0,0
11971,user_11971,1398,71,2,69,Apr-19,1,1,0
11972,user_11972,869,17,17,0,Oct-18,7,0,0
11973,user_11973,19,4,4,0,Sep-18,8,0,0
11974,user_11974,368,14,4,10,May-19,0,1,1
11975,user_11975,1019,43,34,9,Feb-19,3,0,0
11976,user_11976,767,10,6,4,Feb-19,3,0,0
11977,user_11977,65,10,10,0,Oct-18,7,0,0
11978,user_11978,1670,108,51,57,May-19,0,1,1
11979,user_11979,3116,73,47,26,Apr-19,1,1,0
11980,user_11980,257,35,20,15,May-19,0,1,1
11981,user_11981,391,49,6,43,May-19,0,1,1
11982,user_11982,740,31,16,15,Apr-19,1,1,0
11983,user_11983,33,9,3,6,May-19,0,1,1
11984,user_11984,1728,118,49,69,May-19,0,1,1
11985,user_11985,642,47,44,3,Feb-19,3,0,0
11986,user_11986,2397,35,4,31,Apr-19,1,1,0
11987,user_11987,4839,163,100,63,May-19,0,1,1
11988,user_11988,1496,24,10,14,Apr-19,1,1,0
11989,user_11989,642,23,0,23,May-19,0,1,1
11990,user_11990,15442,254,62,192,May-19,0,1,1
11991,user_11991,1358,32,32,0,Oct-18,7,0,0
11992,user_11992,15959,629,275,354,May-19,0,1,1
11993,user_11993,12711,512,165,347,May-19,0,1,1
11994,user_11994,3948,76,28,48,May-19,0,1,1
11995,user_11995,154,7,1,6,May-19,0,1,1
11996,user_11996,5,1,1,0,Oct-18,7,0,0
11997,user_11997,1756,26,16,10,May-19,0,0,1
11998,user_11998,4787,92,68,24,Apr-19,1,1,0
11999,user_11999,9,2,2,0,Sep-18,8,0,0
12000,user_12000,2822,260,110,150,May-19,0,1,1
12001,user_12001,22964,522,166,356,May-19,0,1,1
12002,user_12002,5664,143,40,103,May-19,0,1,1
12003,user_12003,37,6,0,6,Apr-19,1,1,0
12004,user_12004,462,19,19,0,Nov-18,6,0,0
12005,user_12005,470,16,15,1,Apr-19,1,1,0
12006,user_12006,1166,28,12,16,Feb-19,3,0,0
12007,user_12007,5223,274,95,179,May-19,0,1,1
12008,user_12008,35,5,5,0,Sep-18,8,0,0
12009,user_12009,1168,27,6,21,May-19,0,1,1
12010,user_12010,3853,95,19,76,May-19,0,1,1
12011,user_12011,11035,123,55,68,May-19,0,1,1
12012,user_12012,8176,682,38,644,May-19,0,1,1
12014,user_12014,38563,233,29,204,May-19,0,1,1
12015,user_12015,4857,60,60,0,Nov-18,6,0,0
12016,user_12016,492504,275,21,254,May-19,0,1,1
12017,user_12017,7091,158,36,122,May-19,0,1,1
12018,user_12018,1260,44,15,29,May-19,0,1,1
12020,user_12020,1433,66,23,43,Apr-19,1,1,0
12021,user_12021,205,5,5,0,Oct-18,7,0,0
12022,user_12022,5855,253,110,143,May-19,0,1,1
12023,user_12023,8339,132,62,70,May-19,0,1,1
12025,user_12025,390,16,12,4,Mar-19,2,0,0
12026,user_12026,2882,49,14,35,Mar-19,2,0,0
12027,user_12027,10,1,1,0,Oct-18,7,0,0
12028,user_12028,5482,130,18,112,May-19,0,1,1
12029,user_12029,32064,248,97,151,May-19,0,1,1
12030,user_12030,1636,26,26,0,Nov-18,6,0,0
12031,user_12031,56153,24,9,15,May-19,0,1,1
12032,user_12032,553,16,16,0,Sep-18,8,0,0
12033,user_12033,4051,212,100,112,May-19,0,1,1
12034,user_12034,1001,24,16,8,May-19,0,1,1
12035,user_12035,884,5,5,0,Oct-18,7,0,0
12036,user_12036,424,14,10,4,Apr-19,1,1,0
12038,user_12038,1643,26,18,8,Feb-19,3,0,0
12039,user_12039,1486,79,75,4,Feb-19,3,0,0
12040,user_12040,17299,1064,215,849,May-19,0,1,1
12041,user_12041,39368,103,64,39,May-19,0,1,1
12042,user_12042,27685,14,12,2,Feb-19,3,0,0
12043,user_12043,1815,119,50,69,Apr-19,1,1,0
12044,user_12044,30,1,1,0,Sep-18,8,0,0
12045,user_12045,3541,56,18,38,May-19,0,1,1
12046,user_12046,10340,107,48,59,May-19,0,1,1
12047,user_12047,9,2,2,0,Oct-18,7,0,0
12048,user_12048,443,2,1,1,Mar-19,2,0,0
12049,user_12049,6337,12,4,8,May-19,0,1,1
12051,user_12051,2109,174,51,123,May-19,0,1,1
12052,user_12052,328,30,17,13,May-19,0,1,1
12053,user_12053,5785,193,51,142,May-19,0,1,1
12054,user_12054,34588,347,154,193,May-19,0,1,1
12055,user_12055,21,3,3,0,Sep-18,8,0,0
12056,user_12056,6299,115,61,54,May-19,0,1,1
12057,user_12057,2816,38,26,12,Mar-19,2,0,0
12058,user_12058,3008,85,43,42,May-19,0,1,1
12059,user_12059,281,34,8,26,May-19,0,1,1
12060,user_12060,14337,657,236,421,May-19,0,1,1
12061,user_12061,11006,218,65,153,May-19,0,1,1
12062,user_12062,100,5,5,0,Sep-18,8,0,0
12063,user_12063,7895,278,137,141,May-19,0,1,1
12064,user_12064,805,75,2,73,Apr-19,1,1,0
12065,user_12065,1883,89,36,53,May-19,0,0,1
12066,user_12066,1861,80,41,39,Mar-19,2,0,0
12067,user_12067,7098,80,76,4,Mar-19,2,0,0
12068,user_12068,74,7,5,2,Mar-19,2,0,0
12069,user_12069,13485,112,38,74,May-19,0,1,1
12070,user_12070,9,1,1,0,Sep-18,8,0,0
12071,user_12071,221,4,4,0,Sep-18,8,0,0
12072,user_12072,2231,53,52,1,Jan-19,4,0,0
12073,user_12073,5973,55,1,54,May-19,0,1,1
12074,user_12074,131,7,5,2,May-19,0,1,1
12075,user_12075,5348,16,11,5,May-19,0,1,1
12076,user_12076,1512,47,37,10,May-19,0,0,1
12077,user_12077,4858,160,126,34,Apr-19,1,1,0
12078,user_12078,1695,102,38,64,May-19,0,1,1
12079,user_12079,3437,138,50,88,May-19,0,1,1
12080,user_12080,6445,120,42,78,Mar-19,2,0,0
12081,user_12081,1281,37,36,1,Mar-19,2,0,0
12082,user_12082,3525,148,10,138,May-19,0,1,1
12083,user_12083,486,22,18,4,Feb-19,3,0,0
12084,user_12084,738,53,10,43,May-19,0,1,1
12085,user_12085,9,1,1,0,Sep-18,8,0,0
12086,user_12086,248281,360,93,267,May-19,0,1,1
12087,user_12087,1494,56,56,0,Oct-18,7,0,0
12088,user_12088,4145,118,79,39,Apr-19,1,1,0
12089,user_12089,288,22,8,14,Apr-19,1,1,0
12090,user_12090,1118,90,20,70,May-19,0,1,1
12091,user_12091,142,15,11,4,Apr-19,1,1,0
12092,user_12092,524,47,46,1,Mar-19,2,0,0
12093,user_12093,5202,88,72,16,Apr-19,1,1,0
12094,user_12094,775,10,2,8,Apr-19,1,1,0
12095,user_12095,367,48,27,21,Mar-19,2,0,0
12096,user_12096,5979,161,2,159,May-19,0,1,1
12097,user_12097,1108,100,97,3,Apr-19,1,1,0
12098,user_12098,2171,38,19,19,May-19,0,1,1
12099,user_12099,6018,128,38,90,May-19,0,1,1
12100,user_12100,56617,697,242,455,May-19,0,1,1
12101,user_12101,1141,35,35,0,Oct-18,7,0,0
12102,user_12102,6973,96,42,54,May-19,0,1,1
12103,user_12103,8522,129,84,45,May-19,0,1,1
12104,user_12104,796,54,12,42,Mar-19,2,0,0
12105,user_12105,26,5,5,0,Sep-18,8,0,0
12106,user_12106,23945,1407,261,1146,May-19,0,1,1
12107,user_12107,1298,59,21,38,May-19,0,1,1
12108,user_12108,2962,50,23,27,Mar-19,2,0,0
12109,user_12109,73739,124,85,39,May-19,0,1,1
12110,user_12110,3960,334,296,38,Apr-19,1,1,0
12111,user_12111,541,20,20,0,Nov-18,6,0,0
12112,user_12112,6784,107,54,53,Apr-19,1,1,0
12113,user_12113,22,3,0,3,Jan-19,4,0,0
12114,user_12114,3522,178,113,65,May-19,0,1,1
12115,user_12115,5813,307,149,158,May-19,0,1,1
12116,user_12116,13532,96,69,27,May-19,0,1,1
12117,user_12117,6667,424,215,209,Apr-19,1,1,0
12118,user_12118,454,7,3,4,Mar-19,2,0,0
12119,user_12119,1932,13,13,0,Dec-18,5,0,0
12120,user_12120,19,4,4,0,Sep-18,8,0,0
12121,user_12121,11110,148,115,33,May-19,0,1,1
12122,user_12122,7101,116,27,89,May-19,0,1,1
12123,user_12123,191,3,3,0,Oct-18,7,0,0
12124,user_12124,25734,315,102,213,May-19,0,1,1
12125,user_12125,16,3,3,0,Sep-18,8,0,0
12126,user_12126,43,2,2,0,Sep-18,8,0,0
12127,user_12127,1475,19,12,7,Mar-19,2,0,0
12128,user_12128,590,52,0,52,May-19,0,1,1
12129,user_12129,18,3,3,0,Oct-18,7,0,0
12130,user_12130,1104,53,24,29,May-19,0,1,1
12131,user_12131,2682,45,36,9,Jan-19,4,0,0
12132,user_12132,31319,141,12,129,May-19,0,1,1
12133,user_12133,130267,120,63,57,May-19,0,1,1
12134,user_12134,143,4,4,0,Sep-18,8,0,0
12135,user_12135,2342,123,82,41,Apr-19,1,1,0
12136,user_12136,7681,16,16,0,Sep-18,8,0,0
12137,user_12137,4745,191,70,121,May-19,0,1,1
12138,user_12138,5853,150,99,51,Apr-19,1,1,0
12139,user_12139,1986,17,4,13,May-19,0,1,1
12140,user_12140,1039,72,33,39,May-19,0,1,1
12141,user_12141,2451,15,12,3,Jan-19,4,0,0
12142,user_12142,20415,95,63,32,May-19,0,1,1
12143,user_12143,5879,182,105,77,Mar-19,2,0,0
12144,user_12144,8621,186,154,32,May-19,0,1,1
12145,user_12145,5312,34,9,25,Apr-19,1,1,0
12146,user_12146,19870,506,230,276,May-19,0,1,1
12147,user_12147,42,7,7,0,Oct-18,7,0,0
12148,user_12148,32884,74,20,54,May-19,0,1,1
12149,user_12149,3144,49,31,18,Feb-19,3,0,0
12151,user_12151,16608,235,118,117,May-19,0,1,1
12152,user_12152,2242,115,56,59,May-19,0,1,1
12153,user_12153,8207,170,29,141,May-19,0,1,1
12154,user_12154,144272,210,0,210,May-19,0,1,1
12155,user_12155,728,40,24,16,Mar-19,2,0,0
12156,user_12156,42,9,9,0,Oct-18,7,0,0
12157,user_12157,1164,88,15,73,May-19,0,1,1
12158,user_12158,440,16,8,8,Jan-19,4,0,0
12159,user_12159,15,2,2,0,Sep-18,8,0,0
12160,user_12160,6230,23,3,20,May-19,0,1,1
12161,user_12161,1713,14,0,14,Apr-19,1,1,0
12162,user_12162,7568,302,128,174,May-19,0,1,1
12163,user_12163,883,4,3,1,Mar-19,2,0,0
12164,user_12164,43,7,7,0,Oct-18,7,0,0
12165,user_12165,1441,38,4,34,May-19,0,1,1
12166,user_12166,18,2,2,0,Oct-18,7,0,0
12167,user_12167,5,8,4,4,Jan-19,4,0,0
12168,user_12168,9,2,0,2,Feb-19,3,0,0
12169,user_12169,21505,95,17,78,Feb-19,3,0,0
12170,user_12170,20850,391,216,175,May-19,0,1,1
12171,user_12171,2240,28,28,0,Oct-18,7,0,0
12172,user_12172,10626,122,60,62,Apr-19,1,1,0
12173,user_12173,4777,324,109,215,May-19,0,1,1
12174,user_12174,1721,69,7,62,May-19,0,1,1
12175,user_12175,1601,9,9,0,Oct-18,7,0,0
12176,user_12176,1930,47,27,20,Apr-19,1,1,0
12177,user_12177,9,2,2,0,Sep-18,8,0,0
12178,user_12178,120166,140,35,105,May-19,0,1,1
12179,user_12179,7462,300,106,194,May-19,0,1,1
12180,user_12180,427,5,5,0,Sep-18,8,0,0
12181,user_12181,6911,440,145,295,May-19,0,1,1
12182,user_12182,5399,74,69,5,Mar-19,2,0,0
12183,user_12183,1741,55,28,27,May-19,0,1,1
12184,user_12184,3929,229,132,97,May-19,0,1,1
12185,user_12185,918,33,33,0,Dec-18,5,0,0
12186,user_12186,1522,25,25,0,Nov-18,6,0,0
12187,user_12187,30823,730,387,343,May-19,0,1,1
12188,user_12188,4253,257,120,137,May-19,0,1,1
12189,user_12189,1907,52,52,0,Oct-18,7,0,0
12190,user_12190,1517,82,38,44,May-19,0,1,1
12191,user_12191,32,6,6,0,Sep-18,8,0,0
12192,user_12192,156,5,3,2,Apr-19,1,1,0
12193,user_12193,2259,43,40,3,May-19,0,1,1
12195,user_12195,4496,259,138,121,May-19,0,1,1
12196,user_12196,239,5,3,2,Mar-19,2,0,0
12197,user_12197,2987,148,42,106,May-19,0,1,1
12198,user_12198,2132,44,26,18,May-19,0,1,1
12199,user_12199,8412,153,82,71,May-19,0,1,1
12200,user_12200,17427,242,90,152,May-19,0,1,1
12202,user_12202,6240,248,71,177,May-19,0,1,1
12203,user_12203,11911,355,135,220,May-19,0,1,1
12204,user_12204,4458,302,79,223,May-19,0,1,1
12205,user_12205,4860,50,10,40,May-19,0,1,1
12206,user_12206,1,1,1,0,Sep-18,8,0,0
12207,user_12207,997,69,59,10,May-19,0,0,1
12209,user_12209,452,83,76,7,Feb-19,3,0,0
12210,user_12210,7172,84,30,54,May-19,0,1,1
12211,user_12211,5541,371,25,346,May-19,0,1,1
12212,user_12212,3123,106,72,34,May-19,0,1,1
12213,user_12213,6409,54,51,3,Jan-19,4,0,0
12214,user_12214,23,3,3,0,Sep-18,8,0,0
12215,user_12215,11043,99,32,67,May-19,0,1,1
12216,user_12216,10,4,4,0,Nov-18,6,0,0
12217,user_12217,580,14,14,0,Oct-18,7,0,0
12218,user_12218,22,6,5,1,Feb-19,3,0,0
12219,user_12219,29632,779,331,448,May-19,0,1,1
12220,user_12220,638,84,35,49,May-19,0,1,1
12221,user_12221,5072,47,42,5,Jan-19,4,0,0
12222,user_12222,53275,225,72,153,May-19,0,1,1
12223,user_12223,319367,175,46,129,May-19,0,1,1
12224,user_12224,1156,32,26,6,Apr-19,1,1,0
12225,user_12225,4935,209,35,174,May-19,0,1,1
12226,user_12226,725,31,17,14,May-19,0,1,1
12227,user_12227,4335,187,86,101,Apr-19,1,1,0
12228,user_12228,6090,211,71,140,May-19,0,1,1
12229,user_12229,69,8,8,0,Oct-18,7,0,0
12230,user_12230,892,52,13,39,May-19,0,1,1
12231,user_12231,8224,358,61,297,May-19,0,1,1
12232,user_12232,1185,248,34,214,May-19,0,1,1
12233,user_12233,45,15,15,0,Dec-18,5,0,0
12234,user_12234,1557,60,33,27,Apr-19,1,1,0
12236,user_12236,5528,596,240,356,May-19,0,1,1
12237,user_12237,14,3,3,0,Sep-18,8,0,0
12238,user_12238,4702,150,95,55,May-19,0,1,1
12239,user_12239,61,5,5,0,Sep-18,8,0,0
12240,user_12240,28662,556,285,271,May-19,0,1,1
12241,user_12241,501,31,31,0,Dec-18,5,0,0
12242,user_12242,2685,70,33,37,May-19,0,0,1
12243,user_12243,138,20,3,17,Feb-19,3,0,0
12244,user_12244,2453,36,36,0,Sep-18,8,0,0
12245,user_12245,2804,75,2,73,May-19,0,1,1
12246,user_12246,77570,119,34,85,May-19,0,1,1
12247,user_12247,3333,55,29,26,Mar-19,2,0,0
12248,user_12248,9344,209,148,61,Apr-19,1,1,0
12249,user_12249,1086,25,24,1,Mar-19,2,0,0
12250,user_12250,500,30,30,0,Dec-18,5,0,0
12251,user_12251,11066,656,4,652,May-19,0,1,1
12252,user_12252,42,6,6,0,Sep-18,8,0,0
12253,user_12253,6358,119,119,0,Nov-18,6,0,0
12254,user_12254,7516,116,38,78,Apr-19,1,1,0
12255,user_12255,703,31,15,16,Feb-19,3,0,0
12256,user_12256,3248,44,26,18,Apr-19,1,1,0
12257,user_12257,4639,192,98,94,May-19,0,1,1
12258,user_12258,5131,216,44,172,May-19,0,1,1
12259,user_12259,6190,401,161,240,May-19,0,1,1
12261,user_12261,0,5,5,0,Sep-18,8,0,0
12262,user_12262,26073,745,233,512,May-19,0,1,1
12263,user_12263,1,1,1,0,Sep-18,8,0,0
12264,user_12264,5323,318,126,192,May-19,0,1,1
12265,user_12265,11705,50,23,27,May-19,0,1,1
12266,user_12266,2581,137,107,30,Apr-19,1,1,0
12267,user_12267,3983,162,22,140,May-19,0,1,1
12268,user_12268,430,10,2,8,Apr-19,1,1,0
12269,user_12269,0,1,1,0,Sep-18,8,0,0
12270,user_12270,5262,150,77,73,May-19,0,1,1
12271,user_12271,499,22,13,9,May-19,0,1,1
12272,user_12272,3604,118,68,50,May-19,0,1,1
12274,user_12274,12582,101,66,35,Mar-19,2,0,0
12275,user_12275,10705,316,114,202,May-19,0,1,1
12277,user_12277,3601,442,170,272,May-19,0,1,1
12278,user_12278,1078,17,10,7,May-19,0,0,1
12279,user_12279,40,3,3,0,Sep-18,8,0,0
12281,user_12281,2161,131,74,57,May-19,0,1,1
12282,user_12282,7235,96,28,68,May-19,0,1,1
12283,user_12283,3003,170,97,73,May-19,0,1,1
12284,user_12284,7476,130,56,74,May-19,0,1,1
12285,user_12285,4970,43,21,22,Mar-19,2,0,0
12286,user_12286,191,8,4,4,Feb-19,3,0,0
12287,user_12287,12711,57,46,11,May-19,0,1,1
12288,user_12288,2696,95,45,50,May-19,0,1,1
12289,user_12289,26,3,2,1,Mar-19,2,0,0
12290,user_12290,6784,156,62,94,May-19,0,1,1
12291,user_12291,4293,274,57,217,May-19,0,1,1
12292,user_12292,4122,322,150,172,May-19,0,1,1
12293,user_12293,534,39,39,0,Dec-18,5,0,0
12294,user_12294,7954,200,112,88,May-19,0,1,1
12295,user_12295,16,5,0,5,Apr-19,1,1,0
12296,user_12296,33290,270,194,76,May-19,0,1,1
12297,user_12297,9276,20,4,16,May-19,0,1,1
12298,user_12298,9828,230,95,135,May-19,0,1,1
12299,user_12299,16575,170,41,129,May-19,0,1,1
12300,user_12300,6042,294,193,101,May-19,0,1,1
12301,user_12301,1008,103,103,0,Oct-18,7,0,0
12302,user_12302,6637,52,52,0,Oct-18,7,0,0
12303,user_12303,10236,289,114,175,May-19,0,1,1
12304,user_12304,6432,91,31,60,May-19,0,0,1
12305,user_12305,97,4,4,0,Nov-18,6,0,0
12306,user_12306,2090,36,16,20,Apr-19,1,1,0
12307,user_12307,4661,97,2,95,May-19,0,1,1
12308,user_12308,764,67,43,24,May-19,0,1,1
12309,user_12309,50131,1152,1049,103,May-19,0,1,1
12310,user_12310,41555,314,110,204,May-19,0,1,1
12311,user_12311,84076,89,40,49,May-19,0,1,1
12312,user_12312,229,39,23,16,Mar-19,2,0,0
12313,user_12313,2371,41,33,8,Mar-19,2,0,0
12314,user_12314,3556,69,5,64,May-19,0,1,1
12315,user_12315,85,8,8,0,Sep-18,8,0,0
12316,user_12316,5629,97,84,13,Mar-19,2,0,0
12317,user_12317,1,1,1,0,Sep-18,8,0,0
12318,user_12318,28717,640,313,327,May-19,0,1,1
12319,user_12319,56449,838,397,441,May-19,0,1,1
12320,user_12320,4039,32,4,28,Apr-19,1,1,0
12322,user_12322,311,7,4,3,May-19,0,1,1
12323,user_12323,3899,37,9,28,May-19,0,1,1
12324,user_12324,2959,79,5,74,Apr-19,1,1,0
12325,user_12325,1060,109,95,14,Apr-19,1,1,0
12327,user_12327,165,7,7,0,Sep-18,8,0,0
12328,user_12328,14398,166,164,2,Jan-19,4,0,0
12329,user_12329,7838,230,74,156,May-19,0,1,1
12330,user_12330,8433,51,46,5,May-19,0,1,1
12331,user_12331,4251,52,10,42,Apr-19,1,1,0
12332,user_12332,12671,422,133,289,May-19,0,1,1
12334,user_12334,12842,84,49,35,Apr-19,1,1,0
12335,user_12335,11219,137,102,35,May-19,0,1,1
12336,user_12336,5298,137,104,33,May-19,0,1,1
12337,user_12337,8187,343,224,119,Apr-19,1,1,0
12338,user_12338,9652,55,5,50,Apr-19,1,1,0
12339,user_12339,20,5,5,0,Sep-18,8,0,0
12340,user_12340,11797,116,60,56,Apr-19,1,1,0
12341,user_12341,3805,115,35,80,May-19,0,1,1
12342,user_12342,8146,728,350,378,May-19,0,1,1
12343,user_12343,1117,37,14,23,May-19,0,0,1
12344,user_12344,1676,57,26,31,May-19,0,0,1
12345,user_12345,15918,354,28,326,May-19,0,1,1
12346,user_12346,5829,134,66,68,May-19,0,1,1
12347,user_12347,981,50,40,10,Feb-19,3,0,0
12348,user_12348,6445,89,13,76,May-19,0,1,1
12349,user_12349,1881,60,19,41,May-19,0,1,1
12350,user_12350,1338,51,30,21,Feb-19,3,0,0
12351,user_12351,3047,52,20,32,May-19,0,1,1
12352,user_12352,537,8,3,5,Apr-19,1,1,0
12354,user_12354,24,5,5,0,Sep-18,8,0,0
12355,user_12355,26,3,3,0,Sep-18,8,0,0
12356,user_12356,31084,98,50,48,May-19,0,1,1
12357,user_12357,36,7,5,2,Mar-19,2,0,0
12358,user_12358,14,3,3,0,Sep-18,8,0,0
12359,user_12359,1,1,1,0,Sep-18,8,0,0
12360,user_12360,18,3,3,0,Sep-18,8,0,0
12361,user_12361,2654,99,36,63,May-19,0,1,1
12362,user_12362,279,13,3,10,May-19,0,1,1
12363,user_12363,41,5,5,0,Sep-18,8,0,0
12365,user_12365,960,82,6,76,May-19,0,1,1
12366,user_12366,81,3,3,0,Sep-18,8,0,0
12367,user_12367,1239,9,9,0,Sep-18,8,0,0
12368,user_12368,10313,96,23,73,Apr-19,1,1,0
12369,user_12369,142,17,13,4,Feb-19,3,0,0
12370,user_12370,6100,201,58,143,May-19,0,1,1
12371,user_12371,22514,123,105,18,May-19,0,1,1
12372,user_12372,12517,743,77,666,May-19,0,1,1
12373,user_12373,194533,649,228,421,May-19,0,1,1
12374,user_12374,4038,181,91,90,Apr-19,1,1,0
12375,user_12375,10281,329,151,178,May-19,0,1,1
12376,user_12376,3042,55,7,48,Apr-19,1,1,0
12377,user_12377,580,10,6,4,Mar-19,2,0,0
12378,user_12378,610,24,21,3,Feb-19,3,0,0
12380,user_12380,4011,25,11,14,May-19,0,1,1
12381,user_12381,14242,352,19,333,May-19,0,1,1
12382,user_12382,1919,255,124,131,May-19,0,1,1
12383,user_12383,19,4,4,0,Sep-18,8,0,0
12384,user_12384,1491,31,0,31,May-19,0,1,1
12385,user_12385,398,19,9,10,May-19,0,0,1
12386,user_12386,20,2,2,0,Sep-18,8,0,0
12387,user_12387,33592,1143,434,709,May-19,0,1,1
12388,user_12388,6955,370,155,215,May-19,0,1,1
12389,user_12389,5918,465,356,109,Apr-19,1,1,0
12390,user_12390,7404,105,49,56,Apr-19,1,1,0
12391,user_12391,4,1,1,0,Sep-18,8,0,0
12392,user_12392,3693,26,26,0,Dec-18,5,0,0
12393,user_12393,427,19,12,7,Apr-19,1,1,0
12395,user_12395,10,3,3,0,Oct-18,7,0,0
12396,user_12396,30,9,9,0,Dec-18,5,0,0
12397,user_12397,894,30,25,5,Mar-19,2,0,0
12398,user_12398,24,4,4,0,Sep-18,8,0,0
12399,user_12399,10405,160,78,82,Apr-19,1,1,0
12400,user_12400,1547,88,46,42,May-19,0,1,1
12401,user_12401,14,2,2,0,Sep-18,8,0,0
12402,user_12402,12319,123,19,104,May-19,0,1,1
12403,user_12403,181,24,24,0,Sep-18,8,0,0
12404,user_12404,3969,180,75,105,May-19,0,1,1
12405,user_12405,7225,78,29,49,May-19,0,1,1
12406,user_12406,585,46,11,35,May-19,0,1,1
12407,user_12407,1364,94,32,62,May-19,0,1,1
12408,user_12408,1360,48,24,24,Mar-19,2,0,0
12409,user_12409,356,9,9,0,Oct-18,7,0,0
12410,user_12410,10,14,14,0,Sep-18,8,0,0
12411,user_12411,2330,112,58,54,May-19,0,1,1
12412,user_12412,2863,55,55,0,Nov-18,6,0,0
12413,user_12413,4983,184,31,153,May-19,0,1,1
12414,user_12414,17,2,2,0,Sep-18,8,0,0
12415,user_12415,486,13,12,1,Apr-19,1,1,0
12416,user_12416,266,18,18,0,Oct-18,7,0,0
12417,user_12417,3518,246,135,111,May-19,0,1,1
12418,user_12418,1283,20,2,18,May-19,0,1,1
12419,user_12419,2791,44,23,21,Mar-19,2,0,0
12420,user_12420,1614,61,13,48,May-19,0,1,1
12421,user_12421,937,107,107,0,Nov-18,6,0,0
12422,user_12422,18293,165,120,45,May-19,0,1,1
12423,user_12423,2074,57,57,0,Nov-18,6,0,0
12424,user_12424,3897,289,67,222,Mar-19,2,0,0
12425,user_12425,872,51,47,4,May-19,0,0,1
12426,user_12426,42798,48,26,22,May-19,0,1,1
12427,user_12427,36327,911,169,742,May-19,0,1,1
12428,user_12428,13343,86,23,63,May-19,0,1,1
12429,user_12429,874,125,15,110,May-19,0,1,1
12430,user_12430,34,5,4,1,Jan-19,4,0,0
12431,user_12431,22635,263,106,157,May-19,0,1,1
12432,user_12432,101,3,3,0,Oct-18,7,0,0
12433,user_12433,222,15,8,7,Mar-19,2,0,0
12434,user_12434,15023,142,68,74,May-19,0,1,1
12435,user_12435,2077,62,46,16,May-19,0,1,1
12436,user_12436,3360,32,14,18,Apr-19,1,1,0
12437,user_12437,14141,469,180,289,Apr-19,1,1,0
12438,user_12438,464,15,15,0,Dec-18,5,0,0
12439,user_12439,38323,863,241,622,May-19,0,1,1
12440,user_12440,8468,584,322,262,May-19,0,1,1
12441,user_12441,17558,30,19,11,May-19,0,1,1
12442,user_12442,6662,159,68,91,May-19,0,1,1
12443,user_12443,295,7,3,4,Mar-19,2,0,0
12444,user_12444,557,13,6,7,Feb-19,3,0,0
12447,user_12447,2564,85,24,61,Apr-19,1,1,0
12448,user_12448,34856,194,105,89,May-19,0,1,1
12449,user_12449,4478,73,71,2,Jan-19,4,0,0
12450,user_12450,1141,57,10,47,May-19,0,1,1
12452,user_12452,3150,296,159,137,May-19,0,1,1
12453,user_12453,15242,298,63,235,May-19,0,1,1
12456,user_12456,16,3,3,0,Sep-18,8,0,0
12457,user_12457,18,5,5,0,Sep-18,8,0,0
12458,user_12458,14107,93,91,2,Jan-19,4,0,0
12459,user_12459,1072,21,21,0,Nov-18,6,0,0
12460,user_12460,16,3,3,0,Sep-18,8,0,0
12461,user_12461,3470,112,13,99,May-19,0,1,1
12462,user_12462,5585,121,48,73,May-19,0,1,1
12463,user_12463,15,7,3,4,Apr-19,1,1,0
12464,user_12464,31200,802,320,482,May-19,0,1,1
12465,user_12465,3636,40,40,0,Oct-18,7,0,0
12466,user_12466,6354,90,90,0,Dec-18,5,0,0
12467,user_12467,465,47,12,35,May-19,0,1,1
12468,user_12468,7583,65,50,15,May-19,0,1,1
12469,user_12469,2670,71,40,31,May-19,0,1,1
12470,user_12470,67862,306,139,167,May-19,0,1,1
12471,user_12471,118452,110,51,59,May-19,0,1,1
12472,user_12472,1604,51,46,5,Mar-19,2,0,0
12473,user_12473,19,4,1,3,Mar-19,2,0,0
12474,user_12474,30937,695,203,492,May-19,0,1,1
12475,user_12475,422,13,3,10,Mar-19,2,0,0
12476,user_12476,556,7,2,5,May-19,0,1,1
12477,user_12477,1568,39,35,4,Feb-19,3,0,0
12478,user_12478,1530,100,21,79,May-19,0,1,1
12479,user_12479,93,11,8,3,Mar-19,2,0,0
12480,user_12480,3328,60,34,26,Apr-19,1,1,0
12482,user_12482,285,20,19,1,Mar-19,2,0,0
12484,user_12484,8905,50,27,23,May-19,0,1,1
12485,user_12485,4032,248,162,86,May-19,0,1,1
12486,user_12486,1696,46,7,39,May-19,0,1,1
12487,user_12487,1620,37,30,7,Apr-19,1,1,0
12488,user_12488,18,3,3,0,Oct-18,7,0,0
12489,user_12489,1088,22,21,1,Jan-19,4,0,0
12490,user_12490,4210,96,61,35,May-19,0,1,1
12491,user_12491,158,2,1,1,Apr-19,1,1,0
12492,user_12492,286,41,41,0,Sep-18,8,0,0
12493,user_12493,1952,50,2,48,May-19,0,1,1
12494,user_12494,432,24,2,22,May-19,0,1,1
12495,user_12495,2358,37,14,23,May-19,0,1,1
12496,user_12496,7272,68,8,60,Apr-19,1,1,0
12497,user_12497,13283,131,23,108,May-19,0,1,1
12498,user_12498,8731,338,130,208,May-19,0,1,1
12499,user_12499,3529,23,14,9,May-19,0,1,1
12500,user_12500,6631,438,198,240,May-19,0,1,1
12501,user_12501,93065,31,12,19,May-19,0,1,1
12502,user_12502,9508,258,129,129,May-19,0,1,1
12503,user_12503,1371,42,8,34,May-19,0,1,1
12504,user_12504,3931,39,39,0,Oct-18,7,0,0
12505,user_12505,1174,34,16,18,Mar-19,2,0,0
12506,user_12506,155,9,9,0,Nov-18,6,0,0
12507,user_12507,1570,117,58,59,May-19,0,1,1
12508,user_12508,719,11,2,9,Apr-19,1,1,0
12509,user_12509,1152,38,6,32,May-19,0,0,1
12510,user_12510,23436,398,209,189,May-19,0,1,1
12511,user_12511,2757,76,23,53,May-19,0,1,1
12512,user_12512,3566,56,36,20,Apr-19,1,1,0
12513,user_12513,8125,41,30,11,May-19,0,0,1
12514,user_12514,13170,492,242,250,May-19,0,1,1
12515,user_12515,2361,92,47,45,May-19,0,1,1
12516,user_12516,14715,331,178,153,May-19,0,1,1
12517,user_12517,9029,238,62,176,May-19,0,1,1
12518,user_12518,464,17,11,6,Apr-19,1,1,0
12519,user_12519,291422,118,30,88,May-19,0,1,1
12520,user_12520,2015,86,82,4,Apr-19,1,1,0
12521,user_12521,86576,94,55,39,Apr-19,1,1,0
12522,user_12522,9098,272,249,23,Apr-19,1,1,0
12523,user_12523,186,11,0,11,Mar-19,2,0,0
12524,user_12524,2048,48,30,18,Feb-19,3,0,0
12525,user_12525,9913,804,371,433,May-19,0,1,1
12526,user_12526,201,2,2,0,Sep-18,8,0,0
12527,user_12527,5071,92,70,22,May-19,0,1,1
12528,user_12528,7065,129,80,49,Apr-19,1,1,0
12529,user_12529,7053,560,68,492,May-19,0,1,1
12531,user_12531,86,2,2,0,Sep-18,8,0,0
12532,user_12532,861,13,13,0,Nov-18,6,0,0
12533,user_12533,3568,72,72,0,Sep-18,8,0,0
12534,user_12534,2977,297,41,256,Apr-19,1,1,0
12535,user_12535,275,5,5,0,Sep-18,8,0,0
12536,user_12536,364,18,18,0,Nov-18,6,0,0
12537,user_12537,24872,805,297,508,Apr-19,1,1,0
12538,user_12538,6760,73,45,28,May-19,0,1,1
12539,user_12539,327,34,26,8,Apr-19,1,1,0
12540,user_12540,26,4,4,0,Oct-18,7,0,0
12541,user_12541,719,41,5,36,May-19,0,1,1
12542,user_12542,18,3,3,0,Sep-18,8,0,0
12543,user_12543,12800,146,62,84,May-19,0,1,1
12544,user_12544,7531,248,78,170,May-19,0,1,1
12545,user_12545,18807,389,4,385,May-19,0,1,1
12546,user_12546,1074,32,15,17,Apr-19,1,1,0
12547,user_12547,23,4,4,0,Sep-18,8,0,0
12548,user_12548,28330,1292,402,890,May-19,0,1,1
12549,user_12549,41506,1116,296,820,May-19,0,1,1
12550,user_12550,3057,72,41,31,May-19,0,0,1
12551,user_12551,2410,29,15,14,May-19,0,1,1
12552,user_12552,17,6,3,3,Mar-19,2,0,0
12553,user_12553,22289,1286,582,704,May-19,0,1,1
12554,user_12554,2145,62,6,56,May-19,0,1,1
12555,user_12555,2871,42,2,40,May-19,0,1,1
12556,user_12556,1556,69,43,26,Apr-19,1,1,0
12557,user_12557,9,2,2,0,Sep-18,8,0,0
12558,user_12558,10698,83,20,63,May-19,0,1,1
12559,user_12559,367,31,30,1,Jan-19,4,0,0
12560,user_12560,31,5,4,1,Mar-19,2,0,0
12561,user_12561,1817,110,57,53,Apr-19,1,1,0
12562,user_12562,2400,122,96,26,Mar-19,2,0,0
12563,user_12563,61,10,9,1,Jan-19,4,0,0
12564,user_12564,394,15,3,12,May-19,0,1,1
12565,user_12565,18,2,2,0,Sep-18,8,0,0
12566,user_12566,13332,303,80,223,May-19,0,1,1
12567,user_12567,38,5,5,0,Dec-18,5,0,0
12568,user_12568,21671,399,107,292,May-19,0,1,1
12569,user_12569,5422,71,54,17,Apr-19,1,1,0
12570,user_12570,20342,91,26,65,May-19,0,1,1
12571,user_12571,26662,967,379,588,May-19,0,1,1
12572,user_12572,999,43,11,32,May-19,0,1,1
12573,user_12573,1226,43,25,18,Apr-19,1,1,0
12574,user_12574,420,71,13,58,May-19,0,1,1
12575,user_12575,2,2,2,0,Sep-18,8,0,0
12576,user_12576,125,9,7,2,Jan-19,4,0,0
12577,user_12577,4134,89,89,0,Dec-18,5,0,0
12578,user_12578,6816,122,83,39,Apr-19,1,1,0
12579,user_12579,2402,19,14,5,May-19,0,1,1
12580,user_12580,208,22,13,9,May-19,0,1,1
12581,user_12581,3344,99,85,14,Feb-19,3,0,0
12582,user_12582,1068,58,26,32,May-19,0,0,1
12583,user_12583,16381,629,410,219,May-19,0,1,1
12584,user_12584,79060,676,193,483,May-19,0,1,1
12585,user_12585,4150,46,13,33,May-19,0,1,1
12586,user_12586,2082,38,11,27,Apr-19,1,1,0
12587,user_12587,15208,337,85,252,May-19,0,1,1
12588,user_12588,1057,22,12,10,May-19,0,1,1
12589,user_12589,6817,60,38,22,May-19,0,0,1
12590,user_12590,11,2,2,0,Nov-18,6,0,0
12591,user_12591,12986,2192,466,1726,May-19,0,1,1
12592,user_12592,575,49,6,43,Mar-19,2,0,0
12593,user_12593,1804,139,99,40,Apr-19,1,1,0
12594,user_12594,341,21,12,9,Apr-19,1,1,0
12595,user_12595,6143,96,64,32,Mar-19,2,0,0
12596,user_12596,111,7,7,0,Dec-18,5,0,0
12597,user_12597,1069,76,44,32,Apr-19,1,1,0
12598,user_12598,709,16,16,0,Oct-18,7,0,0
12599,user_12599,1178,104,41,63,May-19,0,1,1
12600,user_12600,234,23,20,3,Feb-19,3,0,0
12601,user_12601,15980,491,313,178,May-19,0,1,1
12602,user_12602,6,3,3,0,Sep-18,8,0,0
12603,user_12603,9,1,1,0,Sep-18,8,0,0
12604,user_12604,934,29,18,11,May-19,0,1,1
12605,user_12605,1125,16,16,0,Oct-18,7,0,0
12606,user_12606,17768,307,109,198,May-19,0,1,1
12607,user_12607,16,3,3,0,Oct-18,7,0,0
12608,user_12608,7764,113,48,65,May-19,0,0,1
12609,user_12609,816,10,3,7,Apr-19,1,1,0
12610,user_12610,359,6,6,0,Nov-18,6,0,0
12611,user_12611,809,21,10,11,Feb-19,3,0,0
12612,user_12612,138,4,4,0,Sep-18,8,0,0
12613,user_12613,62,6,2,4,Apr-19,1,1,0
12614,user_12614,16,3,3,0,Sep-18,8,0,0
12615,user_12615,5938,253,53,200,May-19,0,1,1
12616,user_12616,21437,347,194,153,May-19,0,1,1
12618,user_12618,5688,210,82,128,May-19,0,1,1
12619,user_12619,5248,130,58,72,May-19,0,1,1
12620,user_12620,997,38,25,13,May-19,0,0,1
12621,user_12621,3317,51,41,10,Apr-19,1,1,0
12622,user_12622,6150,143,84,59,May-19,0,1,1
12623,user_12623,1567,24,16,8,Mar-19,2,0,0
12624,user_12624,628,35,24,11,May-19,0,1,1
12625,user_12625,15577,228,144,84,Apr-19,1,1,0
12626,user_12626,1666,52,12,40,May-19,0,1,1
12627,user_12627,10214,475,120,355,May-19,0,1,1
12628,user_12628,13238,42,38,4,Apr-19,1,1,0
12629,user_12629,2,1,1,0,Sep-18,8,0,0
12631,user_12631,2841,112,4,108,May-19,0,1,1
12632,user_12632,3090,161,25,136,May-19,0,1,1
12633,user_12633,9,2,2,0,Sep-18,8,0,0
12634,user_12634,3522,119,70,49,Mar-19,2,0,0
12635,user_12635,2763,53,3,50,May-19,0,1,1
12636,user_12636,220,19,19,0,Oct-18,7,0,0
12637,user_12637,7877,110,65,45,Apr-19,1,1,0
12638,user_12638,4349,135,51,84,Feb-19,3,0,0
12639,user_12639,1032,50,27,23,May-19,0,1,1
12640,user_12640,4183,95,39,56,Apr-19,1,1,0
12641,user_12641,8492,54,35,19,Apr-19,1,1,0
12642,user_12642,110,6,6,0,Oct-18,7,0,0
12643,user_12643,2925,101,29,72,May-19,0,1,1
12644,user_12644,2073,17,5,12,Feb-19,3,0,0
12645,user_12645,9424,275,112,163,May-19,0,1,1
12646,user_12646,16987,118,38,80,May-19,0,1,1
12648,user_12648,2218,130,52,78,May-19,0,1,1
12649,user_12649,1194,33,4,29,May-19,0,1,1
12650,user_12650,50,14,14,0,Dec-18,5,0,0
12651,user_12651,8442,139,68,71,May-19,0,1,1
12652,user_12652,41,6,3,3,Apr-19,1,1,0
12653,user_12653,11,2,2,0,Sep-18,8,0,0
12654,user_12654,331,16,7,9,Mar-19,2,0,0
12655,user_12655,62188,1316,537,779,May-19,0,1,1
12656,user_12656,4434,253,119,134,May-19,0,1,1
12657,user_12657,138042,5285,2043,3242,May-19,0,1,1
12658,user_12658,1957,51,35,16,May-19,0,1,1
12659,user_12659,5022,93,55,38,May-19,0,1,1
12660,user_12660,5524,344,106,238,May-19,0,1,1
12661,user_12661,1764,84,38,46,May-19,0,1,1
12662,user_12662,35,5,5,0,Oct-18,7,0,0
12663,user_12663,5580,292,48,244,May-19,0,1,1
12664,user_12664,521,45,28,17,May-19,0,1,1
12665,user_12665,289,32,4,28,May-19,0,0,1
12666,user_12666,14640,310,114,196,May-19,0,1,1
12667,user_12667,120,10,8,2,Apr-19,1,1,0
12668,user_12668,1215,64,59,5,Apr-19,1,1,0
12669,user_12669,1441,163,88,75,Apr-19,1,1,0
12670,user_12670,3324,92,36,56,May-19,0,1,1
12671,user_12671,1432,66,39,27,Apr-19,1,1,0
12672,user_12672,5544,223,73,150,May-19,0,1,1
12673,user_12673,30395,297,124,173,May-19,0,1,1
12674,user_12674,3652,309,81,228,May-19,0,1,1
12676,user_12676,9200,31,31,0,Oct-18,7,0,0
12677,user_12677,3571,459,209,250,May-19,0,1,1
12678,user_12678,1518,106,49,57,Apr-19,1,1,0
12679,user_12679,821,25,0,25,May-19,0,1,1
12680,user_12680,9293,438,412,26,Feb-19,3,0,0
12681,user_12681,175,19,8,11,Apr-19,1,1,0
12682,user_12682,113,9,9,0,Dec-18,5,0,0
12683,user_12683,100,10,5,5,Apr-19,1,1,0
12684,user_12684,12842,210,24,186,May-19,0,1,1
12685,user_12685,1287,20,14,6,May-19,0,1,1
12686,user_12686,32,12,6,6,May-19,0,1,1
12687,user_12687,9638,125,86,39,Apr-19,1,1,0
12688,user_12688,7452,110,0,110,May-19,0,1,1
12689,user_12689,14978,231,99,132,May-19,0,1,1
12690,user_12690,915,46,30,16,May-19,0,1,1
12691,user_12691,1530,50,49,1,Feb-19,3,0,0
12692,user_12692,1499,18,18,0,Dec-18,5,0,0
12693,user_12693,5439,205,111,94,May-19,0,1,1
12694,user_12694,19588,266,69,197,May-19,0,1,1
12695,user_12695,4201,147,133,14,May-19,0,0,1
12696,user_12696,15522,464,134,330,May-19,0,1,1
12697,user_12697,511,66,48,18,May-19,0,0,1
12698,user_12698,11908,120,77,43,Mar-19,2,0,0
12699,user_12699,913,79,11,68,May-19,0,1,1
12700,user_12700,28665,526,116,410,May-19,0,1,1
12701,user_12701,4647,309,239,70,May-19,0,0,1
12702,user_12702,538,21,12,9,May-19,0,1,1
12703,user_12703,214,20,14,6,May-19,0,1,1
12704,user_12704,6,3,3,0,Sep-18,8,0,0
12705,user_12705,997,12,12,0,Dec-18,5,0,0
12706,user_12706,12615,498,247,251,May-19,0,1,1
12707,user_12707,7338,306,98,208,May-19,0,1,1
12708,user_12708,8587,335,155,180,May-19,0,1,1
12709,user_12709,298,28,22,6,Feb-19,3,0,0
12710,user_12710,2544,204,59,145,May-19,0,1,1
12711,user_12711,3347,105,40,65,May-19,0,1,1
12712,user_12712,1598,73,4,69,May-19,0,1,1
12713,user_12713,392,7,7,0,Sep-18,8,0,0
12714,user_12714,10,3,3,0,Nov-18,6,0,0
12715,user_12715,241,6,0,6,Mar-19,2,0,0
12716,user_12716,248,19,8,11,May-19,0,1,1
12717,user_12717,15,1,1,0,Dec-18,5,0,0
12718,user_12718,9942,82,62,20,May-19,0,1,1
12719,user_12719,4885,214,107,107,May-19,0,1,1
12720,user_12720,30630,327,220,107,May-19,0,1,1
12721,user_12721,1456,43,13,30,May-19,0,1,1
12722,user_12722,1933,147,123,24,May-19,0,1,1
12723,user_12723,28552,827,322,505,May-19,0,1,1
12724,user_12724,0,1,1,0,Oct-18,7,0,0
12726,user_12726,3752,136,37,99,May-19,0,1,1
12727,user_12727,882,17,17,0,Oct-18,7,0,0
12728,user_12728,2327,59,51,8,Apr-19,1,1,0
12729,user_12729,1071,74,37,37,May-19,0,1,1
12730,user_12730,107,7,4,3,Feb-19,3,0,0
12731,user_12731,5654,238,50,188,May-19,0,1,1
12732,user_12732,17436,983,352,631,May-19,0,1,1
12733,user_12733,4159,114,33,81,May-19,0,1,1
12734,user_12734,28392,337,102,235,May-19,0,1,1
12735,user_12735,10,1,1,0,Sep-18,8,0,0
12736,user_12736,17752,1130,573,557,May-19,0,1,1
12738,user_12738,89,3,0,3,Apr-19,1,1,0
12739,user_12739,1721,9,9,0,Nov-18,6,0,0
12740,user_12740,13999,306,62,244,May-19,0,1,1
12741,user_12741,6192,220,67,153,May-19,0,1,1
12742,user_12742,7011,100,73,27,May-19,0,1,1
12743,user_12743,4202,42,12,30,Apr-19,1,1,0
12744,user_12744,4340,10,3,7,May-19,0,1,1
12745,user_12745,17,3,3,0,Oct-18,7,0,0
12746,user_12746,10637,245,25,220,May-19,0,1,1
12747,user_12747,1744,310,132,178,May-19,0,1,1
12748,user_12748,1677,137,32,105,May-19,0,1,1
12749,user_12749,3196,92,59,33,Apr-19,1,1,0
12750,user_12750,5639,418,401,17,Mar-19,2,0,0
12751,user_12751,49395,486,218,268,May-19,0,1,1
12752,user_12752,6608,334,77,257,May-19,0,1,1
12753,user_12753,18215,440,161,279,May-19,0,1,1
12754,user_12754,1164,44,40,4,Apr-19,1,1,0
12755,user_12755,4023,248,184,64,May-19,0,1,1
12756,user_12756,8236,99,99,0,Dec-18,5,0,0
12757,user_12757,241,8,7,1,Jan-19,4,0,0
12758,user_12758,7897,353,266,87,May-19,0,1,1
12759,user_12759,2993,44,44,0,Oct-18,7,0,0
12760,user_12760,4809,81,81,0,Oct-18,7,0,0
12761,user_12761,12828,343,115,228,May-19,0,1,1
12762,user_12762,12238,452,213,239,May-19,0,1,1
12763,user_12763,2490,156,94,62,May-19,0,1,1
12764,user_12764,659,18,2,16,May-19,0,1,1
12766,user_12766,2922,104,55,49,May-19,0,1,1
12767,user_12767,4617,123,33,90,May-19,0,1,1
12768,user_12768,647,44,13,31,May-19,0,1,1
12769,user_12769,18,5,5,0,Sep-18,8,0,0
12770,user_12770,1154,22,15,7,Mar-19,2,0,0
12771,user_12771,900,33,32,1,May-19,0,0,1
12772,user_12772,36,5,5,0,Dec-18,5,0,0
12773,user_12773,15,9,9,0,Nov-18,6,0,0
12774,user_12774,37561,60,34,26,May-19,0,1,1
12775,user_12775,17625,317,86,231,May-19,0,1,1
12776,user_12776,4357,29,3,26,May-19,0,1,1
12777,user_12777,669,16,5,11,Apr-19,1,1,0
12778,user_12778,1157,45,27,18,May-19,0,1,1
12779,user_12779,124,9,9,0,Nov-18,6,0,0
12780,user_12780,513,25,14,11,May-19,0,1,1
12781,user_12781,232,19,19,0,Nov-18,6,0,0
12782,user_12782,23525,972,539,433,May-19,0,1,1
12783,user_12783,2312,59,40,19,May-19,0,0,1
12784,user_12784,1104,47,47,0,Dec-18,5,0,0
12785,user_12785,2497,43,36,7,Apr-19,1,1,0
12786,user_12786,20,3,3,0,Oct-18,7,0,0
12787,user_12787,7296,96,38,58,May-19,0,1,1
12788,user_12788,1207,67,13,54,May-19,0,1,1
12789,user_12789,1852,144,76,68,Feb-19,3,0,0
12790,user_12790,146,7,7,0,Sep-18,8,0,0
12791,user_12791,1529,32,10,22,May-19,0,1,1
12792,user_12792,6003,187,129,58,May-19,0,1,1
12793,user_12793,10498,310,130,180,May-19,0,1,1
12794,user_12794,1304,22,15,7,Apr-19,1,1,0
12795,user_12795,347,11,3,8,Mar-19,2,0,0
12796,user_12796,5228,10,4,6,Jan-19,4,0,0
12797,user_12797,6536,69,35,34,May-19,0,1,1
12798,user_12798,8621,103,86,17,Apr-19,1,1,0
12799,user_12799,35162,138,90,48,Apr-19,1,1,0
12800,user_12800,9461,70,56,14,May-19,0,1,1
12802,user_12802,2573,69,17,52,May-19,0,1,1
12803,user_12803,14569,296,101,195,May-19,0,1,1
12804,user_12804,49,9,8,1,Apr-19,1,1,0
12805,user_12805,873,72,20,52,May-19,0,1,1
12806,user_12806,31,6,6,0,Oct-18,7,0,0
12807,user_12807,185,8,8,0,Oct-18,7,0,0
12808,user_12808,5318,23,16,7,Feb-19,3,0,0
12809,user_12809,225,16,13,3,Feb-19,3,0,0
12810,user_12810,933,92,1,91,Apr-19,1,1,0
12811,user_12811,147,8,8,0,Nov-18,6,0,0
12812,user_12812,34,9,7,2,Apr-19,1,1,0
12813,user_12813,2809,98,57,41,May-19,0,1,1
12814,user_12814,1152,43,43,0,Dec-18,5,0,0
12815,user_12815,5918,234,82,152,May-19,0,1,1
12816,user_12816,4283,602,301,301,May-19,0,1,1
12817,user_12817,415,6,6,0,Oct-18,7,0,0
12818,user_12818,4078,68,35,33,Mar-19,2,0,0
12820,user_12820,430,11,11,0,Oct-18,7,0,0
12821,user_12821,16,3,3,0,Sep-18,8,0,0
12822,user_12822,6747,391,203,188,May-19,0,1,1
12823,user_12823,9828,36,14,22,Apr-19,1,1,0
12824,user_12824,617,42,29,13,May-19,0,0,1
12825,user_12825,722,37,28,9,Mar-19,2,0,0
12826,user_12826,13964,189,58,131,May-19,0,1,1
12827,user_12827,23486,262,147,115,May-19,0,1,1
12828,user_12828,1059,49,21,28,May-19,0,1,1
12829,user_12829,81947,15,1,14,May-19,0,1,1
12830,user_12830,2215,138,2,136,May-19,0,1,1
12831,user_12831,9054,426,214,212,May-19,0,1,1
12832,user_12832,941,7,3,4,May-19,0,1,1
12833,user_12833,1665,62,56,6,Apr-19,1,1,0
12834,user_12834,1213,64,19,45,May-19,0,1,1
12835,user_12835,59,17,9,8,May-19,0,0,1
12836,user_12836,9,1,1,0,Sep-18,8,0,0
12837,user_12837,3758,98,6,92,May-19,0,1,1
12838,user_12838,9267,192,13,179,May-19,0,1,1
12839,user_12839,7222,340,162,178,May-19,0,1,1
12840,user_12840,13690,138,49,89,May-19,0,1,1
12841,user_12841,73,9,9,0,Dec-18,5,0,0
12842,user_12842,3670,226,68,158,May-19,0,1,1
12843,user_12843,128,13,7,6,Jan-19,4,0,0
12845,user_12845,17,2,2,0,Sep-18,8,0,0
12846,user_12846,1399,15,14,1,Feb-19,3,0,0
12847,user_12847,955,47,25,22,Apr-19,1,1,0
12848,user_12848,2037,16,6,10,Jan-19,4,0,0
12849,user_12849,3983,27,27,0,Dec-18,5,0,0
12851,user_12851,2182,37,24,13,May-19,0,1,1
12852,user_12852,6620,273,107,166,May-19,0,1,1
12853,user_12853,3104,62,61,1,Jan-19,4,0,0
12854,user_12854,2748,159,127,32,Apr-19,1,1,0
12855,user_12855,20956,222,59,163,May-19,0,1,1
12856,user_12856,49,5,4,1,May-19,0,0,1
12857,user_12857,1349,136,71,65,May-19,0,1,1
12858,user_12858,1981,22,15,7,May-19,0,0,1
12859,user_12859,29948,170,96,74,May-19,0,1,1
12861,user_12861,2255,50,17,33,May-19,0,1,1
12862,user_12862,313,61,34,27,May-19,0,1,1
12863,user_12863,143,52,13,39,May-19,0,1,1
12864,user_12864,119538,38,13,25,May-19,0,1,1
12865,user_12865,15,3,3,0,Sep-18,8,0,0
12866,user_12866,21490,472,172,300,May-19,0,1,1
12867,user_12867,398,8,8,0,Nov-18,6,0,0
12868,user_12868,7490,555,50,505,May-19,0,1,1
12869,user_12869,3681,418,153,265,May-19,0,1,1
12870,user_12870,690,16,14,2,Mar-19,2,0,0
12871,user_12871,9,2,0,2,May-19,0,0,1
12872,user_12872,3415,95,54,41,Apr-19,1,1,0
12873,user_12873,779,45,37,8,Jan-19,4,0,0
12874,user_12874,2519,86,54,32,Apr-19,1,1,0
12875,user_12875,9817,516,230,286,May-19,0,1,1
12876,user_12876,1610,104,34,70,May-19,0,1,1
12877,user_12877,930,73,22,51,May-19,0,1,1
12878,user_12878,96,4,3,1,Jan-19,4,0,0
12879,user_12879,7315,131,93,38,Apr-19,1,1,0
12880,user_12880,170558,27,16,11,May-19,0,1,1
12881,user_12881,395,42,9,33,May-19,0,1,1
12882,user_12882,20801,315,120,195,May-19,0,1,1
12883,user_12883,6377,197,121,76,May-19,0,1,1
12884,user_12884,1181,65,28,37,May-19,0,1,1
12885,user_12885,2968,27,22,5,May-19,0,1,1
12886,user_12886,2458,21,21,0,Nov-18,6,0,0
12887,user_12887,618,40,27,13,May-19,0,1,1
12888,user_12888,1126,40,19,21,Feb-19,3,0,0
12889,user_12889,21,2,2,0,Sep-18,8,0,0
12890,user_12890,413,10,10,0,Oct-18,7,0,0
12891,user_12891,1828,46,8,38,Apr-19,1,1,0
12892,user_12892,2975,68,27,41,Apr-19,1,1,0
12893,user_12893,1846,36,30,6,Feb-19,3,0,0
12894,user_12894,435105,61,0,61,May-19,0,1,1
12895,user_12895,3838,47,45,2,Apr-19,1,1,0
12896,user_12896,879,74,5,69,Feb-19,3,0,0
12898,user_12898,8217,92,54,38,Apr-19,1,1,0
12899,user_12899,23740,265,50,215,May-19,0,1,1
12900,user_12900,2709,96,61,35,Apr-19,1,1,0
12901,user_12901,11,2,2,0,Sep-18,8,0,0
12902,user_12902,1497,56,44,12,Apr-19,1,1,0
12903,user_12903,9557,32,13,19,May-19,0,0,1
12904,user_12904,18,3,3,0,Oct-18,7,0,0
12905,user_12905,8342,531,156,375,May-19,0,1,1
12906,user_12906,23888,1184,367,817,May-19,0,1,1
12907,user_12907,3816,41,18,23,Apr-19,1,1,0
12908,user_12908,2332,27,16,11,Apr-19,1,1,0
12909,user_12909,1262,39,21,18,Apr-19,1,1,0
12910,user_12910,2730,40,0,40,Apr-19,1,1,0
12911,user_12911,376,16,5,11,Mar-19,2,0,0
12912,user_12912,9326,69,49,20,Jan-19,4,0,0
12913,user_12913,3011,83,78,5,Apr-19,1,1,0
12914,user_12914,3344,214,172,42,May-19,0,1,1
12916,user_12916,4742,353,99,254,May-19,0,1,1
12917,user_12917,31615,766,307,459,May-19,0,1,1
12918,user_12918,21,4,4,0,Sep-18,8,0,0
12919,user_12919,13180,256,78,178,May-19,0,1,1
12920,user_12920,19,5,5,0,Sep-18,8,0,0
12922,user_12922,8,2,2,0,Oct-18,7,0,0
12923,user_12923,5,3,2,1,Mar-19,2,0,0
12924,user_12924,882,22,22,0,Oct-18,7,0,0
12926,user_12926,21374,156,135,21,May-19,0,1,1
12927,user_12927,2544,21,14,7,Jan-19,4,0,0
12928,user_12928,26,4,3,1,Mar-19,2,0,0
12929,user_12929,6622,46,42,4,May-19,0,0,1
12930,user_12930,6927,556,234,322,May-19,0,1,1
12931,user_12931,3432,107,39,68,May-19,0,1,1
12932,user_12932,3708,105,61,44,Apr-19,1,1,0
12933,user_12933,2286,79,53,26,May-19,0,1,1
12934,user_12934,2632,66,58,8,Apr-19,1,1,0
12935,user_12935,9,2,2,0,Oct-18,7,0,0
12936,user_12936,321,66,51,15,May-19,0,1,1
12937,user_12937,2588,114,17,97,May-19,0,1,1
12938,user_12938,2205,158,63,95,May-19,0,1,1
12939,user_12939,9,2,2,0,Sep-18,8,0,0
12940,user_12940,1250,17,17,0,Dec-18,5,0,0
12941,user_12941,13777,104,41,63,Apr-19,1,1,0
12942,user_12942,81,5,5,0,Sep-18,8,0,0
12943,user_12943,14666,596,229,367,May-19,0,1,1
12944,user_12944,4039,115,75,40,May-19,0,1,1
12945,user_12945,16050,210,164,46,Mar-19,2,0,0
12946,user_12946,12,6,6,0,Dec-18,5,0,0
12947,user_12947,14,3,3,0,Sep-18,8,0,0
12948,user_12948,7413,52,52,0,Dec-18,5,0,0
12949,user_12949,6670,75,46,29,Apr-19,1,1,0
12950,user_12950,667,86,25,61,May-19,0,1,1
12951,user_12951,3625,107,61,46,May-19,0,0,1
12952,user_12952,8,4,4,0,Nov-18,6,0,0
12953,user_12953,61,24,11,13,Apr-19,1,1,0
12954,user_12954,14343,34,20,14,Apr-19,1,1,0
12955,user_12955,12822,97,18,79,May-19,0,1,1
12956,user_12956,27078,374,151,223,May-19,0,1,1
12957,user_12957,3505,140,71,69,May-19,0,1,1
12958,user_12958,95,19,15,4,May-19,0,0,1
12959,user_12959,3320,69,59,10,Mar-19,2,0,0
12960,user_12960,1490,30,2,28,May-19,0,1,1
12962,user_12962,186,4,4,0,Sep-18,8,0,0
12963,user_12963,8253,161,47,114,May-19,0,1,1
12964,user_12964,659,21,14,7,Feb-19,3,0,0
12965,user_12965,11753,333,128,205,May-19,0,1,1
12966,user_12966,1103,104,12,92,May-19,0,1,1
12967,user_12967,17587,326,13,313,May-19,0,1,1
12968,user_12968,3186,209,128,81,Mar-19,2,0,0
12969,user_12969,45,4,4,0,Sep-18,8,0,0
12970,user_12970,3530,110,28,82,May-19,0,1,1
12971,user_12971,3898,73,73,0,Oct-18,7,0,0
12972,user_12972,40792,21,7,14,May-19,0,1,1
12973,user_12973,354,67,44,23,May-19,0,1,1
12974,user_12974,1873,28,11,17,Apr-19,1,1,0
12975,user_12975,1928,73,42,31,May-19,0,1,1
12976,user_12976,3229,144,76,68,Apr-19,1,1,0
12977,user_12977,6028,250,93,157,May-19,0,1,1
12978,user_12978,16,11,9,2,Jan-19,4,0,0
12979,user_12979,6089,178,102,76,May-19,0,1,1
12980,user_12980,1354,16,10,6,Apr-19,1,1,0
12982,user_12982,2007,161,64,97,May-19,0,1,1
12983,user_12983,1135,43,17,26,Apr-19,1,1,0
12984,user_12984,195,10,8,2,Mar-19,2,0,0
12985,user_12985,4141,74,58,16,May-19,0,1,1
12986,user_12986,11622,129,64,65,May-19,0,1,1
12987,user_12987,6508,135,42,93,May-19,0,1,1
12988,user_12988,13061,358,113,245,May-19,0,1,1
12989,user_12989,5992,673,135,538,May-19,0,1,1
12990,user_12990,20,3,3,0,Dec-18,5,0,0
12991,user_12991,874,43,24,19,May-19,0,1,1
12992,user_12992,445,28,10,18,May-19,0,1,1
12993,user_12993,5376,112,100,12,Mar-19,2,0,0
12994,user_12994,2492,160,160,0,Oct-18,7,0,0
12995,user_12995,3377,293,0,293,May-19,0,1,1
12996,user_12996,14,3,3,0,Sep-18,8,0,0
12997,user_12997,2232,12,5,7,Mar-19,2,0,0
12998,user_12998,5743,459,90,369,May-19,0,1,1
12999,user_12999,5165,64,35,29,May-19,0,1,1
13000,user_13000,4806,205,102,103,May-19,0,1,1
13001,user_13001,16186,445,157,288,Mar-19,2,0,0
13002,user_13002,16,5,5,0,Oct-18,7,0,0
13003,user_13003,3743,69,35,34,May-19,0,1,1
13004,user_13004,1,1,1,0,Nov-18,6,0,0
13005,user_13005,873709,560,247,313,May-19,0,1,1
13006,user_13006,16,5,5,0,Sep-18,8,0,0
13007,user_13007,791,23,5,18,May-19,0,1,1
13008,user_13008,9277,450,156,294,Mar-19,2,0,0
13009,user_13009,3112,94,13,81,May-19,0,1,1
13010,user_13010,520,39,25,14,Apr-19,1,1,0
13011,user_13011,2920,143,37,106,May-19,0,1,1
13012,user_13012,21814,71,37,34,Apr-19,1,1,0
13013,user_13013,15034,259,109,150,May-19,0,1,1
13015,user_13015,4836,94,87,7,Apr-19,1,1,0
13016,user_13016,5110,116,46,70,May-19,0,1,1
13017,user_13017,32,5,5,0,Sep-18,8,0,0
13018,user_13018,1552,57,20,37,Apr-19,1,1,0
13020,user_13020,135,36,28,8,Jan-19,4,0,0
13021,user_13021,3827,46,42,4,Mar-19,2,0,0
13023,user_13023,1292,93,40,53,Apr-19,1,1,0
13024,user_13024,395,11,6,5,Mar-19,2,0,0
13025,user_13025,51,12,11,1,May-19,0,0,1
13026,user_13026,16500,229,48,181,May-19,0,1,1
13027,user_13027,2841,12,5,7,Feb-19,3,0,0
13028,user_13028,7328,187,134,53,May-19,0,1,1
13029,user_13029,2516,53,22,31,May-19,0,1,1
13030,user_13030,260,14,1,13,May-19,0,1,1
13031,user_13031,500,53,14,39,May-19,0,1,1
13032,user_13032,11116,97,68,29,May-19,0,1,1
13033,user_13033,41,5,3,2,Feb-19,3,0,0
13034,user_13034,63361,218,75,143,May-19,0,1,1
13035,user_13035,30027,319,160,159,May-19,0,1,1
13036,user_13036,402,44,28,16,May-19,0,1,1
13037,user_13037,381,13,13,0,Sep-18,8,0,0
13038,user_13038,867,28,28,0,Oct-18,7,0,0
13039,user_13039,96305,79,34,45,May-19,0,1,1
13040,user_13040,1171,62,62,0,Nov-18,6,0,0
13041,user_13041,2621,11,9,2,Feb-19,3,0,0
13042,user_13042,14323,137,74,63,May-19,0,1,1
13043,user_13043,27713,474,264,210,May-19,0,1,1
13044,user_13044,1362,11,8,3,Feb-19,3,0,0
13045,user_13045,1354,28,10,18,May-19,0,1,1
13046,user_13046,3245,87,7,80,Apr-19,1,1,0
13047,user_13047,4815,177,124,53,Apr-19,1,1,0
13048,user_13048,3370,165,75,90,May-19,0,1,1
13049,user_13049,5318,106,106,0,Dec-18,5,0,0
13050,user_13050,148,12,0,12,May-19,0,1,1
13051,user_13051,1890,78,25,53,May-19,0,1,1
13052,user_13052,276,24,19,5,Feb-19,3,0,0
13053,user_13053,10789,235,103,132,May-19,0,1,1
13054,user_13054,6389,242,54,188,May-19,0,1,1
13055,user_13055,3179,157,106,51,May-19,0,1,1
13056,user_13056,214,6,6,0,Sep-18,8,0,0
13057,user_13057,2,2,2,0,Oct-18,7,0,0
13058,user_13058,17544,532,387,145,May-19,0,1,1
13059,user_13059,11455,63,34,29,Apr-19,1,1,0
13060,user_13060,86,4,4,0,Nov-18,6,0,0
13061,user_13061,842,19,7,12,May-19,0,1,1
13062,user_13062,6285,220,42,178,Apr-19,1,1,0
13063,user_13063,4664,25,6,19,Mar-19,2,0,0
13064,user_13064,1036,28,24,4,Feb-19,3,0,0
13065,user_13065,13357,120,17,103,May-19,0,1,1
13066,user_13066,12570,241,176,65,May-19,0,1,1
13067,user_13067,394,20,6,14,Mar-19,2,0,0
13068,user_13068,24218,345,137,208,May-19,0,1,1
13069,user_13069,1327,89,17,72,May-19,0,1,1
13070,user_13070,431,9,9,0,Oct-18,7,0,0
13071,user_13071,13785,58,17,41,May-19,0,1,1
13072,user_13072,11594,163,60,103,May-19,0,1,1
13073,user_13073,16102,338,50,288,May-19,0,1,1
13074,user_13074,5391,141,51,90,May-19,0,1,1
13075,user_13075,2180,87,23,64,May-19,0,1,1
13076,user_13076,554,50,34,16,May-19,0,1,1
13077,user_13077,1578,75,31,44,May-19,0,1,1
13078,user_13078,12310,141,13,128,Apr-19,1,1,0
13079,user_13079,12927,181,10,171,May-19,0,1,1
13080,user_13080,13734,273,121,152,May-19,0,1,1
13081,user_13081,1356,58,0,58,May-19,0,1,1
13082,user_13082,1006,43,38,5,May-19,0,1,1
13083,user_13083,170,1,1,0,Sep-18,8,0,0
13084,user_13084,20,1,0,1,May-19,0,0,1
13085,user_13085,9,2,2,0,Sep-18,8,0,0
13086,user_13086,399,51,19,32,May-19,0,1,1
13087,user_13087,24488,212,33,179,May-19,0,1,1
13088,user_13088,26878,1223,262,961,May-19,0,1,1
13089,user_13089,101,5,5,0,Oct-18,7,0,0
13090,user_13090,5148,148,40,108,May-19,0,1,1
13091,user_13091,12682,236,131,105,May-19,0,1,1
13092,user_13092,2550,38,4,34,May-19,0,1,1
13093,user_13093,1548,40,40,0,Dec-18,5,0,0
13094,user_13094,14610,463,209,254,May-19,0,1,1
13095,user_13095,3817,18,13,5,Apr-19,1,1,0
13096,user_13096,2008,67,21,46,May-19,0,1,1
13097,user_13097,14332,52,9,43,Apr-19,1,1,0
13098,user_13098,163,8,0,8,Feb-19,3,0,0
13099,user_13099,4969,44,10,34,May-19,0,1,1
13100,user_13100,22825,933,214,719,May-19,0,1,1
13101,user_13101,1522,28,28,0,Nov-18,6,0,0
13103,user_13103,9,1,1,0,Sep-18,8,0,0
13104,user_13104,49,8,8,0,Oct-18,7,0,0
13105,user_13105,1,1,1,0,Sep-18,8,0,0
13106,user_13106,5733,14,10,4,May-19,0,1,1
13107,user_13107,7158,101,82,19,Apr-19,1,1,0
13108,user_13108,4666,28,7,21,Mar-19,2,0,0
13109,user_13109,34243,786,293,493,May-19,0,1,1
13110,user_13110,2943,164,65,99,May-19,0,1,1
13111,user_13111,2809,161,154,7,Apr-19,1,1,0
13112,user_13112,2437,62,27,35,Apr-19,1,1,0
13113,user_13113,9302,495,219,276,May-19,0,1,1
13114,user_13114,930,61,52,9,Apr-19,1,1,0
13115,user_13115,4545,50,28,22,May-19,0,1,1
13116,user_13116,21,4,4,0,Sep-18,8,0,0
13117,user_13117,6496,65,18,47,Apr-19,1,1,0
13118,user_13118,4302,148,102,46,Apr-19,1,1,0
13119,user_13119,70556,512,108,404,May-19,0,1,1
13120,user_13120,1041,104,10,94,May-19,0,1,1
13121,user_13121,6920,569,351,218,Mar-19,2,0,0
13122,user_13122,1171,106,10,96,May-19,0,1,1
13123,user_13123,8,2,2,0,Sep-18,8,0,0
13125,user_13125,1242,32,16,16,Apr-19,1,1,0
13126,user_13126,98,21,18,3,Jan-19,4,0,0
13127,user_13127,6221,173,110,63,May-19,0,1,1
13128,user_13128,1044,13,7,6,Apr-19,1,1,0
13129,user_13129,3052,38,33,5,Apr-19,1,1,0
13130,user_13130,53802,41,27,14,Feb-19,3,0,0
13131,user_13131,1977,46,45,1,Apr-19,1,1,0
13132,user_13132,16360,607,132,475,May-19,0,1,1
13133,user_13133,6914,305,92,213,May-19,0,1,1
13134,user_13134,7269,185,49,136,Apr-19,1,1,0
13135,user_13135,795,41,37,4,May-19,0,1,1
13136,user_13136,13375,449,252,197,May-19,0,1,1
13137,user_13137,11907,40,31,9,Apr-19,1,1,0
13138,user_13138,154,20,0,20,Apr-19,1,1,0
13139,user_13139,18,3,3,0,Oct-18,7,0,0
13140,user_13140,742,21,9,12,Mar-19,2,0,0
13141,user_13141,33027,40,21,19,Apr-19,1,1,0
13142,user_13142,4188,53,15,38,May-19,0,1,1
13143,user_13143,2907,63,17,46,May-19,0,1,1
13144,user_13144,200,4,4,0,Nov-18,6,0,0
13145,user_13145,5214,186,45,141,May-19,0,1,1
13146,user_13146,1987,145,42,103,May-19,0,1,1
13147,user_13147,30500,2307,580,1727,May-19,0,1,1
13148,user_13148,1178,65,43,22,Apr-19,1,1,0
13149,user_13149,11636,189,59,130,May-19,0,1,1
13151,user_13151,36599,144,80,64,May-19,0,1,1
13152,user_13152,178,7,7,0,Nov-18,6,0,0
13153,user_13153,6386,66,65,1,Mar-19,2,0,0
13154,user_13154,22,11,10,1,Jan-19,4,0,0
13155,user_13155,223,40,6,34,Apr-19,1,1,0
13157,user_13157,82266,490,159,331,May-19,0,1,1
13158,user_13158,9543,115,111,4,Apr-19,1,1,0
13160,user_13160,14,3,3,0,Oct-18,7,0,0
13161,user_13161,16349,38,17,21,May-19,0,1,1
13162,user_13162,3691,132,78,54,May-19,0,1,1
13163,user_13163,3344,55,18,37,May-19,0,1,1
13164,user_13164,3836,281,86,195,May-19,0,1,1
13165,user_13165,7122,545,375,170,May-19,0,1,1
13166,user_13166,14,5,3,2,Apr-19,1,1,0
13167,user_13167,6,4,4,0,Oct-18,7,0,0
13168,user_13168,242,38,8,30,May-19,0,1,1
13169,user_13169,79640,706,205,501,May-19,0,1,1
13170,user_13170,6148,178,35,143,May-19,0,1,1
13171,user_13171,29322,1177,479,698,May-19,0,1,1
13172,user_13172,94,12,12,0,Oct-18,7,0,0
13174,user_13174,213,76,37,39,Apr-19,1,1,0
13175,user_13175,76,9,9,0,Nov-18,6,0,0
13176,user_13176,301,3,3,0,Sep-18,8,0,0
13177,user_13177,407,8,4,4,Mar-19,2,0,0
13178,user_13178,14325,260,82,178,May-19,0,1,1
13179,user_13179,2591,89,33,56,Apr-19,1,1,0
13181,user_13181,15414,146,28,118,May-19,0,1,1
13182,user_13182,4946,241,137,104,Apr-19,1,1,0
13183,user_13183,1317,26,26,0,Oct-18,7,0,0
13184,user_13184,1581,112,88,24,Apr-19,1,1,0
13185,user_13185,62,10,9,1,Apr-19,1,1,0
13186,user_13186,20,4,4,0,Sep-18,8,0,0
13187,user_13187,1811,28,15,13,May-19,0,1,1
13188,user_13188,1422,51,48,3,Jan-19,4,0,0
13191,user_13191,5268,93,40,53,May-19,0,1,1
13192,user_13192,1052,24,10,14,Apr-19,1,1,0
13193,user_13193,344,27,26,1,Jan-19,4,0,0
13194,user_13194,11,2,2,0,Oct-18,7,0,0
13195,user_13195,822,77,12,65,Apr-19,1,1,0
13196,user_13196,4928,145,143,2,Mar-19,2,0,0
13197,user_13197,5094,64,45,19,Apr-19,1,1,0
13198,user_13198,20,1,1,0,Nov-18,6,0,0
13199,user_13199,8961,263,97,166,May-19,0,1,1
13200,user_13200,20149,810,313,497,May-19,0,1,1
13201,user_13201,9,2,2,0,Sep-18,8,0,0
13202,user_13202,193,8,7,1,Apr-19,1,1,0
13203,user_13203,134486,799,380,419,May-19,0,1,1
13204,user_13204,6211,113,10,103,May-19,0,1,1
13205,user_13205,12130,698,54,644,May-19,0,1,1
13206,user_13206,1774,29,25,4,Mar-19,2,0,0
13207,user_13207,20,6,6,0,Sep-18,8,0,0
13208,user_13208,799,16,3,13,May-19,0,1,1
13209,user_13209,58,5,5,0,Oct-18,7,0,0
13210,user_13210,43196,885,198,687,May-19,0,1,1
13211,user_13211,2769,203,53,150,May-19,0,1,1
13212,user_13212,6564,197,133,64,May-19,0,1,1
13213,user_13213,2211,28,18,10,Mar-19,2,0,0
13214,user_13214,2470,120,5,115,May-19,0,1,1
13215,user_13215,795,61,19,42,Apr-19,1,1,0
13216,user_13216,6712,114,39,75,May-19,0,1,1
13217,user_13217,3483,26,23,3,Mar-19,2,0,0
13218,user_13218,5837,110,17,93,May-19,0,1,1
13219,user_13219,1096,21,5,16,Jan-19,4,0,0
13220,user_13220,26176,480,202,278,May-19,0,1,1
13221,user_13221,4996,27,9,18,Mar-19,2,0,0
13222,user_13222,2371,60,5,55,May-19,0,1,1
13223,user_13223,159,13,13,0,Nov-18,6,0,0
13224,user_13224,9897,80,75,5,May-19,0,0,1
13225,user_13225,1339,27,3,24,Apr-19,1,1,0
13226,user_13226,106973,328,201,127,May-19,0,1,1
13227,user_13227,732,3,0,3,Mar-19,2,0,0
13228,user_13228,159,2,2,0,Sep-18,8,0,0
13229,user_13229,59,12,8,4,Apr-19,1,1,0
13230,user_13230,5824,31,9,22,May-19,0,1,1
13231,user_13231,1310,80,61,19,Mar-19,2,0,0
13232,user_13232,3648,33,14,19,Apr-19,1,1,0
13233,user_13233,8505,393,325,68,Mar-19,2,0,0
13234,user_13234,5038,314,124,190,May-19,0,1,1
13235,user_13235,632,39,38,1,Apr-19,1,1,0
13236,user_13236,17,4,4,0,Sep-18,8,0,0
13237,user_13237,25634,275,164,111,May-19,0,1,1
13238,user_13238,1515,143,28,115,May-19,0,1,1
13239,user_13239,7966,83,12,71,May-19,0,1,1
13240,user_13240,22621,374,165,209,May-19,0,1,1
13241,user_13241,16836,59,32,27,May-19,0,1,1
13242,user_13242,17939,60,60,0,Oct-18,7,0,0
13244,user_13244,1740,49,4,45,May-19,0,1,1
13245,user_13245,476,7,7,0,Nov-18,6,0,0
13246,user_13246,19317,1160,414,746,May-19,0,1,1
13247,user_13247,74,24,5,19,Apr-19,1,1,0
13248,user_13248,1,1,1,0,Sep-18,8,0,0
13249,user_13249,26595,551,346,205,Mar-19,2,0,0
13250,user_13250,2533,178,55,123,May-19,0,1,1
13251,user_13251,18,4,4,0,Sep-18,8,0,0
13252,user_13252,87,3,3,0,Sep-18,8,0,0
13253,user_13253,1255,26,26,0,Dec-18,5,0,0
13254,user_13254,891,44,31,13,Mar-19,2,0,0
13255,user_13255,1,1,1,0,Oct-18,7,0,0
13256,user_13256,67,11,6,5,Apr-19,1,1,0
13257,user_13257,23,4,4,0,Sep-18,8,0,0
13258,user_13258,3033,27,15,12,May-19,0,1,1
13259,user_13259,1652,207,99,108,May-19,0,1,1
13260,user_13260,6153,105,43,62,Mar-19,2,0,0
13261,user_13261,1343,63,57,6,Apr-19,1,1,0
13262,user_13262,14631,612,403,209,May-19,0,1,1
13263,user_13263,6730,425,76,349,May-19,0,1,1
13264,user_13264,214,9,9,0,Oct-18,7,0,0
13265,user_13265,2129,20,7,13,May-19,0,1,1
13266,user_13266,33281,36,12,24,Apr-19,1,1,0
13267,user_13267,22240,157,54,103,May-19,0,1,1
13268,user_13268,16,3,3,0,Sep-18,8,0,0
13269,user_13269,30,8,8,0,Nov-18,6,0,0
13270,user_13270,1133,38,7,31,Apr-19,1,1,0
13271,user_13271,5695,175,34,141,Apr-19,1,1,0
13272,user_13272,11,2,2,0,Sep-18,8,0,0
13273,user_13273,75,35,25,10,Apr-19,1,1,0
13274,user_13274,219,7,3,4,Mar-19,2,0,0
13275,user_13275,389,26,3,23,Feb-19,3,0,0
13276,user_13276,12058,227,129,98,May-19,0,1,1
13277,user_13277,9252,82,16,66,May-19,0,1,1
13278,user_13278,114311,191,108,83,May-19,0,1,1
13279,user_13279,5176,74,50,24,Apr-19,1,1,0
13280,user_13280,194,23,8,15,Apr-19,1,1,0
13281,user_13281,17,4,0,4,Mar-19,2,0,0
13282,user_13282,1019,48,44,4,Mar-19,2,0,0
13283,user_13283,1804,144,29,115,May-19,0,1,1
13284,user_13284,334,17,15,2,Feb-19,3,0,0
13285,user_13285,3656,50,29,21,Apr-19,1,1,0
13286,user_13286,9,2,2,0,Sep-18,8,0,0
13287,user_13287,2756,94,94,0,Nov-18,6,0,0
13288,user_13288,3575,136,55,81,May-19,0,1,1
13289,user_13289,7399,77,48,29,Mar-19,2,0,0
13290,user_13290,2202,28,27,1,Mar-19,2,0,0
13291,user_13291,4863,101,33,68,May-19,0,1,1
13292,user_13292,403,20,2,18,Mar-19,2,0,0
13293,user_13293,33,5,5,0,Oct-18,7,0,0
13294,user_13294,9666,271,108,163,May-19,0,1,1
13295,user_13295,121,23,0,23,May-19,0,1,1
13296,user_13296,8059,324,122,202,May-19,0,1,1
13297,user_13297,21072,96,40,56,May-19,0,1,1
13298,user_13298,3165,107,13,94,May-19,0,1,1
13300,user_13300,260,23,15,8,Mar-19,2,0,0
13303,user_13303,48149,381,130,251,May-19,0,1,1
13305,user_13305,24376,279,158,121,May-19,0,1,1
13306,user_13306,598,41,2,39,May-19,0,1,1
13307,user_13307,3119,93,24,69,May-19,0,1,1
13308,user_13308,958,54,27,27,Apr-19,1,1,0
13309,user_13309,1492,56,15,41,May-19,0,1,1
13310,user_13310,31,2,0,2,Jan-19,4,0,0
13311,user_13311,13452,288,100,188,May-19,0,1,1
13312,user_13312,17982,842,278,564,May-19,0,1,1
13313,user_13313,153,26,10,16,Jan-19,4,0,0
13314,user_13314,52,7,0,7,Apr-19,1,1,0
13315,user_13315,671,18,6,12,May-19,0,1,1
13316,user_13316,5903,94,60,34,May-19,0,1,1
13317,user_13317,6731,359,10,349,May-19,0,1,1
13318,user_13318,4892,96,1,95,Apr-19,1,1,0
13319,user_13319,5003,365,38,327,May-19,0,1,1
13320,user_13320,20,2,2,0,Oct-18,7,0,0
13321,user_13321,1217,50,20,30,Apr-19,1,1,0
13322,user_13322,29780,655,141,514,May-19,0,1,1
13323,user_13323,6437,98,67,31,Apr-19,1,1,0
13324,user_13324,21,3,3,0,Oct-18,7,0,0
13325,user_13325,1951,65,33,32,Apr-19,1,1,0
13326,user_13326,2898,28,7,21,Apr-19,1,1,0
13327,user_13327,10740,285,175,110,Mar-19,2,0,0
13328,user_13328,4631,74,12,62,Apr-19,1,1,0
13329,user_13329,639,89,23,66,May-19,0,1,1
13330,user_13330,39760,13,10,3,Apr-19,1,1,0
13331,user_13331,8708,36,27,9,Apr-19,1,1,0
13332,user_13332,11,2,2,0,Oct-18,7,0,0
13333,user_13333,544,51,10,41,May-19,0,1,1
13334,user_13334,2450,50,3,47,May-19,0,0,1
13335,user_13335,376,11,6,5,May-19,0,1,1
13336,user_13336,3029,55,51,4,Mar-19,2,0,0
13337,user_13337,12,5,5,0,Oct-18,7,0,0
13338,user_13338,9589,91,11,80,May-19,0,1,1
13339,user_13339,8,3,3,0,Oct-18,7,0,0
13340,user_13340,21710,102,28,74,Apr-19,1,1,0
13342,user_13342,108,33,21,12,May-19,0,1,1
13343,user_13343,12763,315,162,153,May-19,0,1,1
13344,user_13344,1637,42,38,4,May-19,0,0,1
13345,user_13345,8,2,2,0,Oct-18,7,0,0
13346,user_13346,10808,121,28,93,May-19,0,1,1
13347,user_13347,2744,103,5,98,May-19,0,1,1
13348,user_13348,16,3,0,3,Apr-19,1,1,0
13349,user_13349,1322,39,37,2,Apr-19,1,1,0
13350,user_13350,5445,114,79,35,May-19,0,1,1
13351,user_13351,8107,206,0,206,Apr-19,1,1,0
13352,user_13352,15794,921,178,743,May-19,0,1,1
13353,user_13353,11444,402,96,306,May-19,0,1,1
13354,user_13354,17,3,3,0,Nov-18,6,0,0
13355,user_13355,33847,107,71,36,Mar-19,2,0,0
13356,user_13356,44,7,4,3,May-19,0,0,1
13357,user_13357,1603,92,35,57,Feb-19,3,0,0
13358,user_13358,5559,47,0,47,May-19,0,1,1
13359,user_13359,12946,348,176,172,May-19,0,1,1
13360,user_13360,9849,175,97,78,May-19,0,1,1
13361,user_13361,6415,266,107,159,May-19,0,1,1
13362,user_13362,11,2,2,0,Nov-18,6,0,0
13363,user_13363,22496,63,13,50,May-19,0,1,1
13364,user_13364,64,4,4,0,Oct-18,7,0,0
13366,user_13366,2724,103,6,97,Apr-19,1,1,0
13367,user_13367,8020,199,30,169,May-19,0,1,1
13368,user_13368,3130,253,60,193,May-19,0,1,1
13369,user_13369,5210,47,10,37,Apr-19,1,1,0
13370,user_13370,4653,143,6,137,May-19,0,1,1
13372,user_13372,110,9,5,4,Apr-19,1,1,0
13373,user_13373,462,34,23,11,May-19,0,0,1
13374,user_13374,2471,77,63,14,Mar-19,2,0,0
13376,user_13376,2695,184,76,108,May-19,0,1,1
13377,user_13377,125,8,2,6,Mar-19,2,0,0
13378,user_13378,15764,431,66,365,May-19,0,1,1
13379,user_13379,1819,85,22,63,May-19,0,1,1
13380,user_13380,2197,60,60,0,Dec-18,5,0,0
13381,user_13381,15395,215,65,150,May-19,0,1,1
13383,user_13383,10,10,7,3,Jan-19,4,0,0
13384,user_13384,2900,251,105,146,May-19,0,1,1
13385,user_13385,1344,39,0,39,Apr-19,1,1,0
13386,user_13386,1937,82,53,29,Mar-19,2,0,0
13387,user_13387,3237,276,80,196,May-19,0,1,1
13388,user_13388,5101,206,116,90,May-19,0,1,1
13389,user_13389,381,12,4,8,May-19,0,1,1
13390,user_13390,15,6,6,0,Dec-18,5,0,0
13391,user_13391,25,7,3,4,Jan-19,4,0,0
13392,user_13392,5193,417,4,413,May-19,0,1,1
13393,user_13393,9238,190,20,170,May-19,0,1,1
13394,user_13394,16,5,0,5,May-19,0,0,1
13395,user_13395,825,30,11,19,May-19,0,1,1
13396,user_13396,501,24,13,11,Mar-19,2,0,0
13397,user_13397,988,23,3,20,May-19,0,1,1
13398,user_13398,23463,183,0,183,May-19,0,1,1
13399,user_13399,45,8,8,0,Nov-18,6,0,0
13400,user_13400,5967,260,146,114,Apr-19,1,1,0
13401,user_13401,726,28,28,0,Nov-18,6,0,0
13402,user_13402,9,2,2,0,Oct-18,7,0,0
13403,user_13403,60,8,1,7,Feb-19,3,0,0
13404,user_13404,8444,126,55,71,May-19,0,1,1
13405,user_13405,18248,186,94,92,May-19,0,1,1
13406,user_13406,3729,73,73,0,Nov-18,6,0,0
13407,user_13407,248,109,97,12,Mar-19,2,0,0
13410,user_13410,3777,165,32,133,Apr-19,1,1,0
13411,user_13411,811,19,4,15,Apr-19,1,1,0
13412,user_13412,101,5,3,2,Jan-19,4,0,0
13413,user_13413,26,4,4,0,Oct-18,7,0,0
13414,user_13414,2603,72,18,54,May-19,0,1,1
13416,user_13416,869,268,4,264,May-19,0,1,1
13417,user_13417,132,17,14,3,Apr-19,1,1,0
13418,user_13418,21761,128,20,108,May-19,0,1,1
13419,user_13419,1262,45,45,0,Nov-18,6,0,0
13420,user_13420,18,3,3,0,Oct-18,7,0,0
13421,user_13421,6099,407,120,287,May-19,0,1,1
13422,user_13422,2603,88,42,46,May-19,0,1,1
13423,user_13423,1293,40,35,5,Apr-19,1,1,0
13425,user_13425,2921,12,11,1,Jan-19,4,0,0
13426,user_13426,194,17,7,10,Mar-19,2,0,0
13427,user_13427,3587,29,5,24,May-19,0,1,1
13428,user_13428,2789,124,0,124,May-19,0,1,1
13429,user_13429,9,2,2,0,Oct-18,7,0,0
13430,user_13430,11351,392,88,304,May-19,0,1,1
13431,user_13431,16,3,3,0,Oct-18,7,0,0
13432,user_13432,7053,61,39,22,May-19,0,1,1
13433,user_13433,17685,279,118,161,May-19,0,1,1
13434,user_13434,4665,224,123,101,May-19,0,1,1
13435,user_13435,1931,82,17,65,May-19,0,1,1
13436,user_13436,27,4,3,1,Jan-19,4,0,0
13437,user_13437,8744,406,251,155,May-19,0,1,1
13438,user_13438,1486,41,23,18,May-19,0,1,1
13439,user_13439,30030,311,115,196,May-19,0,1,1
13440,user_13440,2555,127,29,98,May-19,0,1,1
13441,user_13441,2310,31,25,6,Apr-19,1,1,0
13442,user_13442,2571,56,2,54,Apr-19,1,1,0
13443,user_13443,46971,405,164,241,May-19,0,1,1
13444,user_13444,1343,26,26,0,Nov-18,6,0,0
13445,user_13445,43301,562,247,315,May-19,0,1,1
13446,user_13446,2000,27,17,10,Apr-19,1,1,0
13447,user_13447,955,30,19,11,May-19,0,1,1
13448,user_13448,10635,95,84,11,May-19,0,0,1
13450,user_13450,3168,136,22,114,May-19,0,1,1
13452,user_13452,1362,175,34,141,May-19,0,1,1
13453,user_13453,3941,19,3,16,Apr-19,1,1,0
13454,user_13454,49786,131,45,86,Apr-19,1,1,0
13455,user_13455,18,3,1,2,May-19,0,0,1
13456,user_13456,944,17,9,8,May-19,0,0,1
13457,user_13457,1477,76,26,50,May-19,0,0,1
13458,user_13458,2951,122,11,111,May-19,0,1,1
13459,user_13459,11599,45,4,41,May-19,0,1,1
13460,user_13460,21,3,3,0,Oct-18,7,0,0
13461,user_13461,193,12,5,7,Jan-19,4,0,0
13462,user_13462,331,8,2,6,May-19,0,1,1
13463,user_13463,1183,65,9,56,May-19,0,1,1
13464,user_13464,524,63,39,24,Apr-19,1,1,0
13465,user_13465,31,7,6,1,Apr-19,1,1,0
13466,user_13466,28494,168,6,162,May-19,0,1,1
13467,user_13467,20707,242,15,227,May-19,0,1,1
13468,user_13468,6724,204,10,194,May-19,0,1,1
13469,user_13469,13696,221,49,172,May-19,0,1,1
13470,user_13470,925,22,3,19,Feb-19,3,0,0
13471,user_13471,128,3,3,0,Dec-18,5,0,0
13472,user_13472,2495,87,30,57,Apr-19,1,1,0
13473,user_13473,33499,138,70,68,May-19,0,1,1
13474,user_13474,785,122,19,103,May-19,0,1,1
13475,user_13475,5998,88,39,49,May-19,0,1,1
13476,user_13476,3144,44,5,39,May-19,0,1,1
13477,user_13477,2245,192,79,113,May-19,0,1,1
13478,user_13478,14984,570,56,514,May-19,0,1,1
13479,user_13479,9441,155,71,84,May-19,0,1,1
13480,user_13480,23,3,3,0,Oct-18,7,0,0
13481,user_13481,9,2,2,0,Oct-18,7,0,0
13482,user_13482,33717,772,117,655,May-19,0,1,1
13483,user_13483,931,24,11,13,Apr-19,1,1,0
13484,user_13484,4380,131,42,89,Apr-19,1,1,0
13485,user_13485,31,6,6,0,Oct-18,7,0,0
13486,user_13486,3140,130,7,123,May-19,0,1,1
13487,user_13487,1853,44,2,42,May-19,0,1,1
13488,user_13488,941,25,1,24,Apr-19,1,1,0
13489,user_13489,1468,17,17,0,Dec-18,5,0,0
13490,user_13490,4275,265,98,167,May-19,0,1,1
13491,user_13491,33,9,7,2,Apr-19,1,1,0
13492,user_13492,179,21,11,10,May-19,0,1,1
13493,user_13493,21897,25,25,0,Dec-18,5,0,0
13494,user_13494,376,53,17,36,May-19,0,1,1
13496,user_13496,1633,42,7,35,Apr-19,1,1,0
13497,user_13497,359,14,11,3,Jan-19,4,0,0
13498,user_13498,28335,238,92,146,May-19,0,1,1
13500,user_13500,1996,35,7,28,May-19,0,1,1
13501,user_13501,3569,39,11,28,Apr-19,1,1,0
13502,user_13502,197,13,5,8,Apr-19,1,1,0
13503,user_13503,4946,24,6,18,Apr-19,1,1,0
13504,user_13504,5002,156,113,43,May-19,0,1,1
13505,user_13505,26826,388,188,200,May-19,0,1,1
13506,user_13506,562,12,9,3,Apr-19,1,1,0
13507,user_13507,5555,235,101,134,May-19,0,1,1
13508,user_13508,1994,22,17,5,May-19,0,0,1
13509,user_13509,6239,71,59,12,Apr-19,1,1,0
13510,user_13510,4173,40,30,10,Apr-19,1,1,0
13511,user_13511,18,4,4,0,Oct-18,7,0,0
13512,user_13512,174,35,17,18,Apr-19,1,1,0
13513,user_13513,9,4,4,0,Dec-18,5,0,0
13514,user_13514,1718,53,35,18,May-19,0,0,1
13515,user_13515,2640,44,44,0,Nov-18,6,0,0
13516,user_13516,23123,919,288,631,May-19,0,1,1
13517,user_13517,647,26,3,23,May-19,0,1,1
13518,user_13518,148,13,13,0,Oct-18,7,0,0
13519,user_13519,8234,637,161,476,May-19,0,1,1
13520,user_13520,3000,46,21,25,Apr-19,1,1,0
13521,user_13521,140,32,22,10,Apr-19,1,1,0
13522,user_13522,7204,340,78,262,May-19,0,1,1
13524,user_13524,7225,216,38,178,May-19,0,1,1
13525,user_13525,687,32,16,16,May-19,0,1,1
13526,user_13526,1710,37,28,9,Jan-19,4,0,0
13527,user_13527,3917,122,122,0,Dec-18,5,0,0
13528,user_13528,286,23,2,21,May-19,0,0,1
13530,user_13530,17,2,2,0,Oct-18,7,0,0
13531,user_13531,8305,80,43,37,May-19,0,1,1
13532,user_13532,863,97,29,68,Apr-19,1,1,0
13533,user_13533,935,14,11,3,Feb-19,3,0,0
13534,user_13534,864,54,0,54,Apr-19,1,1,0
13535,user_13535,854299,174,4,170,May-19,0,1,1
13536,user_13536,1365,34,9,25,May-19,0,1,1
13537,user_13537,6722,52,44,8,Jan-19,4,0,0
13538,user_13538,16,3,3,0,Oct-18,7,0,0
13539,user_13539,2793,36,1,35,Apr-19,1,1,0
13540,user_13540,273,3,3,0,Oct-18,7,0,0
13541,user_13541,146,16,15,1,Jan-19,4,0,0
13542,user_13542,14,3,3,0,Oct-18,7,0,0
13543,user_13543,18,4,4,0,Oct-18,7,0,0
13544,user_13544,5443,89,47,42,May-19,0,1,1
13545,user_13545,6255,70,19,51,Apr-19,1,1,0
13546,user_13546,469,28,16,12,Apr-19,1,1,0
13547,user_13547,1801,65,18,47,May-19,0,1,1
13548,user_13548,10517,267,129,138,May-19,0,1,1
13549,user_13549,16797,278,134,144,May-19,0,1,1
13550,user_13550,104,42,15,27,May-19,0,1,1
13551,user_13551,70,14,4,10,Apr-19,1,1,0
13552,user_13552,1125,19,16,3,Apr-19,1,1,0
13553,user_13553,5940,195,19,176,May-19,0,1,1
13554,user_13554,836,35,14,21,May-19,0,1,1
13555,user_13555,19603,29,25,4,Jan-19,4,0,0
13556,user_13556,2077,57,6,51,May-19,0,1,1
13557,user_13557,21,3,3,0,Oct-18,7,0,0
13558,user_13558,1886,34,6,28,Apr-19,1,1,0
13560,user_13560,4220,23,23,0,Dec-18,5,0,0
13561,user_13561,13828,307,76,231,May-19,0,1,1
13562,user_13562,18462,619,110,509,May-19,0,1,1
13563,user_13563,7217,132,123,9,Apr-19,1,1,0
13564,user_13564,4308,149,113,36,Apr-19,1,1,0
13565,user_13565,21945,83,27,56,May-19,0,1,1
13566,user_13566,258,13,4,9,May-19,0,0,1
13567,user_13567,6525,63,9,54,May-19,0,1,1
13568,user_13568,1375,26,22,4,Feb-19,3,0,0
13569,user_13569,9,2,2,0,Nov-18,6,0,0
13570,user_13570,1334,26,26,0,Nov-18,6,0,0
13571,user_13571,6192,98,16,82,Apr-19,1,1,0
13572,user_13572,33,8,8,0,Dec-18,5,0,0
13573,user_13573,35452,156,93,63,May-19,0,1,1
13574,user_13574,14331,698,15,683,Apr-19,1,1,0
13575,user_13575,6826,196,18,178,May-19,0,1,1
13576,user_13576,4633,107,61,46,Apr-19,1,1,0
13577,user_13577,16,3,3,0,Oct-18,7,0,0
13578,user_13578,489,2,2,0,Oct-18,7,0,0
13579,user_13579,110,6,3,3,May-19,0,1,1
13580,user_13580,9506,38,21,17,Jan-19,4,0,0
13581,user_13581,99,11,5,6,Feb-19,3,0,0
13582,user_13582,15682,403,34,369,May-19,0,1,1
13583,user_13583,7283,87,58,29,May-19,0,1,1
13584,user_13584,12114,229,70,159,May-19,0,1,1
13585,user_13585,3099,103,25,78,May-19,0,1,1
13586,user_13586,733,76,19,57,May-19,0,1,1
13587,user_13587,9,1,0,1,Feb-19,3,0,0
13588,user_13588,2135,51,51,0,Oct-18,7,0,0
13589,user_13589,2447,171,63,108,May-19,0,1,1
13590,user_13590,147,6,5,1,Jan-19,4,0,0
13591,user_13591,2806,70,8,62,May-19,0,1,1
13592,user_13592,3127,20,2,18,Feb-19,3,0,0
13593,user_13593,3867,177,53,124,May-19,0,1,1
13594,user_13594,6221,211,102,109,May-19,0,1,1
13595,user_13595,318,9,9,0,Oct-18,7,0,0
13596,user_13596,191,22,11,11,Mar-19,2,0,0
13597,user_13597,2013,87,42,45,May-19,0,1,1
13598,user_13598,12489,326,52,274,May-19,0,1,1
13599,user_13599,8,1,1,0,Oct-18,7,0,0
13600,user_13600,2698,108,8,100,May-19,0,1,1
13601,user_13601,2323,26,26,0,Dec-18,5,0,0
13602,user_13602,66408,58,32,26,May-19,0,1,1
13603,user_13603,5538,244,106,138,May-19,0,1,1
13604,user_13604,47120,145,19,126,Apr-19,1,1,0
13605,user_13605,915,22,9,13,Mar-19,2,0,0
13606,user_13606,1097,49,29,20,Feb-19,3,0,0
13607,user_13607,80,19,14,5,Feb-19,3,0,0
13608,user_13608,2915,100,55,45,May-19,0,1,1
13609,user_13609,7466,134,43,91,May-19,0,1,1
13612,user_13612,27393,158,17,141,May-19,0,1,1
13613,user_13613,7357,97,17,80,May-19,0,1,1
13614,user_13614,30953,30,15,15,Apr-19,1,1,0
13615,user_13615,19220,73,27,46,Apr-19,1,1,0
13616,user_13616,153,5,5,0,Nov-18,6,0,0
13617,user_13617,1447,84,36,48,Apr-19,1,1,0
13618,user_13618,8529,328,91,237,May-19,0,1,1
13619,user_13619,351,38,3,35,May-19,0,1,1
13620,user_13620,12460,116,37,79,May-19,0,1,1
13621,user_13621,17931,281,110,171,May-19,0,1,1
13622,user_13622,5863,145,93,52,Apr-19,1,1,0
13623,user_13623,362,54,53,1,Mar-19,2,0,0
13624,user_13624,8841,168,83,85,May-19,0,1,1
13625,user_13625,830,15,2,13,Mar-19,2,0,0
13626,user_13626,954,27,6,21,Apr-19,1,1,0
13627,user_13627,42,7,7,0,Dec-18,5,0,0
13628,user_13628,198,29,16,13,Feb-19,3,0,0
13629,user_13629,1569,39,24,15,Apr-19,1,1,0
13630,user_13630,1410,33,2,31,May-19,0,1,1
13631,user_13631,2758,46,4,42,Mar-19,2,0,0
13632,user_13632,23304,235,96,139,May-19,0,1,1
13633,user_13633,64662,32,14,18,Apr-19,1,1,0
13634,user_13634,14,4,4,0,Dec-18,5,0,0
13635,user_13635,284,8,8,0,Oct-18,7,0,0
13636,user_13636,8960,204,116,88,May-19,0,1,1
13637,user_13637,2748,30,30,0,Nov-18,6,0,0
13638,user_13638,47,7,7,0,Dec-18,5,0,0
13639,user_13639,1013,9,9,0,Nov-18,6,0,0
13640,user_13640,4791,97,32,65,Apr-19,1,1,0
13641,user_13641,4283,77,69,8,Mar-19,2,0,0
13642,user_13642,5192,14,9,5,Mar-19,2,0,0
13643,user_13643,304,41,28,13,Jan-19,4,0,0
13644,user_13644,2460,44,44,0,Oct-18,7,0,0
13645,user_13645,166,25,8,17,May-19,0,0,1
13646,user_13646,70,25,16,9,Jan-19,4,0,0
13647,user_13647,1516,86,82,4,Mar-19,2,0,0
13648,user_13648,3426,154,109,45,Mar-19,2,0,0
13649,user_13649,966,25,16,9,Apr-19,1,1,0
13650,user_13650,2403,58,16,42,May-19,0,1,1
13651,user_13651,5598,152,34,118,May-19,0,1,1
13652,user_13652,3420,35,23,12,May-19,0,1,1
13653,user_13653,3460,169,167,2,Apr-19,1,1,0
13654,user_13654,5495,73,24,49,May-19,0,1,1
13655,user_13655,524,132,10,122,May-19,0,1,1
13656,user_13656,8109,77,42,35,May-19,0,1,1
13657,user_13657,248,10,0,10,Apr-19,1,1,0
13658,user_13658,1589,74,18,56,May-19,0,0,1
13659,user_13659,851,118,81,37,Apr-19,1,1,0
13660,user_13660,1621,94,23,71,May-19,0,1,1
13661,user_13661,1569,126,41,85,May-19,0,1,1
13662,user_13662,76468,35,3,32,May-19,0,1,1
13663,user_13663,1877,7,7,0,Dec-18,5,0,0
13664,user_13664,1352,48,20,28,May-19,0,1,1
13666,user_13666,41,4,4,0,Dec-18,5,0,0
13667,user_13667,1558,11,11,0,Dec-18,5,0,0
13668,user_13668,601,15,11,4,Feb-19,3,0,0
13669,user_13669,193,12,3,9,Mar-19,2,0,0
13670,user_13670,5801,397,91,306,May-19,0,1,1
13671,user_13671,2335,18,16,2,Jan-19,4,0,0
13672,user_13672,1196,26,10,16,May-19,0,1,1
13673,user_13673,472,87,0,87,May-19,0,1,1
13675,user_13675,929,37,21,16,May-19,0,1,1
13676,user_13676,637,16,10,6,Feb-19,3,0,0
13677,user_13677,1577,38,26,12,Apr-19,1,1,0
13678,user_13678,18,4,0,4,Apr-19,1,1,0
13679,user_13679,20436,674,180,494,May-19,0,1,1
13680,user_13680,1328,73,35,38,May-19,0,1,1
13681,user_13681,1212,31,18,13,Feb-19,3,0,0
13682,user_13682,898,32,27,5,Apr-19,1,1,0
13683,user_13683,2600,124,8,116,May-19,0,1,1
13684,user_13684,213,26,20,6,Apr-19,1,1,0
13685,user_13685,5702,365,72,293,May-19,0,1,1
13686,user_13686,7825,84,30,54,May-19,0,1,1
13687,user_13687,2074,88,20,68,Apr-19,1,1,0
13688,user_13688,9552,213,38,175,May-19,0,1,1
13689,user_13689,4744,522,189,333,May-19,0,1,1
13690,user_13690,5094,225,2,223,May-19,0,1,1
13691,user_13691,3124,50,39,11,Feb-19,3,0,0
13692,user_13692,279,9,3,6,May-19,0,0,1
13693,user_13693,164,14,14,0,Dec-18,5,0,0
13694,user_13694,11,8,8,0,Dec-18,5,0,0
13695,user_13695,4574,134,29,105,May-19,0,1,1
13696,user_13696,2784,69,2,67,May-19,0,1,1
13697,user_13697,7319,101,57,44,May-19,0,1,1
13698,user_13698,3934,21,13,8,Mar-19,2,0,0
13699,user_13699,19327,726,282,444,May-19,0,1,1
13700,user_13700,6801,83,69,14,Apr-19,1,1,0
13701,user_13701,451,12,3,9,Apr-19,1,1,0
13702,user_13702,8257,166,69,97,Apr-19,1,1,0
13703,user_13703,2167,52,23,29,May-19,0,0,1
13704,user_13704,6516,353,67,286,May-19,0,1,1
13705,user_13705,10308,373,79,294,May-19,0,1,1
13706,user_13706,4542,91,6,85,May-19,0,1,1
13707,user_13707,21,3,3,0,Dec-18,5,0,0
13708,user_13708,1914,74,22,52,Apr-19,1,1,0
13709,user_13709,60792,518,163,355,May-19,0,1,1
13710,user_13710,1763,59,3,56,May-19,0,1,1
13711,user_13711,3131,137,40,97,May-19,0,1,1
13712,user_13712,3049,82,40,42,May-19,0,1,1
13713,user_13713,48214,668,112,556,May-19,0,1,1
13714,user_13714,9881,106,78,28,Apr-19,1,1,0
13715,user_13715,14225,470,214,256,May-19,0,1,1
13716,user_13716,72,8,6,2,Jan-19,4,0,0
13717,user_13717,8402,163,40,123,May-19,0,1,1
13718,user_13718,1262,35,12,23,Apr-19,1,1,0
13719,user_13719,7656,359,3,356,Apr-19,1,1,0
13720,user_13720,1155,31,4,27,Apr-19,1,1,0
13721,user_13721,41254,429,78,351,May-19,0,1,1
13722,user_13722,23284,141,65,76,Mar-19,2,0,0
13724,user_13724,75,6,4,2,Jan-19,4,0,0
13725,user_13725,35360,568,38,530,May-19,0,1,1
13728,user_13728,3233,114,91,23,May-19,0,1,1
13729,user_13729,3876,46,36,10,May-19,0,1,1
13730,user_13730,121249,319,113,206,May-19,0,1,1
13731,user_13731,3480,78,25,53,Jan-19,4,0,0
13732,user_13732,11,5,2,3,May-19,0,0,1
13733,user_13733,142,10,2,8,Mar-19,2,0,0
13734,user_13734,21295,206,112,94,May-19,0,1,1
13735,user_13735,3310,39,19,20,May-19,0,1,1
13736,user_13736,291,28,18,10,Apr-19,1,1,0
13737,user_13737,84,7,7,0,Dec-18,5,0,0
13738,user_13738,37901,713,361,352,May-19,0,1,1
13739,user_13739,3071,71,7,64,May-19,0,1,1
13740,user_13740,1863,42,21,21,May-19,0,1,1
13741,user_13741,2745,82,27,55,Apr-19,1,1,0
13742,user_13742,8,2,2,0,Oct-18,7,0,0
13743,user_13743,10425,53,3,50,Mar-19,2,0,0
13745,user_13745,2422,61,57,4,Jan-19,4,0,0
13746,user_13746,30045,406,65,341,May-19,0,1,1
13747,user_13747,1408,43,23,20,Apr-19,1,1,0
13748,user_13748,603,43,30,13,Feb-19,3,0,0
13749,user_13749,76,8,5,3,Feb-19,3,0,0
13750,user_13750,618,67,26,41,Apr-19,1,1,0
13751,user_13751,1195,45,45,0,Dec-18,5,0,0
13752,user_13752,50,5,5,0,Nov-18,6,0,0
13753,user_13753,1263,94,11,83,May-19,0,1,1
13754,user_13754,275,10,9,1,Mar-19,2,0,0
13756,user_13756,1999,19,19,0,Dec-18,5,0,0
13757,user_13757,1430,36,2,34,May-19,0,1,1
13758,user_13758,2094,18,18,0,Oct-18,7,0,0
13759,user_13759,589,20,18,2,Feb-19,3,0,0
13761,user_13761,92,19,10,9,May-19,0,1,1
13762,user_13762,713,17,12,5,Apr-19,1,1,0
13763,user_13763,4802,125,20,105,May-19,0,1,1
13764,user_13764,1,1,1,0,Oct-18,7,0,0
13765,user_13765,3891,428,3,425,May-19,0,1,1
13766,user_13766,849,15,7,8,May-19,0,1,1
13767,user_13767,8,2,2,0,Oct-18,7,0,0
13768,user_13768,6643,134,51,83,May-19,0,0,1
13769,user_13769,2233,60,36,24,Apr-19,1,1,0
13770,user_13770,711,26,8,18,Apr-19,1,1,0
13771,user_13771,3922,122,56,66,May-19,0,1,1
13772,user_13772,10005,104,36,68,May-19,0,1,1
13773,user_13773,180,15,8,7,Apr-19,1,1,0
13774,user_13774,63,8,8,0,Nov-18,6,0,0
13775,user_13775,2010,51,39,12,May-19,0,1,1
13776,user_13776,2759,114,7,107,May-19,0,1,1
13777,user_13777,27449,357,75,282,May-19,0,1,1
13778,user_13778,11992,197,49,148,May-19,0,1,1
13779,user_13779,46249,600,98,502,May-19,0,1,1
13780,user_13780,859,26,23,3,Apr-19,1,1,0
13781,user_13781,9,2,2,0,Oct-18,7,0,0
13782,user_13782,42,8,8,0,Oct-18,7,0,0
13783,user_13783,1639,84,10,74,May-19,0,1,1
13784,user_13784,31,4,0,4,Feb-19,3,0,0
13785,user_13785,41613,27,8,19,May-19,0,1,1
13786,user_13786,5716,81,69,12,May-19,0,0,1
13787,user_13787,5441,263,115,148,May-19,0,1,1
13788,user_13788,2718,107,94,13,May-19,0,1,1
13790,user_13790,10641,35,35,0,Nov-18,6,0,0
13791,user_13791,7377,124,15,109,May-19,0,1,1
13792,user_13792,1589,85,14,71,Apr-19,1,1,0
13793,user_13793,1017,24,12,12,Apr-19,1,1,0
13794,user_13794,14125,333,78,255,May-19,0,1,1
13795,user_13795,11505,439,31,408,May-19,0,1,1
13796,user_13796,39,11,9,2,Mar-19,2,0,0
13797,user_13797,37,9,3,6,Apr-19,1,1,0
13798,user_13798,128,10,10,0,Oct-18,7,0,0
13799,user_13799,11798,298,133,165,May-19,0,1,1
13800,user_13800,11636,359,106,253,May-19,0,1,1
13801,user_13801,8941,63,24,39,Apr-19,1,1,0
13802,user_13802,2948,84,3,81,May-19,0,1,1
13803,user_13803,1322,44,36,8,Jan-19,4,0,0
13804,user_13804,936,30,26,4,Jan-19,4,0,0
13805,user_13805,3441,120,33,87,May-19,0,1,1
13806,user_13806,2793,166,104,62,Feb-19,3,0,0
13807,user_13807,2450,46,34,12,May-19,0,1,1
13808,user_13808,86,2,0,2,Apr-19,1,1,0
13809,user_13809,352,16,6,10,May-19,0,0,1
13810,user_13810,995,64,19,45,May-19,0,1,1
13811,user_13811,28760,933,314,619,May-19,0,1,1
13812,user_13812,7659,201,34,167,May-19,0,1,1
13813,user_13813,10515,664,304,360,May-19,0,1,1
13814,user_13814,2562,58,21,37,Mar-19,2,0,0
13815,user_13815,23,3,3,0,Oct-18,7,0,0
13816,user_13816,50776,26,2,24,May-19,0,1,1
13817,user_13817,2617,82,7,75,May-19,0,1,1
13818,user_13818,12575,64,45,19,Feb-19,3,0,0
13819,user_13819,1385,51,46,5,Mar-19,2,0,0
13820,user_13820,2625,38,16,22,May-19,0,1,1
13822,user_13822,7728,99,50,49,Mar-19,2,0,0
13823,user_13823,310,24,11,13,Mar-19,2,0,0
13824,user_13824,33,3,3,0,Oct-18,7,0,0
13826,user_13826,4364,172,28,144,May-19,0,1,1
13827,user_13827,12,4,4,0,Oct-18,7,0,0
13828,user_13828,217,11,3,8,May-19,0,0,1
13829,user_13829,28152,226,97,129,May-19,0,1,1
13830,user_13830,729,55,36,19,Mar-19,2,0,0
13831,user_13831,71,5,5,0,Dec-18,5,0,0
13832,user_13832,1060,29,29,0,Dec-18,5,0,0
13833,user_13833,9093,93,5,88,May-19,0,1,1
13834,user_13834,10126,35,20,15,May-19,0,1,1
13835,user_13835,1,1,0,1,Mar-19,2,0,0
13837,user_13837,389,25,16,9,May-19,0,1,1
13838,user_13838,729,15,8,7,Apr-19,1,1,0
13839,user_13839,4812,133,61,72,Mar-19,2,0,0
13840,user_13840,19538,144,41,103,May-19,0,1,1
13841,user_13841,1142,87,59,28,May-19,0,1,1
13842,user_13842,65,1,1,0,Oct-18,7,0,0
13843,user_13843,19,4,2,2,Apr-19,1,1,0
13844,user_13844,1,3,3,0,Oct-18,7,0,0
13845,user_13845,4129,45,23,22,May-19,0,1,1
13846,user_13846,935,45,21,24,May-19,0,1,1
13847,user_13847,12,14,14,0,Dec-18,5,0,0
13849,user_13849,3937,124,35,89,May-19,0,1,1
13850,user_13850,234,15,11,4,Apr-19,1,1,0
13851,user_13851,3865,127,11,116,May-19,0,1,1
13852,user_13852,18202,129,24,105,May-19,0,1,1
13853,user_13853,2765,71,0,71,May-19,0,1,1
13854,user_13854,2105,16,3,13,Mar-19,2,0,0
13855,user_13855,90,6,6,0,Nov-18,6,0,0
13856,user_13856,18371,85,18,67,May-19,0,1,1
13857,user_13857,31,5,5,0,Oct-18,7,0,0
13858,user_13858,43,1,1,0,Oct-18,7,0,0
13859,user_13859,11274,898,284,614,May-19,0,1,1
13860,user_13860,20057,180,39,141,May-19,0,1,1
13861,user_13861,2730,53,16,37,Apr-19,1,1,0
13862,user_13862,43070,177,95,82,May-19,0,1,1
13863,user_13863,452,25,25,0,Dec-18,5,0,0
13864,user_13864,1009,109,102,7,Mar-19,2,0,0
13865,user_13865,3999,158,72,86,May-19,0,1,1
13866,user_13866,12544,262,15,247,May-19,0,1,1
13867,user_13867,1383,84,12,72,May-19,0,1,1
13868,user_13868,5187,340,136,204,May-19,0,1,1
13869,user_13869,269,3,0,3,Apr-19,1,1,0
13870,user_13870,9,2,2,0,Dec-18,5,0,0
13871,user_13871,2689,151,32,119,May-19,0,1,1
13872,user_13872,17868,351,80,271,May-19,0,1,1
13873,user_13873,97,9,9,0,Dec-18,5,0,0
13874,user_13874,3206,51,13,38,May-19,0,1,1
13876,user_13876,20309,230,179,51,May-19,0,1,1
13877,user_13877,2269,74,40,34,Apr-19,1,1,0
13878,user_13878,3812,377,178,199,May-19,0,1,1
13879,user_13879,852102,16,9,7,Apr-19,1,1,0
13880,user_13880,13451,263,22,241,May-19,0,1,1
13881,user_13881,1472,145,70,75,Apr-19,1,1,0
13882,user_13882,6595,125,41,84,May-19,0,1,1
13884,user_13884,31,4,3,1,Jan-19,4,0,0
13885,user_13885,3425,182,18,164,May-19,0,1,1
13886,user_13886,2469,61,56,5,Jan-19,4,0,0
13887,user_13887,4318,43,12,31,May-19,0,1,1
13888,user_13888,3820,140,95,45,May-19,0,1,1
13889,user_13889,47,5,0,5,May-19,0,1,1
13890,user_13890,1355,33,2,31,Apr-19,1,1,0
13891,user_13891,60,8,8,0,Oct-18,7,0,0
13892,user_13892,11674,95,20,75,May-19,0,1,1
13893,user_13893,6387,127,79,48,May-19,0,1,1
13894,user_13894,109,7,2,5,Apr-19,1,1,0
13895,user_13895,12165,147,1,146,May-19,0,1,1
13896,user_13896,1023,25,19,6,Jan-19,4,0,0
13897,user_13897,1093,41,27,14,Mar-19,2,0,0
13898,user_13898,5000,196,33,163,May-19,0,1,1
13899,user_13899,503,39,39,0,Nov-18,6,0,0
13901,user_13901,37,6,6,0,Dec-18,5,0,0
13902,user_13902,1170,40,18,22,Apr-19,1,1,0
13903,user_13903,235,12,9,3,Mar-19,2,0,0
13904,user_13904,401,22,22,0,Nov-18,6,0,0
13905,user_13905,3710,29,28,1,Jan-19,4,0,0
13906,user_13906,4186,82,60,22,Apr-19,1,1,0
13907,user_13907,7776,381,43,338,May-19,0,1,1
13908,user_13908,11186,77,3,74,May-19,0,1,1
13909,user_13909,17869,383,113,270,May-19,0,1,1
13910,user_13910,1301,6,6,0,Oct-18,7,0,0
13911,user_13911,4944,98,12,86,May-19,0,1,1
13912,user_13912,259,14,12,2,Mar-19,2,0,0
13913,user_13913,3569,61,32,29,May-19,0,1,1
13914,user_13914,1494,28,18,10,Apr-19,1,1,0
13915,user_13915,2471,157,18,139,May-19,0,1,1
13916,user_13916,1137,71,15,56,May-19,0,1,1
13917,user_13917,7834,20,13,7,Mar-19,2,0,0
13918,user_13918,3678,87,18,69,Apr-19,1,1,0
13919,user_13919,21,2,2,0,Oct-18,7,0,0
13920,user_13920,5192,164,12,152,May-19,0,1,1
13921,user_13921,16363,34,13,21,May-19,0,1,1
13922,user_13922,162,8,0,8,Apr-19,1,1,0
13923,user_13923,11567,472,165,307,May-19,0,1,1
13924,user_13924,2590,81,72,9,Feb-19,3,0,0
13925,user_13925,56,12,12,0,Oct-18,7,0,0
13926,user_13926,544,30,12,18,May-19,0,1,1
13927,user_13927,7633,241,19,222,May-19,0,1,1
13928,user_13928,2614,32,12,20,Mar-19,2,0,0
13929,user_13929,1916,83,43,40,May-19,0,1,1
13930,user_13930,9028,108,106,2,Feb-19,3,0,0
13931,user_13931,4194,297,157,140,May-19,0,1,1
13932,user_13932,1439,41,36,5,May-19,0,0,1
13935,user_13935,33850,192,18,174,May-19,0,1,1
13936,user_13936,1320,39,8,31,May-19,0,1,1
13937,user_13937,17,6,5,1,Jan-19,4,0,0
13938,user_13938,2314,41,2,39,Apr-19,1,1,0
13939,user_13939,6230,60,41,19,May-19,0,1,1
13940,user_13940,7482,215,79,136,May-19,0,1,1
13941,user_13941,1158,7,6,1,Mar-19,2,0,0
13942,user_13942,294,26,24,2,Mar-19,2,0,0
13943,user_13943,11991,175,53,122,May-19,0,1,1
13944,user_13944,4422,154,19,135,May-19,0,1,1
13946,user_13946,887,7,0,7,Apr-19,1,1,0
13947,user_13947,14005,177,47,130,May-19,0,1,1
13948,user_13948,39484,107,40,67,May-19,0,1,1
13949,user_13949,2762,84,5,79,Apr-19,1,1,0
13950,user_13950,49879,17,14,3,Feb-19,3,0,0
13951,user_13951,16042,581,160,421,May-19,0,1,1
13952,user_13952,847,22,6,16,Feb-19,3,0,0
13953,user_13953,21243,23,20,3,Jan-19,4,0,0
13954,user_13954,21,10,4,6,Apr-19,1,1,0
13955,user_13955,7169,46,11,35,May-19,0,1,1
13956,user_13956,19718,565,159,406,May-19,0,1,1
13957,user_13957,38,1,1,0,Oct-18,7,0,0
13958,user_13958,86,7,2,5,Mar-19,2,0,0
13959,user_13959,3049,129,82,47,May-19,0,1,1
13960,user_13960,6088,104,4,100,Apr-19,1,1,0
13961,user_13961,1262,43,15,28,Apr-19,1,1,0
13962,user_13962,647,16,2,14,May-19,0,1,1
13963,user_13963,9,4,2,2,Feb-19,3,0,0
13964,user_13964,10354,80,21,59,May-19,0,1,1
13965,user_13965,8372,354,119,235,May-19,0,1,1
13966,user_13966,1171,54,25,29,Mar-19,2,0,0
13967,user_13967,1,1,1,0,Nov-18,6,0,0
13968,user_13968,14,5,5,0,Oct-18,7,0,0
13969,user_13969,33651,198,98,100,May-19,0,1,1
13970,user_13970,3785,68,25,43,May-19,0,1,1
13971,user_13971,6830,39,8,31,Apr-19,1,1,0
13972,user_13972,80,4,0,4,Apr-19,1,1,0
13973,user_13973,1082,15,10,5,May-19,0,1,1
13974,user_13974,5432,7,0,7,May-19,0,1,1
13975,user_13975,7535,381,14,367,May-19,0,1,1
13976,user_13976,3686,181,12,169,May-19,0,1,1
13977,user_13977,750,25,17,8,Apr-19,1,1,0
13978,user_13978,9050,80,56,24,Apr-19,1,1,0
13979,user_13979,2774,19,3,16,Apr-19,1,1,0
13980,user_13980,9,1,1,0,Oct-18,7,0,0
13981,user_13981,13114,51,32,19,May-19,0,1,1
13982,user_13982,9126,632,251,381,May-19,0,1,1
13983,user_13983,1936,220,24,196,Apr-19,1,1,0
13985,user_13985,8370,44,18,26,May-19,0,1,1
13986,user_13986,12726,238,81,157,May-19,0,1,1
13987,user_13987,18860,15,14,1,Jan-19,4,0,0
13988,user_13988,33914,31,28,3,Jan-19,4,0,0
13989,user_13989,886,21,16,5,Apr-19,1,1,0
13990,user_13990,4749,49,0,49,Apr-19,1,1,0
13991,user_13991,8391,652,193,459,May-19,0,1,1
13992,user_13992,14881,124,46,78,May-19,0,1,1
13994,user_13994,320,80,18,62,May-19,0,1,1
13995,user_13995,6183,230,189,41,May-19,0,1,1
13996,user_13996,1059,11,3,8,Feb-19,3,0,0
13997,user_13997,85,8,6,2,Jan-19,4,0,0
13998,user_13998,327,20,0,20,Apr-19,1,1,0
13999,user_13999,58102,537,187,350,May-19,0,1,1
14000,user_14000,3984,102,3,99,May-19,0,1,1
14002,user_14002,105,28,6,22,May-19,0,1,1
14003,user_14003,21,3,3,0,Oct-18,7,0,0
14004,user_14004,676,18,3,15,Apr-19,1,1,0
14005,user_14005,11119,284,214,70,Apr-19,1,1,0
14007,user_14007,3254,40,35,5,Apr-19,1,1,0
14008,user_14008,76,15,9,6,May-19,0,0,1
14009,user_14009,2091,26,9,17,Feb-19,3,0,0
14010,user_14010,3083,85,47,38,Apr-19,1,1,0
14011,user_14011,5099,127,42,85,Jan-19,4,0,0
14012,user_14012,966,22,22,0,Dec-18,5,0,0
14013,user_14013,9667,217,72,145,May-19,0,1,1
14014,user_14014,38839,16,11,5,Feb-19,3,0,0
14015,user_14015,160,48,13,35,May-19,0,1,1
14016,user_14016,18,3,3,0,Dec-18,5,0,0
14017,user_14017,18,2,2,0,Oct-18,7,0,0
14018,user_14018,108,19,0,19,Apr-19,1,1,0
14019,user_14019,9317,205,33,172,May-19,0,1,1
14020,user_14020,110,18,4,14,Apr-19,1,1,0
14021,user_14021,1806,7,7,0,Nov-18,6,0,0
14022,user_14022,24393,124,17,107,May-19,0,1,1
14023,user_14023,708,8,3,5,Jan-19,4,0,0
14024,user_14024,307,14,4,10,May-19,0,1,1
14025,user_14025,711,36,16,20,May-19,0,0,1
14026,user_14026,64,12,9,3,Mar-19,2,0,0
14027,user_14027,1970,82,27,55,Apr-19,1,1,0
14028,user_14028,17,2,0,2,Feb-19,3,0,0
14029,user_14029,11840,36,28,8,May-19,0,1,1
14030,user_14030,21660,110,21,89,May-19,0,1,1
14031,user_14031,325,10,7,3,Apr-19,1,1,0
14032,user_14032,311,26,7,19,Apr-19,1,1,0
14033,user_14033,28803,593,223,370,May-19,0,1,1
14034,user_14034,854675,82,8,74,May-19,0,1,1
14035,user_14035,6957,210,88,122,Apr-19,1,1,0
14036,user_14036,5964,315,66,249,May-19,0,1,1
14038,user_14038,5372,58,37,21,Mar-19,2,0,0
14039,user_14039,269,35,5,30,May-19,0,1,1
14040,user_14040,21476,245,6,239,May-19,0,1,1
14041,user_14041,9,2,2,0,Oct-18,7,0,0
14042,user_14042,84,12,12,0,Nov-18,6,0,0
14043,user_14043,1013,64,51,13,May-19,0,1,1
14044,user_14044,709,74,15,59,May-19,0,1,1
14045,user_14045,1800,17,10,7,May-19,0,1,1
14046,user_14046,1358,28,28,0,Dec-18,5,0,0
14047,user_14047,3332,32,9,23,May-19,0,1,1
14048,user_14048,8569,64,55,9,May-19,0,1,1
14050,user_14050,79,10,5,5,Apr-19,1,1,0
14051,user_14051,270146,334,105,229,May-19,0,1,1
14052,user_14052,1112,111,0,111,May-19,0,1,1
14053,user_14053,56552,372,46,326,May-19,0,1,1
14054,user_14054,15014,901,456,445,Apr-19,1,1,0
14055,user_14055,26033,930,564,366,May-19,0,1,1
14056,user_14056,729,66,1,65,Mar-19,2,0,0
14057,user_14057,1715,123,74,49,May-19,0,1,1
14058,user_14058,11085,350,146,204,May-19,0,1,1
14059,user_14059,869,17,2,15,Apr-19,1,1,0
14060,user_14060,8206,161,124,37,May-19,0,1,1
14061,user_14061,5136,28,6,22,May-19,0,0,1
14062,user_14062,1036,23,10,13,Apr-19,1,1,0
14063,user_14063,29,11,6,5,Apr-19,1,1,0
14064,user_14064,66,4,4,0,Oct-18,7,0,0
14065,user_14065,102,9,9,0,Nov-18,6,0,0
14066,user_14066,123,17,10,7,Mar-19,2,0,0
14067,user_14067,2780,51,50,1,Jan-19,4,0,0
14068,user_14068,26,4,4,0,Oct-18,7,0,0
14069,user_14069,141,35,21,14,Mar-19,2,0,0
14070,user_14070,157,15,9,6,May-19,0,1,1
14072,user_14072,1022,93,1,92,May-19,0,1,1
14073,user_14073,1052,88,43,45,May-19,0,1,1
14074,user_14074,1326,113,41,72,Apr-19,1,1,0
14075,user_14075,2651,95,7,88,May-19,0,1,1
14076,user_14076,8,2,0,2,Mar-19,2,0,0
14077,user_14077,10,1,1,0,Oct-18,7,0,0
14078,user_14078,2339,39,37,2,Apr-19,1,1,0
14079,user_14079,31,3,3,0,Oct-18,7,0,0
14080,user_14080,5073,250,123,127,May-19,0,1,1
14081,user_14081,1303,27,23,4,Feb-19,3,0,0
14082,user_14082,10173,47,6,41,May-19,0,1,1
14083,user_14083,2428,150,75,75,May-19,0,1,1
14084,user_14084,114035,92,0,92,May-19,0,1,1
14085,user_14085,3125,121,64,57,May-19,0,1,1
14086,user_14086,16,9,3,6,Apr-19,1,1,0
14087,user_14087,6064,96,38,58,Feb-19,3,0,0
14088,user_14088,12252,176,72,104,May-19,0,0,1
14089,user_14089,51,2,2,0,Oct-18,7,0,0
14090,user_14090,24053,601,216,385,May-19,0,1,1
14091,user_14091,3049,146,50,96,Apr-19,1,1,0
14092,user_14092,7456,27,6,21,May-19,0,1,1
14093,user_14093,1353,39,22,17,May-19,0,0,1
14095,user_14095,731,38,15,23,May-19,0,1,1
14096,user_14096,1485,24,16,8,May-19,0,0,1
14097,user_14097,6135,502,52,450,May-19,0,1,1
14098,user_14098,13810,321,49,272,May-19,0,1,1
14099,user_14099,3495,127,17,110,Apr-19,1,1,0
14100,user_14100,26395,306,116,190,May-19,0,1,1
14101,user_14101,19,5,2,3,Apr-19,1,1,0
14103,user_14103,17,10,5,5,Apr-19,1,1,0
14104,user_14104,46,8,8,0,Nov-18,6,0,0
14105,user_14105,43027,344,183,161,May-19,0,1,1
14106,user_14106,1604,18,10,8,Jan-19,4,0,0
14107,user_14107,19641,162,135,27,Apr-19,1,1,0
14108,user_14108,3608,54,49,5,May-19,0,1,1
14109,user_14109,26,5,0,5,Feb-19,3,0,0
14110,user_14110,390,17,3,14,Mar-19,2,0,0
14111,user_14111,22915,413,24,389,May-19,0,1,1
14112,user_14112,4659,57,35,22,Mar-19,2,0,0
14113,user_14113,1844,25,17,8,May-19,0,1,1
14114,user_14114,788,12,9,3,May-19,0,0,1
14115,user_14115,1579,37,1,36,May-19,0,1,1
14116,user_14116,714,21,9,12,May-19,0,1,1
14117,user_14117,849,62,34,28,May-19,0,1,1
14118,user_14118,169,30,3,27,May-19,0,1,1
14119,user_14119,2331,151,58,93,May-19,0,1,1
14120,user_14120,742,12,8,4,Feb-19,3,0,0
14122,user_14122,24737,124,93,31,Apr-19,1,1,0
14123,user_14123,519,31,13,18,Feb-19,3,0,0
14124,user_14124,246,21,21,0,Oct-18,7,0,0
14125,user_14125,2306,13,13,0,Oct-18,7,0,0
14127,user_14127,31194,66,23,43,May-19,0,1,1
14128,user_14128,5974,9,0,9,May-19,0,0,1
14129,user_14129,32691,390,154,236,May-19,0,1,1
14130,user_14130,1081,22,6,16,May-19,0,1,1
14131,user_14131,43,13,0,13,Apr-19,1,1,0
14132,user_14132,315,25,18,7,May-19,0,0,1
14133,user_14133,1012,28,3,25,May-19,0,1,1
14134,user_14134,10779,704,68,636,May-19,0,1,1
14135,user_14135,8474,158,30,128,May-19,0,1,1
14136,user_14136,4858,207,72,135,May-19,0,1,1
14137,user_14137,7785,292,33,259,May-19,0,1,1
14138,user_14138,40905,217,87,130,May-19,0,1,1
14139,user_14139,617,37,7,30,May-19,0,1,1
14140,user_14140,5445,127,23,104,May-19,0,1,1
14141,user_14141,11741,45,22,23,Apr-19,1,1,0
14142,user_14142,785,33,13,20,Feb-19,3,0,0
14143,user_14143,1758,51,31,20,May-19,0,1,1
14144,user_14144,23518,408,215,193,May-19,0,1,1
14145,user_14145,43,3,3,0,Oct-18,7,0,0
14146,user_14146,3412,110,21,89,May-19,0,1,1
14147,user_14147,6794,99,2,97,May-19,0,1,1
14148,user_14148,8405,312,282,30,Apr-19,1,1,0
14149,user_14149,15371,68,64,4,May-19,0,0,1
14150,user_14150,13300,212,59,153,May-19,0,1,1
14151,user_14151,1288,30,13,17,May-19,0,1,1
14152,user_14152,432,19,6,13,Apr-19,1,1,0
14153,user_14153,1489,29,9,20,May-19,0,1,1
14154,user_14154,523,9,8,1,Feb-19,3,0,0
14155,user_14155,1392,22,6,16,Apr-19,1,1,0
14157,user_14157,4263,40,37,3,Apr-19,1,1,0
14158,user_14158,1158,35,18,17,Apr-19,1,1,0
14159,user_14159,2765,71,27,44,May-19,0,1,1
14160,user_14160,10987,657,65,592,May-19,0,1,1
14161,user_14161,6413,30,11,19,May-19,0,1,1
14162,user_14162,2365,71,25,46,Apr-19,1,1,0
14163,user_14163,9,2,2,0,Oct-18,7,0,0
14164,user_14164,9,2,2,0,Oct-18,7,0,0
14165,user_14165,1952,35,2,33,May-19,0,1,1
14166,user_14166,5853,141,29,112,May-19,0,1,1
14167,user_14167,3822,455,23,432,May-19,0,1,1
14168,user_14168,19689,177,41,136,May-19,0,1,1
14169,user_14169,1428,49,8,41,May-19,0,1,1
14170,user_14170,6436,65,3,62,Apr-19,1,1,0
14171,user_14171,41,4,3,1,Apr-19,1,1,0
14173,user_14173,66,7,5,2,May-19,0,0,1
14174,user_14174,37244,268,50,218,May-19,0,1,1
14175,user_14175,18126,513,196,317,May-19,0,1,1
14176,user_14176,10897,174,23,151,May-19,0,1,1
14177,user_14177,3120,58,54,4,Apr-19,1,1,0
14178,user_14178,2243,156,93,63,Apr-19,1,1,0
14179,user_14179,14,3,3,0,Oct-18,7,0,0
14180,user_14180,44,6,6,0,Dec-18,5,0,0
14182,user_14182,27932,799,156,643,May-19,0,1,1
14183,user_14183,2295,132,49,83,May-19,0,1,1
14184,user_14184,6414,138,81,57,May-19,0,1,1
14185,user_14185,929,13,3,10,May-19,0,1,1
14186,user_14186,2687,225,16,209,May-19,0,1,1
14187,user_14187,67,24,24,0,Nov-18,6,0,0
14188,user_14188,193,38,19,19,Apr-19,1,1,0
14189,user_14189,2300,102,9,93,May-19,0,1,1
14190,user_14190,28967,305,120,185,May-19,0,1,1
14191,user_14191,13,3,3,0,Oct-18,7,0,0
14192,user_14192,2926,49,12,37,Apr-19,1,1,0
14193,user_14193,32512,433,133,300,May-19,0,1,1
14194,user_14194,6609,127,76,51,May-19,0,1,1
14195,user_14195,721,84,18,66,May-19,0,1,1
14196,user_14196,30,4,4,0,Oct-18,7,0,0
14198,user_14198,6099,30,6,24,May-19,0,1,1
14199,user_14199,16,3,3,0,Oct-18,7,0,0
14200,user_14200,145,5,5,0,Dec-18,5,0,0
14203,user_14203,3649,122,112,10,May-19,0,1,1
14205,user_14205,4263,62,10,52,May-19,0,1,1
14206,user_14206,6826,85,49,36,May-19,0,1,1
14207,user_14207,383,5,5,0,Nov-18,6,0,0
14208,user_14208,27,5,5,0,Oct-18,7,0,0
14209,user_14209,1033,53,23,30,Feb-19,3,0,0
14210,user_14210,2258,78,41,37,Mar-19,2,0,0
14211,user_14211,5464,151,33,118,May-19,0,1,1
14212,user_14212,70,10,10,0,Nov-18,6,0,0
14213,user_14213,18,3,3,0,Oct-18,7,0,0
14214,user_14214,9,2,2,0,Oct-18,7,0,0
14215,user_14215,780,85,77,8,May-19,0,1,1
14216,user_14216,3354,310,94,216,May-19,0,1,1
14218,user_14218,5629,128,27,101,May-19,0,1,1
14219,user_14219,7434,195,113,82,May-19,0,1,1
14220,user_14220,14,3,3,0,Oct-18,7,0,0
14221,user_14221,7373,224,97,127,May-19,0,1,1
14222,user_14222,161,5,3,2,May-19,0,0,1
14223,user_14223,1371,42,23,19,May-19,0,1,1
14224,user_14224,2924,374,189,185,May-19,0,1,1
14226,user_14226,3874,91,65,26,Apr-19,1,1,0
14227,user_14227,107,10,4,6,Mar-19,2,0,0
14228,user_14228,16,3,3,0,Oct-18,7,0,0
14229,user_14229,11,2,2,0,Oct-18,7,0,0
14230,user_14230,14851,101,52,49,Apr-19,1,1,0
14231,user_14231,2324,14,5,9,May-19,0,1,1
14232,user_14232,165,25,25,0,Nov-18,6,0,0
14233,user_14233,1322,27,27,0,Dec-18,5,0,0
14234,user_14234,970341,61,40,21,Apr-19,1,1,0
14235,user_14235,33,5,5,0,Nov-18,6,0,0
14236,user_14236,16345,437,164,273,May-19,0,1,1
14237,user_14237,1579,153,45,108,May-19,0,1,1
14238,user_14238,7213,81,0,81,May-19,0,1,1
14239,user_14239,13442,196,59,137,May-19,0,1,1
14240,user_14240,3105,43,21,22,May-19,0,1,1
14241,user_14241,3005,151,49,102,May-19,0,1,1
14242,user_14242,1500,19,1,18,Apr-19,1,1,0
14243,user_14243,4592,58,0,58,Apr-19,1,1,0
14244,user_14244,421,17,9,8,Apr-19,1,1,0
14246,user_14246,7804,205,128,77,May-19,0,1,1
14248,user_14248,12190,97,33,64,May-19,0,1,1
14249,user_14249,777,7,2,5,May-19,0,1,1
14250,user_14250,26,3,1,2,Mar-19,2,0,0
14251,user_14251,3877,111,37,74,May-19,0,1,1
14252,user_14252,956,61,49,12,Apr-19,1,1,0
14253,user_14253,1321,56,40,16,Feb-19,3,0,0
14254,user_14254,5953,260,94,166,May-19,0,1,1
14255,user_14255,33,4,0,4,Jan-19,4,0,0
14256,user_14256,5782,176,68,108,May-19,0,1,1
14257,user_14257,13,3,3,0,Oct-18,7,0,0
14258,user_14258,4126,10,6,4,Apr-19,1,1,0
14259,user_14259,19176,706,137,569,May-19,0,1,1
14260,user_14260,2464,58,2,56,May-19,0,1,1
14261,user_14261,159,10,9,1,Jan-19,4,0,0
14262,user_14262,895,52,52,0,Dec-18,5,0,0
14263,user_14263,254,20,13,7,Apr-19,1,1,0
14264,user_14264,898554,554,63,491,May-19,0,1,1
14265,user_14265,819,21,3,18,Feb-19,3,0,0
14266,user_14266,13800,103,31,72,May-19,0,1,1
14267,user_14267,1128,18,18,0,Oct-18,7,0,0
14268,user_14268,3948,65,64,1,Mar-19,2,0,0
14269,user_14269,6622,556,199,357,May-19,0,1,1
14270,user_14270,3921,123,98,25,May-19,0,1,1
14271,user_14271,234,41,14,27,May-19,0,1,1
14272,user_14272,75,9,9,0,Oct-18,7,0,0
14273,user_14273,5325,23,10,13,Mar-19,2,0,0
14274,user_14274,22301,782,293,489,May-19,0,1,1
14275,user_14275,89,10,3,7,May-19,0,0,1
14276,user_14276,1478,49,35,14,Mar-19,2,0,0
14277,user_14277,2444,35,35,0,Nov-18,6,0,0
14278,user_14278,1833,51,50,1,Jan-19,4,0,0
14279,user_14279,106368,195,139,56,May-19,0,1,1
14280,user_14280,1094,99,36,63,May-19,0,1,1
14281,user_14281,4194,388,141,247,May-19,0,1,1
14282,user_14282,1969,107,25,82,May-19,0,1,1
14283,user_14283,16,4,2,2,Jan-19,4,0,0
14284,user_14284,14,3,3,0,Oct-18,7,0,0
14285,user_14285,208,21,11,10,May-19,0,1,1
14286,user_14286,6304,83,69,14,May-19,0,0,1
14287,user_14287,4968,80,27,53,May-19,0,1,1
14288,user_14288,63,4,3,1,May-19,0,0,1
14289,user_14289,12,2,2,0,Oct-18,7,0,0
14290,user_14290,3734,332,217,115,May-19,0,1,1
14291,user_14291,840,43,13,30,Apr-19,1,1,0
14293,user_14293,604,109,26,83,May-19,0,1,1
14294,user_14294,43,6,2,4,Mar-19,2,0,0
14295,user_14295,1018,14,14,0,Dec-18,5,0,0
14296,user_14296,16312,71,54,17,Apr-19,1,1,0
14297,user_14297,34147,163,68,95,Apr-19,1,1,0
14298,user_14298,6549,250,110,140,May-19,0,1,1
14299,user_14299,3827,163,51,112,May-19,0,1,1
14300,user_14300,3750,321,0,321,May-19,0,1,1
14301,user_14301,156141,134,3,131,May-19,0,1,1
14303,user_14303,19600,272,65,207,May-19,0,1,1
14304,user_14304,18877,43,11,32,Apr-19,1,1,0
14305,user_14305,1198,235,8,227,May-19,0,1,1
14306,user_14306,15771,405,168,237,May-19,0,1,1
14307,user_14307,436,47,31,16,Mar-19,2,0,0
14308,user_14308,7825,134,103,31,May-19,0,1,1
14309,user_14309,20874,112,59,53,May-19,0,1,1
14310,user_14310,5072,29,27,2,Jan-19,4,0,0
14311,user_14311,1074,55,0,55,May-19,0,1,1
14312,user_14312,25,7,3,4,Feb-19,3,0,0
14313,user_14313,218,33,7,26,Apr-19,1,1,0
14314,user_14314,14376,134,77,57,May-19,0,1,1
14316,user_14316,32,8,8,0,Nov-18,6,0,0
14317,user_14317,189,50,25,25,Jan-19,4,0,0
14318,user_14318,276,14,6,8,Apr-19,1,1,0
14319,user_14319,1022,14,6,8,May-19,0,0,1
14320,user_14320,110,9,2,7,Mar-19,2,0,0
14321,user_14321,12478,158,36,122,May-19,0,1,1
14322,user_14322,2849,427,103,324,May-19,0,1,1
14323,user_14323,8618,112,55,57,May-19,0,1,1
14324,user_14324,23099,504,161,343,May-19,0,1,1
14325,user_14325,9739,245,53,192,May-19,0,1,1
14326,user_14326,1892,31,25,6,Apr-19,1,1,0
14327,user_14327,29,4,4,0,Oct-18,7,0,0
14328,user_14328,44,6,6,0,Oct-18,7,0,0
14329,user_14329,2732,205,72,133,May-19,0,1,1
14330,user_14330,431,20,11,9,Mar-19,2,0,0
14331,user_14331,713,49,18,31,May-19,0,1,1
14332,user_14332,24911,171,117,54,May-19,0,1,1
14333,user_14333,798,6,6,0,Dec-18,5,0,0
14334,user_14334,99,5,2,3,Mar-19,2,0,0
14335,user_14335,5188,129,45,84,May-19,0,1,1
14336,user_14336,26842,105,29,76,May-19,0,1,1
14337,user_14337,8613,151,71,80,May-19,0,1,1
14338,user_14338,7866,142,41,101,Apr-19,1,1,0
14339,user_14339,841,13,5,8,Apr-19,1,1,0
14340,user_14340,4411,323,106,217,May-19,0,1,1
14341,user_14341,955,16,11,5,Feb-19,3,0,0
14342,user_14342,18286,116,29,87,Mar-19,2,0,0
14343,user_14343,16,3,3,0,Oct-18,7,0,0
14344,user_14344,11,2,2,0,Oct-18,7,0,0
14345,user_14345,17880,311,111,200,May-19,0,1,1
14346,user_14346,9,5,5,0,Dec-18,5,0,0
14347,user_14347,1833,44,0,44,Mar-19,2,0,0
14348,user_14348,37,28,18,10,Mar-19,2,0,0
14349,user_14349,2790,108,44,64,May-19,0,1,1
14350,user_14350,147,23,9,14,Apr-19,1,1,0
14351,user_14351,648,9,9,0,Oct-18,7,0,0
14352,user_14352,143,17,4,13,May-19,0,1,1
14353,user_14353,1215,40,15,25,Apr-19,1,1,0
14355,user_14355,4109,330,128,202,May-19,0,1,1
14356,user_14356,2223,60,10,50,Apr-19,1,1,0
14357,user_14357,16,3,3,0,Dec-18,5,0,0
14358,user_14358,622,68,6,62,May-19,0,1,1
14359,user_14359,51,3,1,2,Apr-19,1,1,0
14360,user_14360,3888,123,38,85,May-19,0,1,1
14361,user_14361,9410,414,79,335,May-19,0,1,1
14362,user_14362,16,3,0,3,Feb-19,3,0,0
14363,user_14363,5082,700,189,511,May-19,0,1,1
14364,user_14364,1728,64,11,53,May-19,0,1,1
14365,user_14365,4270,120,49,71,May-19,0,1,1
14366,user_14366,3964,145,52,93,May-19,0,1,1
14367,user_14367,10851,219,77,142,May-19,0,1,1
14368,user_14368,20746,193,14,179,May-19,0,1,1
14369,user_14369,65,4,4,0,Oct-18,7,0,0
14370,user_14370,317,26,26,0,Nov-18,6,0,0
14371,user_14371,5596,128,31,97,May-19,0,1,1
14372,user_14372,4771,271,160,111,May-19,0,1,1
14373,user_14373,2262,152,54,98,May-19,0,1,1
14374,user_14374,1634,65,26,39,Apr-19,1,1,0
14375,user_14375,7160,65,3,62,May-19,0,1,1
14376,user_14376,7219,129,26,103,May-19,0,1,1
14377,user_14377,82,10,5,5,Apr-19,1,1,0
14378,user_14378,1340,104,82,22,Jan-19,4,0,0
14379,user_14379,11,2,2,0,Oct-18,7,0,0
14380,user_14380,13548,241,156,85,May-19,0,1,1
14381,user_14381,140,4,4,0,Oct-18,7,0,0
14382,user_14382,61,5,5,0,Oct-18,7,0,0
14383,user_14383,14,3,3,0,Oct-18,7,0,0
14384,user_14384,3869,38,36,2,Jan-19,4,0,0
14385,user_14385,14133,983,298,685,May-19,0,1,1
14387,user_14387,29,4,4,0,Nov-18,6,0,0
14388,user_14388,3891,111,55,56,May-19,0,1,1
14389,user_14389,2664,49,35,14,May-19,0,1,1
14390,user_14390,7065,67,11,56,May-19,0,1,1
14391,user_14391,63,11,8,3,Jan-19,4,0,0
14392,user_14392,1248,46,3,43,Mar-19,2,0,0
14393,user_14393,12881,285,91,194,May-19,0,1,1
14394,user_14394,10,10,8,2,Jan-19,4,0,0
14395,user_14395,62,11,10,1,Apr-19,1,1,0
14396,user_14396,1296,34,34,0,Nov-18,6,0,0
14397,user_14397,17,2,2,0,Dec-18,5,0,0
14398,user_14398,520,18,12,6,Feb-19,3,0,0
14399,user_14399,211,14,12,2,Apr-19,1,1,0
14400,user_14400,10,5,5,0,Dec-18,5,0,0
14401,user_14401,169,7,6,1,Feb-19,3,0,0
14402,user_14402,10511,573,228,345,May-19,0,1,1
14403,user_14403,8214,65,8,57,May-19,0,1,1
14404,user_14404,89,6,4,2,Apr-19,1,1,0
14405,user_14405,11542,171,53,118,May-19,0,1,1
14406,user_14406,26225,637,245,392,May-19,0,1,1
14407,user_14407,1503,177,31,146,May-19,0,1,1
14408,user_14408,4282,158,21,137,May-19,0,1,1
14409,user_14409,21,1,1,0,Oct-18,7,0,0
14410,user_14410,3256,79,47,32,Apr-19,1,1,0
14412,user_14412,2029,59,32,27,Feb-19,3,0,0
14413,user_14413,3988,21,10,11,Apr-19,1,1,0
14414,user_14414,305,27,23,4,Mar-19,2,0,0
14415,user_14415,3453,53,39,14,May-19,0,1,1
14416,user_14416,788,38,3,35,Apr-19,1,1,0
14417,user_14417,10255,753,387,366,May-19,0,1,1
14418,user_14418,3201,57,37,20,May-19,0,1,1
14419,user_14419,11565,87,61,26,Apr-19,1,1,0
14420,user_14420,6881,108,77,31,Apr-19,1,1,0
14421,user_14421,7381,89,42,47,May-19,0,1,1
14422,user_14422,5594,35,14,21,May-19,0,1,1
14423,user_14423,9978,47,5,42,May-19,0,1,1
14424,user_14424,40,3,3,0,Dec-18,5,0,0
14425,user_14425,225,4,3,1,Mar-19,2,0,0
14426,user_14426,845,79,44,35,May-19,0,1,1
14427,user_14427,36,14,10,4,Feb-19,3,0,0
14428,user_14428,12128,175,34,141,May-19,0,1,1
14429,user_14429,9,2,2,0,Oct-18,7,0,0
14430,user_14430,2261,110,11,99,May-19,0,1,1
14431,user_14431,11771,312,96,216,May-19,0,1,1
14432,user_14432,5715,52,4,48,May-19,0,1,1
14433,user_14433,1778,171,51,120,May-19,0,1,1
14435,user_14435,1157,77,22,55,May-19,0,1,1
14437,user_14437,3002,52,41,11,Feb-19,3,0,0
14438,user_14438,2811,156,77,79,Apr-19,1,1,0
14439,user_14439,1,1,1,0,Oct-18,7,0,0
14440,user_14440,17283,304,146,158,May-19,0,1,1
14441,user_14441,998,127,47,80,May-19,0,1,1
14442,user_14442,4062,32,4,28,May-19,0,1,1
14443,user_14443,1319,51,9,42,Mar-19,2,0,0
14444,user_14444,18594,95,40,55,May-19,0,1,1
14445,user_14445,3681,85,47,38,May-19,0,1,1
14446,user_14446,2076,205,33,172,May-19,0,1,1
14447,user_14447,2686,25,9,16,Apr-19,1,1,0
14448,user_14448,1976,105,36,69,May-19,0,1,1
14449,user_14449,64,3,3,0,Oct-18,7,0,0
14450,user_14450,702,28,7,21,Apr-19,1,1,0
14451,user_14451,1279,53,20,33,Apr-19,1,1,0
14452,user_14452,576,22,22,0,Oct-18,7,0,0
14453,user_14453,137,21,19,2,Feb-19,3,0,0
14454,user_14454,222,25,25,0,Nov-18,6,0,0
14455,user_14455,4126,67,53,14,Apr-19,1,1,0
14456,user_14456,6793,47,30,17,May-19,0,1,1
14457,user_14457,9543,183,28,155,May-19,0,1,1
14458,user_14458,76031,130,24,106,May-19,0,1,1
14459,user_14459,880,46,35,11,Apr-19,1,1,0
14460,user_14460,122,14,14,0,Dec-18,5,0,0
14461,user_14461,1664,169,91,78,May-19,0,1,1
14462,user_14462,6431,293,74,219,May-19,0,1,1
14463,user_14463,1289,25,25,0,Oct-18,7,0,0
14464,user_14464,4067,177,38,139,May-19,0,1,1
14465,user_14465,186,36,16,20,May-19,0,1,1
14466,user_14466,6566,136,48,88,May-19,0,1,1
14467,user_14467,16,3,3,0,Oct-18,7,0,0
14468,user_14468,9854,159,64,95,May-19,0,1,1
14469,user_14469,8720,139,46,93,May-19,0,1,1
14470,user_14470,4,2,2,0,Oct-18,7,0,0
14471,user_14471,40991,422,201,221,May-19,0,1,1
14472,user_14472,890,23,12,11,Apr-19,1,1,0
14473,user_14473,8856,12,11,1,Feb-19,3,0,0
14474,user_14474,11,2,2,0,Oct-18,7,0,0
14475,user_14475,6188,38,20,18,May-19,0,1,1
14476,user_14476,2222,105,45,60,May-19,0,1,1
14477,user_14477,1403,7,3,4,Feb-19,3,0,0
14478,user_14478,208,30,10,20,May-19,0,1,1
14479,user_14479,1269,80,17,63,May-19,0,1,1
14480,user_14480,12535,315,100,215,May-19,0,1,1
14481,user_14481,5405,93,37,56,May-19,0,1,1
14482,user_14482,5208,47,40,7,Jan-19,4,0,0
14483,user_14483,1982,157,15,142,May-19,0,1,1
14484,user_14484,40457,443,179,264,May-19,0,1,1
14485,user_14485,60,7,7,0,Dec-18,5,0,0
14486,user_14486,1734,74,13,61,May-19,0,1,1
14487,user_14487,48,6,4,2,Feb-19,3,0,0
14488,user_14488,7747,293,102,191,May-19,0,1,1
14489,user_14489,191,56,0,56,Apr-19,1,1,0
14490,user_14490,21,3,3,0,Oct-18,7,0,0
14491,user_14491,4,2,2,0,Nov-18,6,0,0
14492,user_14492,4436,138,63,75,May-19,0,1,1
14493,user_14493,3779,229,136,93,Apr-19,1,1,0
14494,user_14494,2325,37,8,29,Feb-19,3,0,0
14495,user_14495,478,19,0,19,May-19,0,1,1
14496,user_14496,16929,319,97,222,May-19,0,1,1
14497,user_14497,4064,52,51,1,Jan-19,4,0,0
14498,user_14498,8691,216,98,118,May-19,0,1,1
14499,user_14499,31,5,5,0,Nov-18,6,0,0
14501,user_14501,14,2,2,0,Oct-18,7,0,0
14502,user_14502,640,14,14,0,Dec-18,5,0,0
14503,user_14503,1745,38,33,5,May-19,0,0,1
14504,user_14504,8739,140,16,124,May-19,0,1,1
14505,user_14505,13360,341,255,86,May-19,0,0,1
14506,user_14506,7812,103,9,94,May-19,0,1,1
14507,user_14507,9,2,2,0,Nov-18,6,0,0
14508,user_14508,81011,102,68,34,May-19,0,1,1
14510,user_14510,334,15,6,9,Mar-19,2,0,0
14511,user_14511,6135,53,35,18,Apr-19,1,1,0
14512,user_14512,9008,7,0,7,May-19,0,1,1
14513,user_14513,75,7,7,0,Nov-18,6,0,0
14514,user_14514,10751,45,14,31,Apr-19,1,1,0
14515,user_14515,32,15,3,12,Apr-19,1,1,0
14516,user_14516,495,90,51,39,Apr-19,1,1,0
14517,user_14517,4470,177,107,70,May-19,0,1,1
14518,user_14518,1934,222,12,210,May-19,0,1,1
14519,user_14519,2616,112,3,109,May-19,0,1,1
14520,user_14520,90,10,6,4,Feb-19,3,0,0
14521,user_14521,4587,148,34,114,Apr-19,1,1,0
14522,user_14522,682,47,18,29,May-19,0,1,1
14523,user_14523,5266,77,52,25,May-19,0,1,1
14524,user_14524,2991,63,22,41,May-19,0,1,1
14525,user_14525,9503,86,20,66,May-19,0,1,1
14526,user_14526,16,3,3,0,Oct-18,7,0,0
14527,user_14527,424,39,16,23,May-19,0,1,1
14528,user_14528,1597,17,7,10,Mar-19,2,0,0
14529,user_14529,14,3,3,0,Oct-18,7,0,0
14530,user_14530,2924,60,5,55,Jan-19,4,0,0
14531,user_14531,232,23,23,0,Nov-18,6,0,0
14532,user_14532,17,2,2,0,Oct-18,7,0,0
14534,user_14534,12,3,3,0,Oct-18,7,0,0
14535,user_14535,5634,156,55,101,May-19,0,1,1
14536,user_14536,71,12,12,0,Nov-18,6,0,0
14538,user_14538,6695,123,83,40,Apr-19,1,1,0
14539,user_14539,3974,23,11,12,Feb-19,3,0,0
14540,user_14540,130,26,13,13,Apr-19,1,1,0
14542,user_14542,83165,4,3,1,Feb-19,3,0,0
14543,user_14543,1332,79,43,36,May-19,0,1,1
14544,user_14544,13785,21,2,19,May-19,0,1,1
14545,user_14545,8456,97,59,38,May-19,0,1,1
14546,user_14546,2413,140,15,125,May-19,0,1,1
14548,user_14548,9,2,2,0,Oct-18,7,0,0
14549,user_14549,17,7,7,0,Nov-18,6,0,0
14550,user_14550,128,16,9,7,Jan-19,4,0,0
14551,user_14551,1280,24,23,1,Jan-19,4,0,0
14552,user_14552,43,5,5,0,Oct-18,7,0,0
14553,user_14553,2896,58,58,0,Nov-18,6,0,0
14554,user_14554,80,11,3,8,Apr-19,1,1,0
14555,user_14555,2237,77,70,7,Apr-19,1,1,0
14556,user_14556,20417,744,390,354,May-19,0,1,1
14557,user_14557,37,6,3,3,Feb-19,3,0,0
14558,user_14558,273,8,2,6,Apr-19,1,1,0
14559,user_14559,2026,45,5,40,May-19,0,1,1
14560,user_14560,6215,24,9,15,Apr-19,1,1,0
14561,user_14561,4,1,1,0,Oct-18,7,0,0
14562,user_14562,3098,37,9,28,May-19,0,1,1
14564,user_14564,341,18,13,5,Feb-19,3,0,0
14565,user_14565,14,3,3,0,Oct-18,7,0,0
14566,user_14566,509,58,30,28,May-19,0,1,1
14567,user_14567,2126,20,2,18,Feb-19,3,0,0
14569,user_14569,1598,28,8,20,May-19,0,1,1
14571,user_14571,2195,22,10,12,Mar-19,2,0,0
14572,user_14572,4590,253,172,81,May-19,0,1,1
14573,user_14573,6738,234,50,184,May-19,0,1,1
14574,user_14574,3707,146,6,140,May-19,0,1,1
14575,user_14575,1408,58,58,0,Dec-18,5,0,0
14576,user_14576,5695,128,10,118,May-19,0,1,1
14577,user_14577,12360,601,215,386,May-19,0,1,1
14578,user_14578,3346,107,63,44,May-19,0,1,1
14579,user_14579,77,15,2,13,Apr-19,1,1,0
14580,user_14580,9,1,1,0,Nov-18,6,0,0
14582,user_14582,7677,136,52,84,May-19,0,1,1
14583,user_14583,1109,32,21,11,May-19,0,1,1
14584,user_14584,11915,529,3,526,May-19,0,1,1
14585,user_14585,431,17,9,8,Apr-19,1,1,0
14586,user_14586,106,3,3,0,Oct-18,7,0,0
14587,user_14587,441,10,6,4,Apr-19,1,1,0
14588,user_14588,4047,209,1,208,Apr-19,1,1,0
14589,user_14589,85754,1024,210,814,May-19,0,1,1
14590,user_14590,526,41,0,41,May-19,0,1,1
14591,user_14591,54949,72,34,38,May-19,0,1,1
14592,user_14592,13334,222,119,103,May-19,0,1,1
14593,user_14593,3913,23,4,19,May-19,0,1,1
14594,user_14594,3518,30,6,24,May-19,0,1,1
14595,user_14595,1005,137,92,45,Jan-19,4,0,0
14596,user_14596,21,3,3,0,Oct-18,7,0,0
14598,user_14598,5230,170,20,150,May-19,0,1,1
14599,user_14599,733,23,16,7,Apr-19,1,1,0
14600,user_14600,52,7,6,1,May-19,0,0,1
14602,user_14602,916,44,35,9,Apr-19,1,1,0
14603,user_14603,45,6,6,0,Oct-18,7,0,0
14604,user_14604,705,81,7,74,May-19,0,1,1
14605,user_14605,24643,130,116,14,May-19,0,1,1
14606,user_14606,2227,8,3,5,Mar-19,2,0,0
14607,user_14607,14,3,3,0,Oct-18,7,0,0
14608,user_14608,11,2,2,0,Nov-18,6,0,0
14609,user_14609,3878,111,37,74,Apr-19,1,1,0
14610,user_14610,60,9,9,0,Dec-18,5,0,0
14611,user_14611,37,5,3,2,May-19,0,0,1
14612,user_14612,705,48,2,46,May-19,0,1,1
14613,user_14613,6739,255,106,149,May-19,0,1,1
14614,user_14614,1383,79,0,79,Apr-19,1,1,0
14615,user_14615,410,29,9,20,May-19,0,1,1
14616,user_14616,4919,281,0,281,May-19,0,1,1
14618,user_14618,1743,106,23,83,May-19,0,1,1
14619,user_14619,278,44,20,24,May-19,0,1,1
14620,user_14620,2281,48,20,28,Apr-19,1,1,0
14621,user_14621,3567,79,70,9,Mar-19,2,0,0
14622,user_14622,10847,81,54,27,May-19,0,1,1
14623,user_14623,12386,580,215,365,May-19,0,1,1
14624,user_14624,3971,82,78,4,Feb-19,3,0,0
14625,user_14625,3465,147,31,116,May-19,0,1,1
14626,user_14626,546,41,26,15,Apr-19,1,1,0
14627,user_14627,791,41,4,37,May-19,0,1,1
14628,user_14628,7894,32,13,19,May-19,0,1,1
14629,user_14629,2216,54,13,41,May-19,0,1,1
14630,user_14630,2001,91,23,68,Mar-19,2,0,0
14631,user_14631,1923,80,14,66,May-19,0,1,1
14632,user_14632,1489,145,31,114,May-19,0,1,1
14633,user_14633,9,1,1,0,Oct-18,7,0,0
14634,user_14634,3305,122,56,66,May-19,0,1,1
14635,user_14635,12885,64,22,42,May-19,0,1,1
14636,user_14636,5301,170,73,97,May-19,0,1,1
14637,user_14637,12105,284,90,194,May-19,0,1,1
14639,user_14639,874,60,6,54,May-19,0,0,1
14640,user_14640,8634,69,14,55,Apr-19,1,1,0
14641,user_14641,1204,44,2,42,May-19,0,1,1
14642,user_14642,2651,15,1,14,Apr-19,1,1,0
14643,user_14643,4200,126,49,77,May-19,0,1,1
14644,user_14644,3592,112,72,40,Apr-19,1,1,0
14645,user_14645,2724,138,56,82,May-19,0,1,1
14646,user_14646,812,21,21,0,Dec-18,5,0,0
14647,user_14647,6,7,7,0,Nov-18,6,0,0
14648,user_14648,9,3,3,0,Nov-18,6,0,0
14649,user_14649,176,6,6,0,Nov-18,6,0,0
14650,user_14650,9981,162,73,89,May-19,0,1,1
14651,user_14651,2205,204,73,131,May-19,0,1,1
14652,user_14652,8,5,4,1,Apr-19,1,1,0
14653,user_14653,6867,111,105,6,Jan-19,4,0,0
14654,user_14654,1183,49,20,29,Apr-19,1,1,0
14655,user_14655,21620,167,75,92,May-19,0,1,1
14656,user_14656,9233,232,41,191,May-19,0,1,1
14657,user_14657,1576,19,16,3,Mar-19,2,0,0
14658,user_14658,158,10,0,10,May-19,0,1,1
14659,user_14659,6715,127,49,78,May-19,0,1,1
14660,user_14660,788,50,50,0,Dec-18,5,0,0
14661,user_14661,2482,50,25,25,May-19,0,1,1
14662,user_14662,23,5,3,2,Mar-19,2,0,0
14663,user_14663,6649,65,50,15,Apr-19,1,1,0
14664,user_14664,4004,93,31,62,May-19,0,1,1
14665,user_14665,2393,46,20,26,May-19,0,1,1
14666,user_14666,8913,374,78,296,May-19,0,1,1
14667,user_14667,17486,420,219,201,May-19,0,1,1
14668,user_14668,41,4,4,0,Oct-18,7,0,0
14669,user_14669,1475,151,55,96,May-19,0,1,1
14671,user_14671,3509,53,0,53,May-19,0,1,1
14672,user_14672,32982,819,16,803,May-19,0,1,1
14673,user_14673,5241,76,34,42,May-19,0,1,1
14674,user_14674,4323,117,35,82,May-19,0,1,1
14675,user_14675,2080,113,24,89,May-19,0,1,1
14676,user_14676,373,10,8,2,Jan-19,4,0,0
14679,user_14679,6965,150,59,91,May-19,0,1,1
14681,user_14681,3742,133,9,124,May-19,0,1,1
14682,user_14682,10,4,0,4,Mar-19,2,0,0
14683,user_14683,2260,86,41,45,May-19,0,1,1
14684,user_14684,2085,59,34,25,Mar-19,2,0,0
14685,user_14685,620,59,19,40,May-19,0,0,1
14686,user_14686,2956,120,43,77,Apr-19,1,1,0
14687,user_14687,26,4,4,0,Oct-18,7,0,0
14688,user_14688,32,9,1,8,May-19,0,1,1
14689,user_14689,10792,142,66,76,May-19,0,1,1
14690,user_14690,21,3,3,0,Oct-18,7,0,0
14691,user_14691,626,44,13,31,May-19,0,1,1
14692,user_14692,35,5,5,0,Oct-18,7,0,0
14693,user_14693,3357,228,85,143,May-19,0,1,1
14694,user_14694,999,24,22,2,Apr-19,1,1,0
14695,user_14695,3269,92,62,30,May-19,0,1,1
14696,user_14696,3020,207,133,74,May-19,0,1,1
14697,user_14697,2399,87,46,41,May-19,0,1,1
14698,user_14698,6530,145,75,70,May-19,0,1,1
14699,user_14699,40,15,14,1,Jan-19,4,0,0
14700,user_14700,200,3,3,0,Oct-18,7,0,0
14701,user_14701,13322,394,128,266,May-19,0,1,1
14702,user_14702,4677,51,9,42,May-19,0,1,1
14703,user_14703,34246,531,250,281,Apr-19,1,1,0
14704,user_14704,1288,41,8,33,Mar-19,2,0,0
14705,user_14705,226,12,9,3,Mar-19,2,0,0
14706,user_14706,126,5,4,1,Feb-19,3,0,0
14707,user_14707,1907,88,41,47,May-19,0,1,1
14708,user_14708,11407,440,166,274,May-19,0,1,1
14709,user_14709,93,6,6,0,Oct-18,7,0,0
14710,user_14710,11585,32,15,17,May-19,0,1,1
14711,user_14711,11529,475,115,360,May-19,0,1,1
14712,user_14712,402,43,19,24,May-19,0,1,1
14713,user_14713,4266,124,34,90,Apr-19,1,1,0
14714,user_14714,0,1,1,0,Oct-18,7,0,0
14715,user_14715,36,4,4,0,Oct-18,7,0,0
14716,user_14716,607,15,13,2,Jan-19,4,0,0
14717,user_14717,73,11,2,9,Apr-19,1,1,0
14718,user_14718,3151,119,31,88,May-19,0,1,1
14720,user_14720,79,40,8,32,May-19,0,1,1
14721,user_14721,14,3,3,0,Nov-18,6,0,0
14722,user_14722,5689,122,20,102,May-19,0,1,1
14723,user_14723,2585,11,0,11,May-19,0,1,1
14724,user_14724,11756,226,158,68,May-19,0,1,1
14725,user_14725,6987,539,170,369,May-19,0,1,1
14726,user_14726,2523,86,28,58,May-19,0,1,1
14727,user_14727,10,1,1,0,Dec-18,5,0,0
14728,user_14728,706,16,1,15,Apr-19,1,1,0
14729,user_14729,1077,50,2,48,Apr-19,1,1,0
14730,user_14730,38274,92,44,48,May-19,0,1,1
14731,user_14731,11,4,4,0,Nov-18,6,0,0
14732,user_14732,9488,6,6,0,Oct-18,7,0,0
14733,user_14733,3061,30,2,28,May-19,0,1,1
14734,user_14734,3892,328,60,268,May-19,0,1,1
14735,user_14735,23,2,0,2,Apr-19,1,1,0
14736,user_14736,41,7,5,2,Apr-19,1,1,0
14737,user_14737,1559,51,41,10,May-19,0,0,1
14738,user_14738,2024,193,80,113,May-19,0,1,1
14739,user_14739,984,13,7,6,May-19,0,1,1
14740,user_14740,1115,28,25,3,Apr-19,1,1,0
14741,user_14741,1849,66,9,57,May-19,0,1,1
14742,user_14742,18,3,3,0,Nov-18,6,0,0
14743,user_14743,10130,607,233,374,May-19,0,1,1
14744,user_14744,8583,63,0,63,Apr-19,1,1,0
14745,user_14745,1707,43,3,40,May-19,0,1,1
14746,user_14746,6310,77,0,77,May-19,0,1,1
14747,user_14747,8481,210,2,208,May-19,0,1,1
14748,user_14748,46,4,4,0,Oct-18,7,0,0
14749,user_14749,34413,284,18,266,May-19,0,1,1
14750,user_14750,11,2,2,0,Oct-18,7,0,0
14751,user_14751,4755,194,27,167,May-19,0,1,1
14752,user_14752,1250,16,10,6,May-19,0,1,1
14753,user_14753,497,45,1,44,Apr-19,1,1,0
14754,user_14754,257,32,2,30,Mar-19,2,0,0
14755,user_14755,667,7,0,7,May-19,0,1,1
14756,user_14756,4090,64,36,28,May-19,0,1,1
14757,user_14757,28556,1233,315,918,May-19,0,1,1
14758,user_14758,1013,101,25,76,Apr-19,1,1,0
14759,user_14759,7224,156,95,61,May-19,0,1,1
14760,user_14760,1393,46,3,43,Feb-19,3,0,0
14762,user_14762,1353,135,71,64,May-19,0,1,1
14763,user_14763,5604,168,68,100,May-19,0,1,1
14764,user_14764,3404,391,104,287,May-19,0,1,1
14765,user_14765,9,2,0,2,Jan-19,4,0,0
14766,user_14766,5596,315,72,243,May-19,0,1,1
14768,user_14768,1725,27,9,18,May-19,0,1,1
14769,user_14769,731,72,31,41,Apr-19,1,1,0
14770,user_14770,2071,40,13,27,Apr-19,1,1,0
14772,user_14772,2284,4,2,2,May-19,0,1,1
14773,user_14773,65343,101,9,92,May-19,0,1,1
14774,user_14774,27043,475,129,346,May-19,0,1,1
14775,user_14775,6277,99,21,78,May-19,0,1,1
14776,user_14776,16,3,3,0,Nov-18,6,0,0
14777,user_14777,4093,281,112,169,Mar-19,2,0,0
14779,user_14779,3616,110,101,9,Apr-19,1,1,0
14780,user_14780,1343,77,28,49,May-19,0,1,1
14781,user_14781,22118,383,95,288,May-19,0,1,1
14782,user_14782,496,38,9,29,May-19,0,1,1
14783,user_14783,1534,52,10,42,Apr-19,1,1,0
14784,user_14784,1727,57,56,1,Apr-19,1,1,0
14785,user_14785,28,6,6,0,Oct-18,7,0,0
14786,user_14786,5134,131,52,79,May-19,0,1,1
14787,user_14787,569,21,21,0,Nov-18,6,0,0
14789,user_14789,24,5,5,0,Nov-18,6,0,0
14791,user_14791,108,6,6,0,Nov-18,6,0,0
14792,user_14792,3113,272,98,174,May-19,0,1,1
14793,user_14793,1901,84,38,46,May-19,0,1,1
14794,user_14794,175,3,3,0,Oct-18,7,0,0
14795,user_14795,783,7,7,0,Dec-18,5,0,0
14796,user_14796,618,19,16,3,May-19,0,0,1
14797,user_14797,842,26,16,10,May-19,0,1,1
14798,user_14798,2942,99,78,21,May-19,0,0,1
14799,user_14799,1370,78,13,65,May-19,0,1,1
14800,user_14800,27,5,3,2,Feb-19,3,0,0
14801,user_14801,1429,20,3,17,Apr-19,1,1,0
14802,user_14802,856001,40,10,30,Apr-19,1,1,0
14803,user_14803,2948,59,2,57,Apr-19,1,1,0
14804,user_14804,3262,147,20,127,May-19,0,1,1
14805,user_14805,3904,85,20,65,May-19,0,1,1
14806,user_14806,8438,111,49,62,May-19,0,1,1
14807,user_14807,242,8,6,2,Jan-19,4,0,0
14808,user_14808,13918,297,84,213,May-19,0,1,1
14809,user_14809,6398,32,32,0,Nov-18,6,0,0
14810,user_14810,40,4,3,1,Mar-19,2,0,0
14811,user_14811,206,5,5,0,Oct-18,7,0,0
14812,user_14812,41,5,5,0,Oct-18,7,0,0
14813,user_14813,1025,77,5,72,May-19,0,1,1
14814,user_14814,30,16,9,7,Mar-19,2,0,0
14815,user_14815,207,14,4,10,May-19,0,1,1
14816,user_14816,1009,73,16,57,May-19,0,1,1
14817,user_14817,2896,131,102,29,Feb-19,3,0,0
14818,user_14818,464,14,12,2,Feb-19,3,0,0
14819,user_14819,3211,39,5,34,May-19,0,1,1
14820,user_14820,487,11,3,8,Apr-19,1,1,0
14821,user_14821,3739,29,3,26,May-19,0,0,1
14822,user_14822,437,9,6,3,Mar-19,2,0,0
14823,user_14823,1826,183,39,144,May-19,0,1,1
14824,user_14824,6381,139,45,94,May-19,0,1,1
14825,user_14825,11653,157,64,93,May-19,0,1,1
14826,user_14826,3960,58,0,58,Apr-19,1,1,0
14827,user_14827,1176,19,2,17,May-19,0,1,1
14828,user_14828,4672,41,26,15,Apr-19,1,1,0
14829,user_14829,619,20,19,1,Apr-19,1,1,0
14830,user_14830,3606,103,100,3,Jan-19,4,0,0
14831,user_14831,12795,182,111,71,May-19,0,1,1
14832,user_14832,307,36,6,30,May-19,0,1,1
14833,user_14833,1777,29,2,27,Mar-19,2,0,0
14834,user_14834,10,4,2,2,Jan-19,4,0,0
14835,user_14835,1682,45,2,43,May-19,0,1,1
14836,user_14836,2133,79,27,52,Apr-19,1,1,0
14837,user_14837,954,31,28,3,Jan-19,4,0,0
14838,user_14838,1717,24,14,10,May-19,0,0,1
14839,user_14839,2391,63,19,44,May-19,0,0,1
14840,user_14840,1188,27,10,17,Apr-19,1,1,0
14841,user_14841,1353,52,8,44,Apr-19,1,1,0
14843,user_14843,27,4,4,0,Oct-18,7,0,0
14844,user_14844,694,42,36,6,Jan-19,4,0,0
14845,user_14845,15416,160,65,95,Mar-19,2,0,0
14846,user_14846,35624,350,104,246,May-19,0,1,1
14847,user_14847,14,3,3,0,Oct-18,7,0,0
14848,user_14848,2379,242,70,172,May-19,0,1,1
14849,user_14849,2645,114,62,52,May-19,0,1,1
14851,user_14851,1058,34,34,0,Dec-18,5,0,0
14852,user_14852,6,3,3,0,Oct-18,7,0,0
14853,user_14853,13258,157,92,65,May-19,0,1,1
14854,user_14854,14982,430,208,222,May-19,0,1,1
14855,user_14855,9977,207,6,201,May-19,0,1,1
14856,user_14856,675,36,9,27,May-19,0,1,1
14857,user_14857,77,16,10,6,Mar-19,2,0,0
14858,user_14858,1574,26,16,10,Mar-19,2,0,0
14859,user_14859,189,5,4,1,May-19,0,0,1
14860,user_14860,389,3,2,1,Jan-19,4,0,0
14861,user_14861,831,34,27,7,May-19,0,1,1
14862,user_14862,139,10,2,8,Mar-19,2,0,0
14863,user_14863,21,3,3,0,Oct-18,7,0,0
14864,user_14864,106,8,0,8,May-19,0,1,1
14865,user_14865,1171,21,21,0,Nov-18,6,0,0
14866,user_14866,463,17,11,6,Mar-19,2,0,0
14867,user_14867,2771,153,57,96,May-19,0,1,1
14868,user_14868,33027,45,16,29,May-19,0,1,1
14869,user_14869,8869,105,42,63,May-19,0,1,1
14870,user_14870,1330,8,4,4,Feb-19,3,0,0
14871,user_14871,922,41,30,11,May-19,0,1,1
14872,user_14872,1494,36,13,23,Apr-19,1,1,0
14873,user_14873,8974,447,115,332,May-19,0,1,1
14874,user_14874,1,1,1,0,Oct-18,7,0,0
14875,user_14875,426,17,17,0,Dec-18,5,0,0
14876,user_14876,9449,106,35,71,May-19,0,1,1
14877,user_14877,476,50,32,18,Apr-19,1,1,0
14878,user_14878,15,18,13,5,Apr-19,1,1,0
14879,user_14879,1203,99,11,88,Apr-19,1,1,0
14880,user_14880,14703,157,116,41,May-19,0,1,1
14881,user_14881,547,15,6,9,May-19,0,0,1
14882,user_14882,2434,62,14,48,Apr-19,1,1,0
14883,user_14883,2463,20,2,18,May-19,0,1,1
14884,user_14884,917,53,24,29,May-19,0,1,1
14885,user_14885,840,72,19,53,May-19,0,1,1
14886,user_14886,1545,92,39,53,Apr-19,1,1,0
14887,user_14887,366,12,9,3,May-19,0,1,1
14888,user_14888,5025,36,6,30,May-19,0,1,1
14889,user_14889,646,11,11,0,Nov-18,6,0,0
14890,user_14890,21060,245,31,214,May-19,0,1,1
14891,user_14891,4883,586,134,452,May-19,0,1,1
14892,user_14892,3003,296,20,276,May-19,0,1,1
14893,user_14893,49403,1019,210,809,May-19,0,1,1
14894,user_14894,2865,55,29,26,Apr-19,1,1,0
14895,user_14895,5738,217,105,112,May-19,0,1,1
14896,user_14896,4247,128,42,86,May-19,0,1,1
14897,user_14897,18253,40,23,17,Mar-19,2,0,0
14898,user_14898,14,3,3,0,Nov-18,6,0,0
14899,user_14899,1402,94,30,64,May-19,0,1,1
14900,user_14900,28524,231,86,145,May-19,0,1,1
14901,user_14901,1151,60,24,36,May-19,0,1,1
14902,user_14902,2483,76,25,51,May-19,0,1,1
14903,user_14903,17725,266,96,170,May-19,0,1,1
14904,user_14904,16877,248,99,149,May-19,0,1,1
14905,user_14905,1971,39,4,35,May-19,0,1,1
14907,user_14907,2481,99,26,73,May-19,0,0,1
14908,user_14908,38,9,9,0,Oct-18,7,0,0
14909,user_14909,31,5,5,0,Oct-18,7,0,0
14910,user_14910,3590,60,32,28,May-19,0,1,1
14911,user_14911,1717,55,0,55,May-19,0,1,1
14912,user_14912,487,17,13,4,Jan-19,4,0,0
14913,user_14913,21,6,0,6,May-19,0,1,1
14914,user_14914,671,32,5,27,May-19,0,1,1
14915,user_14915,2174,47,12,35,May-19,0,1,1
14916,user_14916,7971,313,96,217,May-19,0,1,1
14917,user_14917,1043,37,13,24,Apr-19,1,1,0
14918,user_14918,2528,118,37,81,May-19,0,0,1
14919,user_14919,681,21,21,0,Dec-18,5,0,0
14920,user_14920,35,3,0,3,Jan-19,4,0,0
14921,user_14921,1396,31,29,2,Jan-19,4,0,0
14923,user_14923,135,5,3,2,Mar-19,2,0,0
14924,user_14924,12520,198,33,165,May-19,0,1,1
14925,user_14925,331,16,3,13,May-19,0,1,1
14926,user_14926,7017,39,4,35,May-19,0,1,1
14927,user_14927,10,3,3,0,Oct-18,7,0,0
14928,user_14928,925,54,4,50,May-19,0,1,1
14929,user_14929,2641,51,9,42,Apr-19,1,1,0
14930,user_14930,2796,200,45,155,May-19,0,1,1
14931,user_14931,22258,868,338,530,May-19,0,1,1
14932,user_14932,316,14,2,12,May-19,0,0,1
14933,user_14933,1957,33,8,25,May-19,0,1,1
14934,user_14934,2717,168,63,105,Apr-19,1,1,0
14935,user_14935,789,20,8,12,Mar-19,2,0,0
14936,user_14936,673,58,19,39,Apr-19,1,1,0
14937,user_14937,16574,214,5,209,May-19,0,1,1
14938,user_14938,5142,23,5,18,Mar-19,2,0,0
14939,user_14939,948,14,7,7,Apr-19,1,1,0
14940,user_14940,7976,551,225,326,May-19,0,1,1
14941,user_14941,1084,62,3,59,May-19,0,1,1
14942,user_14942,36599,1659,386,1273,May-19,0,1,1
14943,user_14943,2569,57,4,53,Apr-19,1,1,0
14944,user_14944,66,3,3,0,Nov-18,6,0,0
14945,user_14945,1892,59,20,39,May-19,0,1,1
14946,user_14946,92923,345,62,283,May-19,0,1,1
14947,user_14947,820,31,20,11,May-19,0,0,1
14948,user_14948,2464,158,0,158,May-19,0,1,1
14949,user_14949,4432,262,161,101,May-19,0,1,1
14950,user_14950,8508,295,90,205,May-19,0,1,1
14951,user_14951,12,3,3,0,Dec-18,5,0,0
14952,user_14952,10675,496,3,493,May-19,0,1,1
14953,user_14953,22,3,3,0,Oct-18,7,0,0
14954,user_14954,1373,45,26,19,May-19,0,1,1
14955,user_14955,1431,66,18,48,Apr-19,1,1,0
14956,user_14956,480,28,28,0,Dec-18,5,0,0
14957,user_14957,261,7,7,0,Nov-18,6,0,0
14958,user_14958,3527,182,69,113,Apr-19,1,1,0
14959,user_14959,6512,81,36,45,May-19,0,1,1
14960,user_14960,25,5,2,3,Jan-19,4,0,0
14961,user_14961,6080,64,58,6,Apr-19,1,1,0
14962,user_14962,2963,59,56,3,Jan-19,4,0,0
14963,user_14963,11,2,2,0,Oct-18,7,0,0
14964,user_14964,3273,77,59,18,Apr-19,1,1,0
14965,user_14965,29,7,7,0,Dec-18,5,0,0
14966,user_14966,4221,76,40,36,Mar-19,2,0,0
14967,user_14967,3016,32,11,21,May-19,0,1,1
14968,user_14968,10181,94,86,8,May-19,0,0,1
14969,user_14969,3076,93,29,64,May-19,0,1,1
14970,user_14970,9500,756,153,603,May-19,0,1,1
14971,user_14971,204,20,20,0,Oct-18,7,0,0
14972,user_14972,1901,59,29,30,Apr-19,1,1,0
14973,user_14973,2630,272,106,166,May-19,0,1,1
14974,user_14974,14249,395,159,236,May-19,0,1,1
14975,user_14975,28,4,4,0,Oct-18,7,0,0
14976,user_14976,3310,60,4,56,May-19,0,1,1
14977,user_14977,1279,80,6,74,May-19,0,1,1
14978,user_14978,721,21,21,0,Nov-18,6,0,0
14979,user_14979,3925,120,40,80,May-19,0,1,1
14980,user_14980,11757,454,172,282,May-19,0,1,1
14982,user_14982,32594,1324,285,1039,May-19,0,1,1
14984,user_14984,2650,59,29,30,May-19,0,1,1
14985,user_14985,5575,196,34,162,May-19,0,1,1
14986,user_14986,16,3,0,3,May-19,0,0,1
14987,user_14987,23552,120,41,79,May-19,0,1,1
14988,user_14988,9,1,1,0,Oct-18,7,0,0
14989,user_14989,719,50,17,33,Apr-19,1,1,0
14990,user_14990,747,16,8,8,Mar-19,2,0,0
14991,user_14991,8237,143,84,59,Apr-19,1,1,0
14992,user_14992,3502,256,0,256,May-19,0,1,1
14993,user_14993,9955,138,97,41,Jan-19,4,0,0
14994,user_14994,38,2,2,0,Oct-18,7,0,0
14995,user_14995,207,5,5,0,Nov-18,6,0,0
14996,user_14996,465,34,16,18,May-19,0,1,1
14997,user_14997,18,3,3,0,Nov-18,6,0,0
14998,user_14998,1807,31,5,26,May-19,0,1,1
14999,user_14999,1527,81,15,66,May-19,0,1,1
15000,user_15000,3573,276,25,251,May-19,0,1,1
15001,user_15001,18,3,3,0,Dec-18,5,0,0
15002,user_15002,2211,72,53,19,May-19,0,1,1
15003,user_15003,486,13,2,11,May-19,0,1,1
15004,user_15004,2343,94,27,67,Apr-19,1,1,0
15005,user_15005,199,42,35,7,May-19,0,1,1
15006,user_15006,2054,104,32,72,May-19,0,1,1
15007,user_15007,3533,79,3,76,Apr-19,1,1,0
15008,user_15008,120,29,29,0,Dec-18,5,0,0
15009,user_15009,2982,62,13,49,May-19,0,1,1
15010,user_15010,662,38,22,16,Mar-19,2,0,0
15011,user_15011,13,1,0,1,May-19,0,0,1
15012,user_15012,6794,130,41,89,May-19,0,1,1
15013,user_15013,4971,17,5,12,May-19,0,0,1
15014,user_15014,4828,74,48,26,May-19,0,1,1
15015,user_15015,967,124,36,88,Apr-19,1,1,0
15016,user_15016,27258,147,36,111,May-19,0,1,1
15017,user_15017,9012,171,100,71,Apr-19,1,1,0
15018,user_15018,58883,35,8,27,May-19,0,1,1
15019,user_15019,158,8,8,0,Nov-18,6,0,0
15020,user_15020,809,17,5,12,Apr-19,1,1,0
15021,user_15021,639,43,20,23,May-19,0,1,1
15022,user_15022,5772,101,63,38,May-19,0,0,1
15023,user_15023,9,2,2,0,Oct-18,7,0,0
15024,user_15024,3745,27,11,16,Apr-19,1,1,0
15025,user_15025,13289,468,83,385,May-19,0,1,1
15026,user_15026,16,3,3,0,Oct-18,7,0,0
15027,user_15027,301,59,10,49,May-19,0,1,1
15028,user_15028,727,19,16,3,Mar-19,2,0,0
15029,user_15029,4842,33,24,9,Jan-19,4,0,0
15031,user_15031,1628,47,26,21,Mar-19,2,0,0
15032,user_15032,8248,28,20,8,Apr-19,1,1,0
15033,user_15033,911,47,21,26,May-19,0,1,1
15034,user_15034,4,6,2,4,Jan-19,4,0,0
15035,user_15035,42143,88,50,38,Apr-19,1,1,0
15036,user_15036,8417,388,88,300,May-19,0,1,1
15037,user_15037,1360,42,28,14,Mar-19,2,0,0
15038,user_15038,70,29,18,11,Apr-19,1,1,0
15039,user_15039,4721,20,4,16,Apr-19,1,1,0
15040,user_15040,988,54,8,46,Mar-19,2,0,0
15041,user_15041,8049,61,34,27,May-19,0,1,1
15042,user_15042,473,24,24,0,Dec-18,5,0,0
15043,user_15043,11588,621,178,443,May-19,0,1,1
15044,user_15044,11698,79,19,60,May-19,0,1,1
15046,user_15046,651,4,4,0,Oct-18,7,0,0
15047,user_15047,8710,103,78,25,Apr-19,1,1,0
15048,user_15048,117,6,0,6,Apr-19,1,1,0
15049,user_15049,60,1,1,0,Oct-18,7,0,0
15050,user_15050,826,18,8,10,Apr-19,1,1,0
15051,user_15051,1330,67,3,64,May-19,0,1,1
15052,user_15052,3946,88,34,54,May-19,0,1,1
15053,user_15053,90834,94,16,78,May-19,0,1,1
15054,user_15054,14905,120,79,41,May-19,0,1,1
15056,user_15056,62,6,6,0,Oct-18,7,0,0
15057,user_15057,704,16,9,7,Apr-19,1,1,0
15058,user_15058,22,7,3,4,Apr-19,1,1,0
15059,user_15059,493,14,14,0,Nov-18,6,0,0
15060,user_15060,144,16,5,11,May-19,0,1,1
15061,user_15061,1465,59,12,47,Apr-19,1,1,0
15062,user_15062,10,1,1,0,Oct-18,7,0,0
15063,user_15063,86,3,3,0,Oct-18,7,0,0
15064,user_15064,25516,107,12,95,May-19,0,1,1
15065,user_15065,13321,210,51,159,May-19,0,1,1
15066,user_15066,1542,19,13,6,Apr-19,1,1,0
15067,user_15067,1846,60,22,38,May-19,0,1,1
15068,user_15068,14935,924,307,617,May-19,0,1,1
15069,user_15069,1052,28,25,3,Apr-19,1,1,0
15070,user_15070,232,28,14,14,May-19,0,1,1
15071,user_15071,5834,26,12,14,Mar-19,2,0,0
15072,user_15072,147,13,6,7,Apr-19,1,1,0
15073,user_15073,14714,230,50,180,May-19,0,1,1
15074,user_15074,6378,33,22,11,Mar-19,2,0,0
15075,user_15075,184,7,2,5,May-19,0,1,1
15076,user_15076,3227,66,0,66,May-19,0,1,1
15077,user_15077,4015,127,8,119,May-19,0,1,1
15078,user_15078,129,6,2,4,May-19,0,1,1
15079,user_15079,174,6,6,0,Oct-18,7,0,0
15080,user_15080,9701,522,80,442,May-19,0,1,1
15081,user_15081,1548,143,7,136,May-19,0,1,1
15082,user_15082,9279,46,18,28,Feb-19,3,0,0
15083,user_15083,1123,25,15,10,Apr-19,1,1,0
15084,user_15084,330,18,9,9,Mar-19,2,0,0
15085,user_15085,34362,209,23,186,May-19,0,1,1
15087,user_15087,3132,337,101,236,May-19,0,1,1
15088,user_15088,11952,345,82,263,May-19,0,1,1
15089,user_15089,71,13,13,0,Dec-18,5,0,0
15090,user_15090,26,4,4,0,Oct-18,7,0,0
15091,user_15091,433,26,13,13,Apr-19,1,1,0
15092,user_15092,1410,46,21,25,May-19,0,1,1
15093,user_15093,30,2,2,0,Oct-18,7,0,0
15094,user_15094,870,8,3,5,Feb-19,3,0,0
15095,user_15095,140,14,4,10,Apr-19,1,1,0
15096,user_15096,3905,269,137,132,May-19,0,1,1
15097,user_15097,5243,152,5,147,May-19,0,1,1
15098,user_15098,16448,102,32,70,May-19,0,1,1
15099,user_15099,23075,196,92,104,May-19,0,1,1
15100,user_15100,5514,378,109,269,May-19,0,1,1
15101,user_15101,721,13,3,10,Mar-19,2,0,0
15102,user_15102,5084,113,87,26,May-19,0,1,1
15103,user_15103,7296,58,56,2,May-19,0,0,1
15104,user_15104,4217,128,45,83,May-19,0,1,1
15105,user_15105,18411,447,3,444,May-19,0,1,1
15106,user_15106,3578,90,88,2,Feb-19,3,0,0
15107,user_15107,183586,193,11,182,May-19,0,1,1
15108,user_15108,3284,187,61,126,May-19,0,1,1
15110,user_15110,9,1,1,0,Nov-18,6,0,0
15111,user_15111,3213,39,26,13,Jan-19,4,0,0
15112,user_15112,13,3,1,2,Jan-19,4,0,0
15113,user_15113,51,2,2,0,Nov-18,6,0,0
15114,user_15114,3540,54,21,33,May-19,0,0,1
15115,user_15115,60,5,1,4,Apr-19,1,1,0
15116,user_15116,6595,435,25,410,May-19,0,0,1
15117,user_15117,13593,128,26,102,May-19,0,1,1
15118,user_15118,3596,49,48,1,May-19,0,0,1
15119,user_15119,2341,29,2,27,Apr-19,1,1,0
15120,user_15120,35,7,3,4,Mar-19,2,0,0
15121,user_15121,6809,269,17,252,May-19,0,1,1
15122,user_15122,2699,78,5,73,May-19,0,1,1
15123,user_15123,32497,360,7,353,May-19,0,1,1
15124,user_15124,6,3,3,0,Dec-18,5,0,0
15125,user_15125,1268,48,3,45,May-19,0,1,1
15126,user_15126,18,4,4,0,Nov-18,6,0,0
15127,user_15127,11470,571,143,428,May-19,0,1,1
15128,user_15128,15,4,1,3,May-19,0,1,1
15129,user_15129,5154,150,47,103,May-19,0,1,1
15130,user_15130,7183,214,62,152,Mar-19,2,0,0
15131,user_15131,15,5,5,0,Nov-18,6,0,0
15132,user_15132,1091,68,13,55,May-19,0,1,1
15133,user_15133,1965,91,14,77,May-19,0,0,1
15134,user_15134,1157,44,41,3,Apr-19,1,1,0
15135,user_15135,5008,141,1,140,May-19,0,1,1
15136,user_15136,2294,175,45,130,Apr-19,1,1,0
15137,user_15137,2714,117,24,93,May-19,0,1,1
15138,user_15138,1555,42,11,31,Mar-19,2,0,0
15139,user_15139,156,40,11,29,May-19,0,0,1
15140,user_15140,229,18,3,15,Apr-19,1,1,0
15141,user_15141,25,29,20,9,Apr-19,1,1,0
15142,user_15142,221,48,18,30,May-19,0,1,1
15143,user_15143,120,14,4,10,Apr-19,1,1,0
15144,user_15144,82,5,2,3,Apr-19,1,1,0
15145,user_15145,3644,9,9,0,Nov-18,6,0,0
15146,user_15146,138,6,0,6,Mar-19,2,0,0
15147,user_15147,12121,92,29,63,May-19,0,1,1
15149,user_15149,313,16,1,15,Apr-19,1,1,0
15150,user_15150,64,5,4,1,Feb-19,3,0,0
15151,user_15151,12122,268,10,258,Apr-19,1,1,0
15152,user_15152,11339,305,88,217,May-19,0,1,1
15153,user_15153,958,20,15,5,Feb-19,3,0,0
15154,user_15154,3579,114,97,17,Apr-19,1,1,0
15155,user_15155,894,39,2,37,May-19,0,1,1
15156,user_15156,3221,179,2,177,May-19,0,1,1
15157,user_15157,4659,182,34,148,May-19,0,1,1
15158,user_15158,31,3,3,0,Nov-18,6,0,0
15159,user_15159,280,34,11,23,Apr-19,1,1,0
15161,user_15161,43,18,8,10,Jan-19,4,0,0
15162,user_15162,245,27,11,16,Apr-19,1,1,0
15163,user_15163,10,2,2,0,Nov-18,6,0,0
15164,user_15164,367,44,18,26,Apr-19,1,1,0
15165,user_15165,204,17,4,13,Mar-19,2,0,0
15166,user_15166,19303,128,15,113,May-19,0,1,1
15167,user_15167,8,5,5,0,Dec-18,5,0,0
15168,user_15168,292,27,0,27,Apr-19,1,1,0
15170,user_15170,7679,222,47,175,May-19,0,1,1
15171,user_15171,869,20,0,20,May-19,0,1,1
15172,user_15172,4135,84,12,72,May-19,0,1,1
15173,user_15173,1822,188,36,152,May-19,0,1,1
15174,user_15174,63,9,0,9,Apr-19,1,1,0
15175,user_15175,8,2,2,0,Nov-18,6,0,0
15177,user_15177,1590,48,1,47,May-19,0,1,1
15178,user_15178,345,27,7,20,May-19,0,1,1
15179,user_15179,2955,69,5,64,May-19,0,1,1
15180,user_15180,26,3,3,0,Nov-18,6,0,0
15181,user_15181,69,2,0,2,Jan-19,4,0,0
15182,user_15182,2291,58,3,55,May-19,0,1,1
15183,user_15183,1862,49,23,26,May-19,0,1,1
15184,user_15184,199,6,5,1,Jan-19,4,0,0
15185,user_15185,11878,41,5,36,Apr-19,1,1,0
15186,user_15186,2549,98,74,24,Apr-19,1,1,0
15187,user_15187,21167,307,25,282,May-19,0,1,1
15188,user_15188,10,2,2,0,Nov-18,6,0,0
15190,user_15190,8989,125,4,121,May-19,0,1,1
15192,user_15192,21,3,3,0,Nov-18,6,0,0
15193,user_15193,3635,10,8,2,May-19,0,0,1
15194,user_15194,129,15,5,10,May-19,0,1,1
15195,user_15195,21592,1581,73,1508,May-19,0,1,1
15196,user_15196,353,31,5,26,May-19,0,1,1
15197,user_15197,27538,17,2,15,May-19,0,1,1
15198,user_15198,1496,85,22,63,May-19,0,1,1
15199,user_15199,999,43,4,39,May-19,0,1,1
15200,user_15200,9,1,1,0,Nov-18,6,0,0
15201,user_15201,1329,20,3,17,May-19,0,1,1
15202,user_15202,2220,25,23,2,Feb-19,3,0,0
15203,user_15203,10,1,1,0,Nov-18,6,0,0
15204,user_15204,10465,409,50,359,May-19,0,1,1
15205,user_15205,18,4,4,0,Nov-18,6,0,0
15206,user_15206,92,7,3,4,Apr-19,1,1,0
15207,user_15207,5994,43,7,36,May-19,0,1,1
15208,user_15208,16919,137,45,92,May-19,0,1,1
15209,user_15209,623,22,0,22,Apr-19,1,1,0
15210,user_15210,665,15,5,10,Apr-19,1,1,0
15211,user_15211,730,19,7,12,Apr-19,1,1,0
15212,user_15212,2627,96,44,52,May-19,0,1,1
15213,user_15213,2836,197,54,143,May-19,0,1,1
15214,user_15214,159,15,15,0,Dec-18,5,0,0
15215,user_15215,296,25,19,6,Feb-19,3,0,0
15216,user_15216,4,1,1,0,Nov-18,6,0,0
15218,user_15218,513,5,2,3,Feb-19,3,0,0
15219,user_15219,173,7,3,4,Feb-19,3,0,0
15220,user_15220,4465,32,17,15,Apr-19,1,1,0
15221,user_15221,54436,428,68,360,May-19,0,1,1
15222,user_15222,1238,17,11,6,Jan-19,4,0,0
15223,user_15223,2472,82,41,41,Apr-19,1,1,0
15224,user_15224,15337,600,66,534,May-19,0,1,1
15226,user_15226,4352,139,50,89,May-19,0,1,1
15227,user_15227,10839,84,7,77,May-19,0,1,1
15228,user_15228,1486,67,0,67,Apr-19,1,1,0
15229,user_15229,229,18,1,17,May-19,0,1,1
15230,user_15230,20,8,5,3,Jan-19,4,0,0
15231,user_15231,19724,517,15,502,May-19,0,1,1
15232,user_15232,2538,77,5,72,May-19,0,1,1
15233,user_15233,630,13,7,6,Apr-19,1,1,0
15234,user_15234,89,10,5,5,Apr-19,1,1,0
15235,user_15235,2514,49,9,40,Apr-19,1,1,0
15236,user_15236,3679,37,19,18,Apr-19,1,1,0
15237,user_15237,929,18,1,17,Jan-19,4,0,0
15239,user_15239,16001,37,3,34,Mar-19,2,0,0
15240,user_15240,4121,62,2,60,May-19,0,1,1
15241,user_15241,89,19,12,7,Jan-19,4,0,0
15242,user_15242,2516,34,15,19,Mar-19,2,0,0
15243,user_15243,2735,80,13,67,May-19,0,1,1
15244,user_15244,5872,77,32,45,May-19,0,1,1
15245,user_15245,11,2,2,0,Nov-18,6,0,0
15246,user_15246,2285,46,20,26,Apr-19,1,1,0
15247,user_15247,1732,8,8,0,Nov-18,6,0,0
15248,user_15248,2334,23,8,15,Apr-19,1,1,0
15249,user_15249,3469,177,73,104,May-19,0,1,1
15250,user_15250,13290,37,12,25,May-19,0,1,1
15251,user_15251,6273,61,3,58,Feb-19,3,0,0
15252,user_15252,4362,89,35,54,May-19,0,1,1
15253,user_15253,2554,43,14,29,May-19,0,1,1
15254,user_15254,19410,159,9,150,Apr-19,1,1,0
15255,user_15255,773,14,2,12,Mar-19,2,0,0
15256,user_15256,772,53,19,34,May-19,0,1,1
15257,user_15257,85,5,4,1,May-19,0,0,1
15258,user_15258,7085,129,58,71,May-19,0,1,1
15259,user_15259,551,21,4,17,May-19,0,1,1
15260,user_15260,74,15,6,9,May-19,0,0,1
15261,user_15261,106,15,4,11,Apr-19,1,1,0
15262,user_15262,1869,146,50,96,May-19,0,1,1
15263,user_15263,9327,177,29,148,May-19,0,1,1
15264,user_15264,10099,165,22,143,May-19,0,1,1
15265,user_15265,0,1,1,0,Nov-18,6,0,0
15266,user_15266,628,54,9,45,May-19,0,1,1
15267,user_15267,9,2,2,0,Nov-18,6,0,0
15268,user_15268,1601,75,6,69,Apr-19,1,1,0
15269,user_15269,8598,219,3,216,May-19,0,1,1
15270,user_15270,40,2,2,0,Nov-18,6,0,0
15272,user_15272,1384,56,41,15,Jan-19,4,0,0
15273,user_15273,887,23,5,18,Mar-19,2,0,0
15274,user_15274,108,10,10,0,Dec-18,5,0,0
15275,user_15275,1209,70,25,45,Apr-19,1,1,0
15276,user_15276,3201,78,14,64,May-19,0,1,1
15277,user_15277,120,3,3,0,Nov-18,6,0,0
15278,user_15278,134,7,7,0,Dec-18,5,0,0
15279,user_15279,204,23,0,23,Apr-19,1,1,0
15280,user_15280,9030,230,61,169,May-19,0,1,1
15281,user_15281,184,4,2,2,Apr-19,1,1,0
15282,user_15282,3575,125,39,86,May-19,0,1,1
15283,user_15283,1,1,1,0,Nov-18,6,0,0
15284,user_15284,22228,450,64,386,May-19,0,1,1
15285,user_15285,311,22,1,21,May-19,0,1,1
15287,user_15287,9143,378,36,342,May-19,0,1,1
15288,user_15288,589,10,4,6,Mar-19,2,0,0
15289,user_15289,772,15,15,0,Dec-18,5,0,0
15290,user_15290,8854,465,21,444,May-19,0,1,1
15291,user_15291,936,58,2,56,May-19,0,1,1
15292,user_15292,8,2,2,0,Dec-18,5,0,0
15293,user_15293,1077,32,14,18,Apr-19,1,1,0
15294,user_15294,605,22,3,19,May-19,0,1,1
15295,user_15295,5399,171,80,91,May-19,0,1,1
15296,user_15296,391,26,21,5,Mar-19,2,0,0
15297,user_15297,444,38,7,31,Apr-19,1,1,0
15298,user_15298,11815,401,41,360,May-19,0,1,1
15299,user_15299,2620,45,4,41,Apr-19,1,1,0
15301,user_15301,21700,610,2,608,May-19,0,1,1
15302,user_15302,6909,53,3,50,May-19,0,1,1
15303,user_15303,21929,336,92,244,May-19,0,1,1
15304,user_15304,8405,88,29,59,May-19,0,1,1
15305,user_15305,124,11,10,1,Feb-19,3,0,0
15306,user_15306,18,3,3,0,Dec-18,5,0,0
15307,user_15307,3213,19,12,7,Mar-19,2,0,0
15308,user_15308,401,6,5,1,Mar-19,2,0,0
15309,user_15309,7556,88,29,59,May-19,0,1,1
15310,user_15310,10,3,3,0,Nov-18,6,0,0
15311,user_15311,2646,88,2,86,May-19,0,0,1
15312,user_15312,25483,503,190,313,May-19,0,1,1
15313,user_15313,2174,29,0,29,May-19,0,1,1
15314,user_15314,5547,108,36,72,Apr-19,1,1,0
15315,user_15315,2851,41,27,14,May-19,0,1,1
15316,user_15316,1337,27,15,12,May-19,0,1,1
15317,user_15317,271,13,8,5,May-19,0,1,1
15318,user_15318,1103,45,25,20,Apr-19,1,1,0
15319,user_15319,395,35,0,35,May-19,0,1,1
15320,user_15320,739,29,8,21,May-19,0,1,1
15321,user_15321,6971,116,0,116,May-19,0,1,1
15322,user_15322,5469,161,14,147,May-19,0,1,1
15323,user_15323,454,80,27,53,May-19,0,1,1
15324,user_15324,2261,45,4,41,Apr-19,1,1,0
15325,user_15325,156,6,6,0,Dec-18,5,0,0
15326,user_15326,421,15,15,0,Dec-18,5,0,0
15327,user_15327,1530,55,2,53,May-19,0,1,1
15328,user_15328,2320,26,7,19,May-19,0,0,1
15329,user_15329,4727,106,14,92,May-19,0,1,1
15330,user_15330,1215,17,10,7,Apr-19,1,1,0
15331,user_15331,10,4,1,3,Mar-19,2,0,0
15332,user_15332,109,18,0,18,May-19,0,1,1
15333,user_15333,988,67,5,62,May-19,0,1,1
15334,user_15334,1275,33,4,29,Mar-19,2,0,0
15335,user_15335,3319,90,90,0,Dec-18,5,0,0
15336,user_15336,954,22,2,20,Apr-19,1,1,0
15337,user_15337,2398,208,6,202,May-19,0,1,1
15338,user_15338,412,30,7,23,May-19,0,1,1
15339,user_15339,1306,22,2,20,Mar-19,2,0,0
15340,user_15340,19858,658,65,593,May-19,0,1,1
15341,user_15341,3355,180,20,160,May-19,0,1,1
15342,user_15342,968,18,5,13,May-19,0,1,1
15344,user_15344,4142,37,1,36,May-19,0,1,1
15345,user_15345,1217,28,3,25,Apr-19,1,1,0
15346,user_15346,9183,109,2,107,May-19,0,1,1
15347,user_15347,14,3,3,0,Dec-18,5,0,0
15348,user_15348,859,24,5,19,Apr-19,1,1,0
15349,user_15349,6287,488,164,324,May-19,0,1,1
15350,user_15350,1260,98,8,90,May-19,0,1,1
15351,user_15351,8,3,3,0,Nov-18,6,0,0
15352,user_15352,17,6,6,0,Dec-18,5,0,0
15353,user_15353,1696,39,13,26,May-19,0,1,1
15354,user_15354,3735,80,15,65,May-19,0,1,1
15355,user_15355,9688,189,91,98,May-19,0,1,1
15356,user_15356,16,3,3,0,Nov-18,6,0,0
15357,user_15357,6104,257,42,215,May-19,0,1,1
15359,user_15359,12,4,4,0,Nov-18,6,0,0
15360,user_15360,12667,95,41,54,May-19,0,0,1
15361,user_15361,51,3,3,0,Nov-18,6,0,0
15362,user_15362,18,3,2,1,Jan-19,4,0,0
15363,user_15363,374520,1023,224,799,May-19,0,1,1
15364,user_15364,9,2,2,0,Nov-18,6,0,0
15365,user_15365,31,15,15,0,Dec-18,5,0,0
15367,user_15367,3494,11,5,6,Mar-19,2,0,0
15368,user_15368,216,12,2,10,Apr-19,1,1,0
15369,user_15369,11199,86,2,84,May-19,0,1,1
15370,user_15370,2983,282,4,278,Apr-19,1,1,0
15371,user_15371,14,3,3,0,Dec-18,5,0,0
15373,user_15373,9,2,2,0,Dec-18,5,0,0
15374,user_15374,1364,48,30,18,Feb-19,3,0,0
15375,user_15375,5207,97,74,23,Feb-19,3,0,0
15376,user_15376,498,33,13,20,Mar-19,2,0,0
15377,user_15377,8951,130,34,96,May-19,0,1,1
15378,user_15378,1957,89,4,85,May-19,0,1,1
15379,user_15379,28,6,6,0,Nov-18,6,0,0
15380,user_15380,65,16,0,16,Mar-19,2,0,0
15381,user_15381,19696,200,38,162,May-19,0,1,1
15382,user_15382,10,1,1,0,Nov-18,6,0,0
15383,user_15383,14728,89,47,42,May-19,0,1,1
15384,user_15384,320,46,25,21,Apr-19,1,1,0
15385,user_15385,4893,55,0,55,May-19,0,1,1
15386,user_15386,9,2,2,0,Nov-18,6,0,0
15387,user_15387,174,7,6,1,Apr-19,1,1,0
15388,user_15388,2720,144,36,108,Apr-19,1,1,0
15389,user_15389,2243,105,2,103,May-19,0,1,1
15391,user_15391,129,29,19,10,Apr-19,1,1,0
15392,user_15392,35,3,3,0,Nov-18,6,0,0
15393,user_15393,3691,5,5,0,Dec-18,5,0,0
15394,user_15394,548,24,14,10,Jan-19,4,0,0
15395,user_15395,40,22,9,13,Apr-19,1,1,0
15397,user_15397,1273,43,41,2,Mar-19,2,0,0
15398,user_15398,19,5,0,5,May-19,0,1,1
15399,user_15399,20,3,2,1,May-19,0,0,1
15400,user_15400,1202,121,4,117,May-19,0,1,1
15401,user_15401,341,33,0,33,Mar-19,2,0,0
15403,user_15403,3337,152,45,107,May-19,0,1,1
15404,user_15404,56715,35,6,29,Apr-19,1,1,0
15405,user_15405,10057,205,29,176,Apr-19,1,1,0
15406,user_15406,73,10,8,2,Feb-19,3,0,0
15407,user_15407,1790,101,62,39,May-19,0,1,1
15408,user_15408,560,19,6,13,Mar-19,2,0,0
15409,user_15409,11069,246,93,153,May-19,0,1,1
15410,user_15410,4115,48,21,27,May-19,0,1,1
15411,user_15411,192,40,27,13,Feb-19,3,0,0
15412,user_15412,8513,648,93,555,May-19,0,1,1
15413,user_15413,17,1,1,0,Nov-18,6,0,0
15415,user_15415,8002,140,8,132,May-19,0,1,1
15416,user_15416,3268,30,8,22,Apr-19,1,1,0
15417,user_15417,122,13,11,2,Feb-19,3,0,0
15418,user_15418,40137,425,19,406,May-19,0,1,1
15419,user_15419,1670,31,2,29,May-19,0,1,1
15420,user_15420,6500,131,36,95,May-19,0,1,1
15421,user_15421,1542,79,27,52,May-19,0,1,1
15422,user_15422,535,27,23,4,Apr-19,1,1,0
15423,user_15423,69637,77,33,44,May-19,0,1,1
15424,user_15424,163,21,16,5,Apr-19,1,1,0
15425,user_15425,40,7,3,4,Apr-19,1,1,0
15426,user_15426,2629,35,25,10,Apr-19,1,1,0
15427,user_15427,2848,16,11,5,May-19,0,1,1
15428,user_15428,12774,172,64,108,May-19,0,1,1
15429,user_15429,1119,46,41,5,Feb-19,3,0,0
15430,user_15430,5342,91,8,83,Apr-19,1,1,0
15431,user_15431,908,22,6,16,Feb-19,3,0,0
15432,user_15432,275,21,14,7,Apr-19,1,1,0
15433,user_15433,3802,45,21,24,Apr-19,1,1,0
15434,user_15434,16,3,3,0,Nov-18,6,0,0
15435,user_15435,190,11,4,7,May-19,0,0,1
15436,user_15436,9128,273,86,187,May-19,0,1,1
15437,user_15437,26,10,10,0,Dec-18,5,0,0
15438,user_15438,879,53,9,44,Mar-19,2,0,0
15439,user_15439,19240,83,3,80,Apr-19,1,1,0
15440,user_15440,42,9,7,2,Jan-19,4,0,0
15441,user_15441,436,27,7,20,May-19,0,1,1
15442,user_15442,181,6,6,0,Dec-18,5,0,0
15443,user_15443,9447,55,16,39,May-19,0,1,1
15444,user_15444,7502,152,2,150,Apr-19,1,1,0
15445,user_15445,2334,7,7,0,Dec-18,5,0,0
15446,user_15446,408,26,11,15,Mar-19,2,0,0
15447,user_15447,24643,236,55,181,May-19,0,1,1
15448,user_15448,2467,37,36,1,Jan-19,4,0,0
15449,user_15449,34,5,2,3,Mar-19,2,0,0
15450,user_15450,961,24,8,16,May-19,0,1,1
15451,user_15451,1056,85,11,74,May-19,0,1,1
15452,user_15452,7389,161,0,161,May-19,0,1,1
15453,user_15453,3096,118,12,106,May-19,0,1,1
15454,user_15454,6788,110,30,80,May-19,0,1,1
15455,user_15455,13,4,2,2,Feb-19,3,0,0
15456,user_15456,859,64,15,49,Apr-19,1,1,0
15457,user_15457,3241,53,53,0,Nov-18,6,0,0
15458,user_15458,2611,392,98,294,May-19,0,1,1
15459,user_15459,1390,83,57,26,May-19,0,1,1
15460,user_15460,32939,974,241,733,May-19,0,1,1
15461,user_15461,204,10,10,0,Nov-18,6,0,0
15462,user_15462,16442,371,17,354,May-19,0,1,1
15463,user_15463,198,24,9,15,Apr-19,1,1,0
15464,user_15464,61908,51,3,48,Apr-19,1,1,0
15465,user_15465,16021,500,162,338,May-19,0,1,1
15466,user_15466,115,15,12,3,Jan-19,4,0,0
15467,user_15467,1446,20,12,8,May-19,0,0,1
15468,user_15468,370,54,29,25,May-19,0,1,1
15470,user_15470,11406,150,47,103,May-19,0,1,1
15471,user_15471,826,102,21,81,May-19,0,1,1
15472,user_15472,4,1,1,0,Nov-18,6,0,0
15473,user_15473,11554,369,15,354,May-19,0,1,1
15474,user_15474,1573,28,6,22,Apr-19,1,1,0
15475,user_15475,5690,65,56,9,May-19,0,1,1
15476,user_15476,43,12,7,5,Apr-19,1,1,0
15477,user_15477,346,46,12,34,May-19,0,1,1
15478,user_15478,12,5,5,0,Nov-18,6,0,0
15479,user_15479,634,43,10,33,May-19,0,1,1
15480,user_15480,20,3,1,2,Feb-19,3,0,0
15481,user_15481,1330,77,19,58,May-19,0,1,1
15482,user_15482,509,7,7,0,Dec-18,5,0,0
15483,user_15483,1,1,1,0,Nov-18,6,0,0
15484,user_15484,10,4,4,0,Dec-18,5,0,0
15485,user_15485,7528,86,7,79,May-19,0,1,1
15486,user_15486,3675,47,2,45,May-19,0,1,1
15487,user_15487,91,165,27,138,May-19,0,1,1
15488,user_15488,1123,53,6,47,Apr-19,1,1,0
15489,user_15489,604,13,13,0,Nov-18,6,0,0
15490,user_15490,967,24,4,20,May-19,0,1,1
15491,user_15491,62,17,10,7,May-19,0,0,1
15492,user_15492,14,9,9,0,Nov-18,6,0,0
15493,user_15493,914,20,10,10,Mar-19,2,0,0
15494,user_15494,2618,70,0,70,May-19,0,1,1
15495,user_15495,15206,133,6,127,May-19,0,1,1
15496,user_15496,836,24,7,17,May-19,0,0,1
15497,user_15497,50,15,1,14,Feb-19,3,0,0
15498,user_15498,26,4,3,1,Feb-19,3,0,0
15500,user_15500,5137,100,8,92,May-19,0,1,1
15501,user_15501,4890,257,0,257,May-19,0,1,1
15503,user_15503,7043,300,148,152,May-19,0,1,1
15504,user_15504,1464,54,7,47,May-19,0,1,1
15505,user_15505,199,13,1,12,Mar-19,2,0,0
15506,user_15506,899,51,13,38,May-19,0,1,1
15507,user_15507,9,6,5,1,Feb-19,3,0,0
15508,user_15508,373,16,2,14,May-19,0,1,1
15509,user_15509,674,22,2,20,Mar-19,2,0,0
15510,user_15510,4541,72,10,62,May-19,0,1,1
15511,user_15511,16646,143,22,121,May-19,0,1,1
15512,user_15512,21224,401,44,357,May-19,0,1,1
15513,user_15513,2467,221,18,203,May-19,0,1,1
15514,user_15514,6,2,2,0,Nov-18,6,0,0
15515,user_15515,2414,151,98,53,May-19,0,0,1
15516,user_15516,753,54,18,36,Apr-19,1,1,0
15518,user_15518,331,9,8,1,Jan-19,4,0,0
15519,user_15519,6994,106,19,87,Apr-19,1,1,0
15520,user_15520,89,8,8,0,Nov-18,6,0,0
15521,user_15521,7397,51,51,0,Dec-18,5,0,0
15522,user_15522,283,7,7,0,Nov-18,6,0,0
15523,user_15523,13,3,3,0,Nov-18,6,0,0
15524,user_15524,8787,91,3,88,Apr-19,1,1,0
15525,user_15525,26,4,2,2,Jan-19,4,0,0
15526,user_15526,10,3,3,0,Nov-18,6,0,0
15527,user_15527,93,10,9,1,Apr-19,1,1,0
15528,user_15528,5921,41,14,27,May-19,0,1,1
15530,user_15530,18,3,3,0,Nov-18,6,0,0
15531,user_15531,2132,119,9,110,May-19,0,1,1
15532,user_15532,890,31,9,22,Apr-19,1,1,0
15533,user_15533,2375,7,3,4,Feb-19,3,0,0
15534,user_15534,76,9,6,3,Apr-19,1,1,0
15535,user_15535,14,3,0,3,Apr-19,1,1,0
15536,user_15536,861,33,0,33,Apr-19,1,1,0
15537,user_15537,6251,125,38,87,Apr-19,1,1,0
15538,user_15538,805,54,18,36,Apr-19,1,1,0
15539,user_15539,350,22,22,0,Nov-18,6,0,0
15540,user_15540,5258,140,24,116,May-19,0,1,1
15541,user_15541,1551,87,38,49,Apr-19,1,1,0
15542,user_15542,35100,52,8,44,May-19,0,1,1
15543,user_15543,1722,105,8,97,May-19,0,1,1
15544,user_15544,597,37,6,31,May-19,0,1,1
15545,user_15545,3068,75,21,54,May-19,0,1,1
15546,user_15546,132,2,0,2,Mar-19,2,0,0
15547,user_15547,624,33,7,26,Mar-19,2,0,0
15548,user_15548,3087,108,13,95,May-19,0,1,1
15549,user_15549,9690,31,28,3,Jan-19,4,0,0
15550,user_15550,2140,55,30,25,Jan-19,4,0,0
15551,user_15551,4121,172,37,135,May-19,0,1,1
15552,user_15552,458,12,3,9,Mar-19,2,0,0
15553,user_15553,34,11,5,6,Apr-19,1,1,0
15555,user_15555,109,7,7,0,Nov-18,6,0,0
15556,user_15556,2221,51,20,31,May-19,0,1,1
15557,user_15557,2763,165,10,155,May-19,0,1,1
15558,user_15558,505,18,16,2,Jan-19,4,0,0
15559,user_15559,79,9,9,0,Dec-18,5,0,0
15560,user_15560,169,7,3,4,Apr-19,1,1,0
15561,user_15561,24,4,4,0,Nov-18,6,0,0
15562,user_15562,12885,33,15,18,May-19,0,1,1
15563,user_15563,220,14,0,14,May-19,0,1,1
15564,user_15564,914,10,1,9,Mar-19,2,0,0
15565,user_15565,14429,300,69,231,May-19,0,1,1
15566,user_15566,196,7,3,4,Apr-19,1,1,0
15567,user_15567,2564,96,7,89,Apr-19,1,1,0
15568,user_15568,14564,93,5,88,May-19,0,1,1
15570,user_15570,1786,42,5,37,May-19,0,1,1
15571,user_15571,2393,53,7,46,May-19,0,0,1
15572,user_15572,926,39,2,37,Mar-19,2,0,0
15573,user_15573,3413,338,112,226,May-19,0,1,1
15574,user_15574,21629,414,71,343,May-19,0,1,1
15575,user_15575,3615,15,12,3,Jan-19,4,0,0
15576,user_15576,6255,73,54,19,May-19,0,1,1
15577,user_15577,43,6,6,0,Dec-18,5,0,0
15579,user_15579,24599,820,8,812,May-19,0,1,1
15580,user_15580,1449,91,13,78,May-19,0,1,1
15581,user_15581,725,32,2,30,May-19,0,1,1
15582,user_15582,5,1,1,0,Nov-18,6,0,0
15583,user_15583,17723,212,44,168,May-19,0,1,1
15584,user_15584,1852,15,14,1,Jan-19,4,0,0
15585,user_15585,2,2,2,0,Nov-18,6,0,0
15586,user_15586,708,36,2,34,Apr-19,1,1,0
15587,user_15587,2585,252,14,238,May-19,0,1,1
15588,user_15588,184,6,5,1,Apr-19,1,1,0
15589,user_15589,8646,126,72,54,May-19,0,1,1
15590,user_15590,33,5,4,1,Mar-19,2,0,0
15591,user_15591,591,18,5,13,May-19,0,0,1
15592,user_15592,9157,446,107,339,Apr-19,1,1,0
15593,user_15593,1883,25,15,10,Apr-19,1,1,0
15594,user_15594,9,6,3,3,Apr-19,1,1,0
15595,user_15595,93489,124,3,121,May-19,0,1,1
15596,user_15596,13765,317,29,288,May-19,0,1,1
15597,user_15597,5117,84,37,47,May-19,0,1,1
15598,user_15598,1339,20,3,17,May-19,0,0,1
15599,user_15599,18,2,2,0,Nov-18,6,0,0
15600,user_15600,30021,150,62,88,May-19,0,1,1
15602,user_15602,780,40,8,32,Mar-19,2,0,0
15603,user_15603,3232,47,12,35,May-19,0,1,1
15604,user_15604,842,30,15,15,Mar-19,2,0,0
15605,user_15605,134,25,8,17,May-19,0,1,1
15606,user_15606,4113,56,56,0,Dec-18,5,0,0
15607,user_15607,111,7,2,5,Apr-19,1,1,0
15608,user_15608,35,5,5,0,Dec-18,5,0,0
15609,user_15609,168,11,6,5,Apr-19,1,1,0
15611,user_15611,52,7,3,4,Mar-19,2,0,0
15612,user_15612,2311,71,3,68,May-19,0,1,1
15613,user_15613,1360,73,10,63,May-19,0,1,1
15614,user_15614,3052,139,67,72,May-19,0,1,1
15615,user_15615,400,6,3,3,Apr-19,1,1,0
15616,user_15616,907,42,8,34,May-19,0,1,1
15617,user_15617,1,1,1,0,Nov-18,6,0,0
15618,user_15618,1969,177,11,166,May-19,0,1,1
15619,user_15619,10727,58,0,58,May-19,0,1,1
15620,user_15620,2601,167,17,150,May-19,0,1,1
15622,user_15622,287,15,6,9,May-19,0,1,1
15623,user_15623,798,30,2,28,Apr-19,1,1,0
15624,user_15624,52,16,5,11,Apr-19,1,1,0
15625,user_15625,5638,51,3,48,May-19,0,1,1
15626,user_15626,5499,195,0,195,May-19,0,1,1
15627,user_15627,513,6,2,4,Apr-19,1,1,0
15628,user_15628,2671,87,25,62,May-19,0,1,1
15629,user_15629,3326,45,37,8,May-19,0,1,1
15630,user_15630,1870,71,9,62,May-19,0,1,1
15631,user_15631,14751,404,10,394,May-19,0,1,1
15632,user_15632,1177,29,21,8,Apr-19,1,1,0
15633,user_15633,347,17,2,15,May-19,0,1,1
15634,user_15634,587,29,18,11,Jan-19,4,0,0
15636,user_15636,130,3,1,2,Apr-19,1,1,0
15637,user_15637,81,4,3,1,Jan-19,4,0,0
15639,user_15639,20115,384,5,379,Apr-19,1,1,0
15640,user_15640,413,6,6,0,Dec-18,5,0,0
15641,user_15641,10952,364,15,349,May-19,0,1,1
15642,user_15642,20,2,1,1,Jan-19,4,0,0
15643,user_15643,4479,19,1,18,May-19,0,1,1
15644,user_15644,554,6,6,0,Dec-18,5,0,0
15645,user_15645,145,11,0,11,May-19,0,1,1
15646,user_15646,1964,83,30,53,May-19,0,1,1
15647,user_15647,9,2,2,0,Nov-18,6,0,0
15648,user_15648,4165,269,51,218,May-19,0,1,1
15649,user_15649,2140,97,9,88,May-19,0,1,1
15650,user_15650,4771,47,16,31,Apr-19,1,1,0
15651,user_15651,39273,73,47,26,May-19,0,0,1
15652,user_15652,3057,151,76,75,May-19,0,0,1
15653,user_15653,18,2,2,0,Dec-18,5,0,0
15654,user_15654,3813,46,6,40,May-19,0,1,1
15655,user_15655,155,26,10,16,Apr-19,1,1,0
15656,user_15656,2203,43,16,27,May-19,0,1,1
15657,user_15657,32606,787,169,618,May-19,0,1,1
15658,user_15658,1,1,1,0,Nov-18,6,0,0
15659,user_15659,1671,27,5,22,May-19,0,1,1
15660,user_15660,3871,260,58,202,May-19,0,1,1
15661,user_15661,15563,845,169,676,May-19,0,1,1
15662,user_15662,19466,236,53,183,May-19,0,1,1
15663,user_15663,12,4,4,0,Dec-18,5,0,0
15664,user_15664,60,3,3,0,Nov-18,6,0,0
15665,user_15665,620,17,7,10,Apr-19,1,1,0
15666,user_15666,1185,53,6,47,May-19,0,1,1
15667,user_15667,3290,101,28,73,May-19,0,1,1
15668,user_15668,108,14,6,8,Mar-19,2,0,0
15669,user_15669,744,10,10,0,Dec-18,5,0,0
15670,user_15670,707,34,11,23,May-19,0,1,1
15671,user_15671,161,24,15,9,Mar-19,2,0,0
15672,user_15672,3513,55,13,42,Apr-19,1,1,0
15673,user_15673,27881,214,110,104,May-19,0,1,1
15674,user_15674,1005,78,4,74,May-19,0,0,1
15675,user_15675,5152,552,62,490,May-19,0,1,1
15676,user_15676,464,19,11,8,Apr-19,1,1,0
15677,user_15677,2802,13,3,10,May-19,0,1,1
15678,user_15678,688,27,7,20,Apr-19,1,1,0
15679,user_15679,9821,233,99,134,May-19,0,1,1
15680,user_15680,5775,121,63,58,May-19,0,1,1
15681,user_15681,3659,83,2,81,Apr-19,1,1,0
15682,user_15682,87,37,8,29,Apr-19,1,1,0
15683,user_15683,671,29,6,23,Mar-19,2,0,0
15684,user_15684,21,3,3,0,Dec-18,5,0,0
15685,user_15685,1423,40,4,36,Jan-19,4,0,0
15686,user_15686,17365,498,131,367,May-19,0,1,1
15687,user_15687,21,3,3,0,Nov-18,6,0,0
15688,user_15688,25,6,5,1,Apr-19,1,1,0
15689,user_15689,888,152,20,132,May-19,0,1,1
15690,user_15690,485,22,3,19,May-19,0,1,1
15691,user_15691,802,56,8,48,May-19,0,1,1
15692,user_15692,22975,675,27,648,May-19,0,1,1
15693,user_15693,57,3,3,0,Nov-18,6,0,0
15694,user_15694,19,5,3,2,May-19,0,0,1
15695,user_15695,1176,57,14,43,May-19,0,1,1
15696,user_15696,565,54,21,33,May-19,0,1,1
15697,user_15697,856,31,12,19,Mar-19,2,0,0
15698,user_15698,76,10,4,6,Apr-19,1,1,0
15699,user_15699,3158,141,58,83,May-19,0,1,1
15700,user_15700,392,7,3,4,May-19,0,0,1
15701,user_15701,21589,42,8,34,May-19,0,1,1
15702,user_15702,21,3,3,0,Nov-18,6,0,0
15703,user_15703,1154,52,16,36,May-19,0,1,1
15704,user_15704,86,26,24,2,Jan-19,4,0,0
15706,user_15706,217,27,6,21,Apr-19,1,1,0
15707,user_15707,9526,128,21,107,May-19,0,1,1
15708,user_15708,1481,99,48,51,Apr-19,1,1,0
15709,user_15709,56583,306,129,177,May-19,0,1,1
15710,user_15710,9,2,2,0,Dec-18,5,0,0
15711,user_15711,1217,105,34,71,May-19,0,1,1
15712,user_15712,20,2,1,1,Jan-19,4,0,0
15713,user_15713,89,13,2,11,Apr-19,1,1,0
15714,user_15714,58,8,4,4,Mar-19,2,0,0
15715,user_15715,23266,164,90,74,May-19,0,1,1
15716,user_15716,252,57,26,31,Mar-19,2,0,0
15717,user_15717,25931,58,6,52,Mar-19,2,0,0
15718,user_15718,510,2,1,1,Jan-19,4,0,0
15719,user_15719,8,2,0,2,Apr-19,1,1,0
15720,user_15720,43,5,0,5,Apr-19,1,1,0
15721,user_15721,30,5,5,0,Dec-18,5,0,0
15722,user_15722,634,16,16,0,Nov-18,6,0,0
15723,user_15723,3072,53,10,43,May-19,0,1,1
15724,user_15724,2860,53,23,30,Apr-19,1,1,0
15725,user_15725,7680,505,100,405,May-19,0,1,1
15726,user_15726,388,4,4,0,Nov-18,6,0,0
15727,user_15727,10056,33,14,19,Apr-19,1,1,0
15728,user_15728,13645,354,5,349,May-19,0,1,1
15729,user_15729,3146,38,0,38,May-19,0,1,1
15730,user_15730,9156,149,22,127,May-19,0,1,1
15731,user_15731,1790,28,6,22,Apr-19,1,1,0
15732,user_15732,119,14,5,9,May-19,0,1,1
15733,user_15733,2650,141,34,107,May-19,0,1,1
15734,user_15734,3473,312,47,265,May-19,0,1,1
15735,user_15735,520,9,3,6,May-19,0,0,1
15736,user_15736,558,16,16,0,Dec-18,5,0,0
15737,user_15737,329,7,4,3,Mar-19,2,0,0
15738,user_15738,5163,113,59,54,May-19,0,1,1
15739,user_15739,3182,47,39,8,Feb-19,3,0,0
15740,user_15740,530,41,6,35,Apr-19,1,1,0
15741,user_15741,3,4,4,0,Dec-18,5,0,0
15742,user_15742,2670,20,11,9,Mar-19,2,0,0
15743,user_15743,1155,58,7,51,May-19,0,1,1
15744,user_15744,818,72,3,69,Apr-19,1,1,0
15745,user_15745,26,3,3,0,Dec-18,5,0,0
15746,user_15746,1136,20,17,3,Apr-19,1,1,0
15747,user_15747,1229,65,10,55,May-19,0,1,1
15748,user_15748,9269,64,9,55,Apr-19,1,1,0
15749,user_15749,311,23,2,21,May-19,0,1,1
15750,user_15750,1717,68,42,26,Apr-19,1,1,0
15751,user_15751,30,4,3,1,May-19,0,0,1
15752,user_15752,15,2,2,0,Nov-18,6,0,0
15753,user_15753,6468,56,6,50,May-19,0,1,1
15755,user_15755,301,13,6,7,Feb-19,3,0,0
15756,user_15756,18,3,3,0,Dec-18,5,0,0
15757,user_15757,6864,95,19,76,May-19,0,1,1
15758,user_15758,2124,65,33,32,May-19,0,1,1
15759,user_15759,181,14,10,4,Apr-19,1,1,0
15760,user_15760,9693,280,68,212,May-19,0,1,1
15761,user_15761,2558,432,1,431,May-19,0,1,1
15762,user_15762,1428,69,14,55,May-19,0,1,1
15763,user_15763,2045,34,15,19,May-19,0,1,1
15764,user_15764,283,29,2,27,May-19,0,1,1
15765,user_15765,1417,112,8,104,May-19,0,1,1
15766,user_15766,1414,14,0,14,May-19,0,1,1
15767,user_15767,1996,121,40,81,May-19,0,1,1
15768,user_15768,17,1,1,0,Nov-18,6,0,0
15770,user_15770,428,21,12,9,May-19,0,0,1
15771,user_15771,126,17,5,12,Apr-19,1,1,0
15772,user_15772,18,3,3,0,Dec-18,5,0,0
15773,user_15773,916,42,10,32,Apr-19,1,1,0
15775,user_15775,73,8,3,5,May-19,0,0,1
15776,user_15776,2127,231,57,174,May-19,0,1,1
15777,user_15777,2879,103,7,96,Apr-19,1,1,0
15778,user_15778,15883,365,103,262,May-19,0,1,1
15779,user_15779,3553,466,2,464,May-19,0,1,1
15780,user_15780,1221,13,5,8,Mar-19,2,0,0
15781,user_15781,85,9,8,1,May-19,0,0,1
15782,user_15782,30783,1564,25,1539,May-19,0,1,1
15783,user_15783,26,3,3,0,Dec-18,5,0,0
15784,user_15784,25755,284,95,189,May-19,0,1,1
15785,user_15785,4362,48,6,42,Feb-19,3,0,0
15786,user_15786,2452,25,21,4,Jan-19,4,0,0
15787,user_15787,449,38,1,37,Feb-19,3,0,0
15788,user_15788,14,10,9,1,Apr-19,1,1,0
15789,user_15789,4430,37,9,28,May-19,0,1,1
15790,user_15790,17679,318,39,279,May-19,0,1,1
15791,user_15791,10,2,2,0,Nov-18,6,0,0
15792,user_15792,562,17,17,0,Dec-18,5,0,0
15794,user_15794,4801,33,7,26,May-19,0,1,1
15795,user_15795,2832,229,43,186,May-19,0,1,1
15796,user_15796,1836,70,13,57,Apr-19,1,1,0
15798,user_15798,1660,23,5,18,May-19,0,0,1
15799,user_15799,98774,549,70,479,May-19,0,1,1
15800,user_15800,69,5,2,3,Mar-19,2,0,0
15801,user_15801,7458,80,74,6,May-19,0,0,1
15802,user_15802,69,7,4,3,Feb-19,3,0,0
15803,user_15803,771,27,2,25,May-19,0,1,1
15804,user_15804,355,15,2,13,Apr-19,1,1,0
15805,user_15805,1587,59,37,22,May-19,0,1,1
15806,user_15806,205,19,0,19,Apr-19,1,1,0
15807,user_15807,460,29,9,20,Apr-19,1,1,0
15808,user_15808,174,44,3,41,May-19,0,1,1
15809,user_15809,48,10,7,3,Feb-19,3,0,0
15810,user_15810,977,34,17,17,Apr-19,1,1,0
15811,user_15811,6193,18,2,16,Mar-19,2,0,0
15813,user_15813,86,2,2,0,Nov-18,6,0,0
15814,user_15814,4213,208,187,21,Mar-19,2,0,0
15815,user_15815,814,41,19,22,May-19,0,1,1
15816,user_15816,21,3,3,0,Nov-18,6,0,0
15817,user_15817,390,7,3,4,May-19,0,0,1
15818,user_15818,1361,32,1,31,Mar-19,2,0,0
15819,user_15819,8896,236,54,182,May-19,0,1,1
15820,user_15820,1933,191,8,183,May-19,0,1,1
15821,user_15821,201,25,12,13,May-19,0,1,1
15822,user_15822,4901,57,4,53,May-19,0,1,1
15823,user_15823,1711,4,4,0,Dec-18,5,0,0
15824,user_15824,6952,61,17,44,Apr-19,1,1,0
15825,user_15825,2804,119,3,116,Apr-19,1,1,0
15826,user_15826,54,8,8,0,Nov-18,6,0,0
15827,user_15827,3095,116,46,70,Apr-19,1,1,0
15828,user_15828,2573,29,21,8,Feb-19,3,0,0
15829,user_15829,19812,269,27,242,May-19,0,1,1
15830,user_15830,93,31,8,23,May-19,0,1,1
15831,user_15831,211,4,4,0,Dec-18,5,0,0
15833,user_15833,9082,444,31,413,May-19,0,1,1
15834,user_15834,30,6,3,3,Apr-19,1,1,0
15835,user_15835,1570,16,1,15,Apr-19,1,1,0
15836,user_15836,4402,66,57,9,Mar-19,2,0,0
15837,user_15837,18,4,3,1,Feb-19,3,0,0
15838,user_15838,1119,12,0,12,May-19,0,1,1
15839,user_15839,1827,23,5,18,May-19,0,1,1
15840,user_15840,9,2,2,0,Dec-18,5,0,0
15841,user_15841,298,15,8,7,Feb-19,3,0,0
15842,user_15842,270,24,24,0,Dec-18,5,0,0
15843,user_15843,1358,43,43,0,Dec-18,5,0,0
15844,user_15844,6541,119,6,113,May-19,0,1,1
15845,user_15845,14059,541,96,445,May-19,0,1,1
15846,user_15846,206,13,2,11,Apr-19,1,1,0
15847,user_15847,254,9,0,9,May-19,0,1,1
15848,user_15848,1010,57,16,41,Apr-19,1,1,0
15849,user_15849,2409,16,4,12,May-19,0,1,1
15850,user_15850,4859,63,34,29,Apr-19,1,1,0
15851,user_15851,123,71,50,21,May-19,0,1,1
15852,user_15852,8,3,3,0,Dec-18,5,0,0
15853,user_15853,7411,115,33,82,May-19,0,1,1
15854,user_15854,899,30,10,20,May-19,0,1,1
15855,user_15855,14326,741,114,627,May-19,0,1,1
15856,user_15856,213,12,12,0,Dec-18,5,0,0
15857,user_15857,201772,575,130,445,May-19,0,1,1
15858,user_15858,19,4,3,1,Apr-19,1,1,0
15859,user_15859,5900,272,53,219,May-19,0,1,1
15861,user_15861,318,28,8,20,May-19,0,1,1
15863,user_15863,358,30,27,3,May-19,0,1,1
15865,user_15865,2816,80,5,75,May-19,0,1,1
15866,user_15866,0,1,0,1,Jan-19,4,0,0
15867,user_15867,2992,182,5,177,May-19,0,1,1
15868,user_15868,1913,73,6,67,May-19,0,1,1
15869,user_15869,4080,170,13,157,May-19,0,1,1
15870,user_15870,4208,22,22,0,Dec-18,5,0,0
15871,user_15871,1905,95,64,31,Feb-19,3,0,0
15872,user_15872,166,10,0,10,May-19,0,1,1
15873,user_15873,14,3,3,0,Nov-18,6,0,0
15874,user_15874,147,12,12,0,Dec-18,5,0,0
15875,user_15875,82,6,3,3,Jan-19,4,0,0
15876,user_15876,452,17,1,16,May-19,0,0,1
15877,user_15877,3689,38,2,36,Mar-19,2,0,0
15878,user_15878,44082,887,159,728,May-19,0,1,1
15879,user_15879,9,2,2,0,Nov-18,6,0,0
15880,user_15880,56,4,0,4,Apr-19,1,1,0
15881,user_15881,297,12,8,4,Apr-19,1,1,0
15882,user_15882,32,6,6,0,Nov-18,6,0,0
15883,user_15883,2872,39,17,22,Mar-19,2,0,0
15884,user_15884,2733,69,8,61,May-19,0,1,1
15885,user_15885,2108,34,6,28,Apr-19,1,1,0
15886,user_15886,2225,24,6,18,Apr-19,1,1,0
15887,user_15887,13209,63,25,38,May-19,0,1,1
15888,user_15888,1567,49,7,42,May-19,0,1,1
15889,user_15889,2805,111,105,6,Mar-19,2,0,0
15890,user_15890,422,35,8,27,May-19,0,1,1
15891,user_15891,6676,213,41,172,May-19,0,1,1
15892,user_15892,53,18,11,7,Jan-19,4,0,0
15893,user_15893,3292,99,4,95,Apr-19,1,1,0
15894,user_15894,7484,300,10,290,May-19,0,1,1
15895,user_15895,1453,20,5,15,May-19,0,0,1
15896,user_15896,654,31,16,15,May-19,0,1,1
15898,user_15898,12775,180,3,177,May-19,0,1,1
15899,user_15899,435,31,19,12,May-19,0,1,1
15900,user_15900,499,18,1,17,Mar-19,2,0,0
15901,user_15901,4438,63,10,53,Mar-19,2,0,0
15902,user_15902,809920,242,47,195,May-19,0,1,1
15903,user_15903,16,10,4,6,Mar-19,2,0,0
15904,user_15904,827,24,9,15,Feb-19,3,0,0
15905,user_15905,140,8,2,6,May-19,0,1,1
15906,user_15906,8463,89,9,80,Apr-19,1,1,0
15907,user_15907,4803,113,37,76,May-19,0,1,1
15908,user_15908,813,111,75,36,May-19,0,1,1
15909,user_15909,4,2,2,0,Dec-18,5,0,0
15910,user_15910,6165,166,82,84,May-19,0,1,1
15911,user_15911,4894,52,20,32,May-19,0,1,1
15912,user_15912,296,22,14,8,May-19,0,0,1
15913,user_15913,663,18,18,0,Nov-18,6,0,0
15914,user_15914,1562,35,3,32,Apr-19,1,1,0
15915,user_15915,1483,41,36,5,Apr-19,1,1,0
15917,user_15917,9494,130,19,111,May-19,0,1,1
15918,user_15918,5542,199,74,125,Apr-19,1,1,0
15919,user_15919,31480,78,36,42,May-19,0,1,1
15920,user_15920,714,43,11,32,May-19,0,1,1
15921,user_15921,5193,70,6,64,May-19,0,1,1
15922,user_15922,4087,113,4,109,May-19,0,1,1
15923,user_15923,710,27,15,12,May-19,0,1,1
15924,user_15924,1227,23,12,11,Jan-19,4,0,0
15925,user_15925,1228,19,17,2,May-19,0,0,1
15926,user_15926,16,3,3,0,Nov-18,6,0,0
15927,user_15927,4930,80,11,69,Apr-19,1,1,0
15928,user_15928,1613,41,16,25,Jan-19,4,0,0
15929,user_15929,3757,230,48,182,May-19,0,1,1
15930,user_15930,52,4,2,2,Mar-19,2,0,0
15931,user_15931,13927,40,13,27,Apr-19,1,1,0
15933,user_15933,53,13,9,4,Mar-19,2,0,0
15934,user_15934,36620,894,90,804,May-19,0,1,1
15935,user_15935,1773,80,71,9,Jan-19,4,0,0
15936,user_15936,19970,271,78,193,May-19,0,1,1
15937,user_15937,1052,20,19,1,Jan-19,4,0,0
15938,user_15938,2204,208,5,203,May-19,0,1,1
15939,user_15939,15099,385,1,384,May-19,0,1,1
15940,user_15940,43,1,1,0,Nov-18,6,0,0
15941,user_15941,1847,90,50,40,May-19,0,1,1
15942,user_15942,192,19,7,12,May-19,0,1,1
15943,user_15943,1462,43,24,19,Apr-19,1,1,0
15944,user_15944,7959,201,61,140,May-19,0,1,1
15945,user_15945,11046,869,14,855,May-19,0,1,1
15946,user_15946,330776,2894,516,2378,May-19,0,1,1
15947,user_15947,9,2,1,1,Feb-19,3,0,0
15948,user_15948,39522,2187,471,1716,May-19,0,1,1
15949,user_15949,12,6,3,3,Feb-19,3,0,0
15950,user_15950,388,60,4,56,Apr-19,1,1,0
15952,user_15952,330,22,4,18,Apr-19,1,1,0
15953,user_15953,564,33,13,20,Apr-19,1,1,0
15954,user_15954,18761,118,10,108,May-19,0,1,1
15955,user_15955,12056,81,25,56,May-19,0,1,1
15956,user_15956,1589,42,11,31,May-19,0,1,1
15957,user_15957,131,22,4,18,Mar-19,2,0,0
15958,user_15958,5361,181,17,164,May-19,0,1,1
15959,user_15959,15726,380,137,243,May-19,0,1,1
15960,user_15960,9,2,2,0,Dec-18,5,0,0
15961,user_15961,6458,397,102,295,May-19,0,1,1
15962,user_15962,859,17,7,10,Mar-19,2,0,0
15963,user_15963,492,39,4,35,May-19,0,1,1
15964,user_15964,656,16,16,0,Nov-18,6,0,0
15965,user_15965,6625,88,25,63,May-19,0,1,1
15966,user_15966,7225,305,3,302,May-19,0,1,1
15968,user_15968,140,27,5,22,Mar-19,2,0,0
15969,user_15969,1576,78,25,53,Mar-19,2,0,0
15970,user_15970,2454,32,16,16,Apr-19,1,1,0
15971,user_15971,9,2,2,0,Nov-18,6,0,0
15972,user_15972,24411,330,40,290,May-19,0,1,1
15973,user_15973,1747,75,9,66,May-19,0,1,1
15974,user_15974,2485,22,1,21,May-19,0,1,1
15975,user_15975,11,2,2,0,Nov-18,6,0,0
15976,user_15976,7837,111,35,76,May-19,0,1,1
15977,user_15977,15947,34,22,12,Apr-19,1,1,0
15978,user_15978,876,49,1,48,Apr-19,1,1,0
15979,user_15979,56720,217,45,172,May-19,0,1,1
15980,user_15980,3852,8,2,6,May-19,0,1,1
15981,user_15981,9,2,2,0,Dec-18,5,0,0
15982,user_15982,290,7,5,2,Mar-19,2,0,0
15983,user_15983,7594,117,3,114,May-19,0,1,1
15984,user_15984,8477,500,52,448,May-19,0,1,1
15985,user_15985,1844,88,15,73,May-19,0,1,1
15988,user_15988,466,11,7,4,May-19,0,1,1
15989,user_15989,116,6,3,3,Jan-19,4,0,0
15990,user_15990,55,5,3,2,Apr-19,1,1,0
15991,user_15991,19,3,3,0,Nov-18,6,0,0
15992,user_15992,16,3,3,0,Nov-18,6,0,0
15993,user_15993,3983,57,26,31,May-19,0,1,1
15994,user_15994,244,18,13,5,Feb-19,3,0,0
15995,user_15995,7912,268,47,221,May-19,0,1,1
15996,user_15996,6,4,3,1,Apr-19,1,1,0
15997,user_15997,8373,145,12,133,May-19,0,1,1
15998,user_15998,358,15,6,9,May-19,0,1,1
15999,user_15999,291,9,3,6,Apr-19,1,1,0
16000,user_16000,1794,191,34,157,May-19,0,1,1
16001,user_16001,2138,169,65,104,Apr-19,1,1,0
16002,user_16002,513,52,20,32,May-19,0,0,1
16003,user_16003,21619,237,11,226,May-19,0,1,1
16004,user_16004,3447,89,62,27,Apr-19,1,1,0
16005,user_16005,49,6,2,4,Feb-19,3,0,0
16006,user_16006,626,65,6,59,May-19,0,1,1
16007,user_16007,6847,72,20,52,May-19,0,1,1
16008,user_16008,210,34,17,17,May-19,0,1,1
16009,user_16009,9,2,2,0,Dec-18,5,0,0
16010,user_16010,4792,255,2,253,May-19,0,1,1
16012,user_16012,1760,86,3,83,May-19,0,1,1
16013,user_16013,809,21,5,16,Mar-19,2,0,0
16014,user_16014,21,2,2,0,Nov-18,6,0,0
16015,user_16015,31448,59,4,55,May-19,0,1,1
16016,user_16016,648,33,26,7,Mar-19,2,0,0
16017,user_16017,2762,163,19,144,May-19,0,1,1
16018,user_16018,2089,112,83,29,Feb-19,3,0,0
16019,user_16019,3671,67,21,46,May-19,0,1,1
16020,user_16020,101,13,9,4,May-19,0,1,1
16021,user_16021,20,3,3,0,Dec-18,5,0,0
16022,user_16022,9,2,2,0,Dec-18,5,0,0
16023,user_16023,334,16,16,0,Dec-18,5,0,0
16024,user_16024,623,24,1,23,Apr-19,1,1,0
16025,user_16025,1531,73,3,70,May-19,0,1,1
16026,user_16026,9628,116,19,97,May-19,0,1,1
16027,user_16027,1001,38,19,19,May-19,0,1,1
16028,user_16028,542,35,2,33,Apr-19,1,1,0
16029,user_16029,3,3,2,1,Jan-19,4,0,0
16030,user_16030,1413,44,37,7,May-19,0,0,1
16031,user_16031,8966,240,35,205,May-19,0,1,1
16032,user_16032,2625,95,22,73,Apr-19,1,1,0
16033,user_16033,1339,192,64,128,May-19,0,1,1
16034,user_16034,21,3,2,1,Jan-19,4,0,0
16035,user_16035,1007,38,37,1,Jan-19,4,0,0
16036,user_16036,985,33,12,21,May-19,0,1,1
16037,user_16037,1100,38,6,32,Apr-19,1,1,0
16038,user_16038,692,21,4,17,Feb-19,3,0,0
16039,user_16039,5750,71,29,42,May-19,0,1,1
16040,user_16040,56899,695,200,495,May-19,0,1,1
16041,user_16041,6866,44,34,10,Apr-19,1,1,0
16042,user_16042,7426,372,294,78,May-19,0,1,1
16043,user_16043,225,6,4,2,Apr-19,1,1,0
16044,user_16044,5209,195,48,147,May-19,0,1,1
16045,user_16045,384,35,3,32,Apr-19,1,1,0
16046,user_16046,1085,21,9,12,Mar-19,2,0,0
16047,user_16047,8533,116,13,103,May-19,0,1,1
16048,user_16048,1239,28,28,0,Nov-18,6,0,0
16049,user_16049,1847,66,7,59,May-19,0,1,1
16050,user_16050,33,3,2,1,Jan-19,4,0,0
16051,user_16051,2800,23,4,19,Mar-19,2,0,0
16052,user_16052,1343,30,25,5,Mar-19,2,0,0
16054,user_16054,1086,50,27,23,Apr-19,1,1,0
16055,user_16055,4092,170,51,119,May-19,0,1,1
16057,user_16057,20,6,0,6,May-19,0,0,1
16058,user_16058,502,26,3,23,May-19,0,1,1
16059,user_16059,1,1,1,0,Dec-18,5,0,0
16060,user_16060,1823,29,2,27,May-19,0,1,1
16061,user_16061,19,13,7,6,Feb-19,3,0,0
16062,user_16062,85,9,9,0,Dec-18,5,0,0
16063,user_16063,9781,28,3,25,May-19,0,1,1
16064,user_16064,76,12,12,0,Dec-18,5,0,0
16065,user_16065,1675,39,14,25,May-19,0,1,1
16066,user_16066,1183,92,24,68,May-19,0,1,1
16069,user_16069,95,12,2,10,Mar-19,2,0,0
16070,user_16070,28,10,2,8,Feb-19,3,0,0
16071,user_16071,2493,61,27,34,Apr-19,1,1,0
16072,user_16072,2659,19,10,9,Jan-19,4,0,0
16073,user_16073,2102,29,0,29,May-19,0,1,1
16075,user_16075,735,86,27,59,May-19,0,1,1
16076,user_16076,16392,946,2,944,May-19,0,1,1
16077,user_16077,14,3,3,0,Nov-18,6,0,0
16078,user_16078,201,8,8,0,Dec-18,5,0,0
16079,user_16079,5176,247,71,176,Apr-19,1,1,0
16080,user_16080,7525,215,22,193,May-19,0,1,1
16081,user_16081,137,18,4,14,Mar-19,2,0,0
16082,user_16082,26,4,4,0,Nov-18,6,0,0
16083,user_16083,134,4,0,4,Apr-19,1,1,0
16084,user_16084,545,16,16,0,Dec-18,5,0,0
16085,user_16085,2911,69,23,46,May-19,0,1,1
16086,user_16086,3297,79,12,67,May-19,0,1,1
16087,user_16087,465011,150,59,91,May-19,0,1,1
16088,user_16088,700,6,2,4,Apr-19,1,1,0
16089,user_16089,1036,64,12,52,May-19,0,1,1
16090,user_16090,324,49,27,22,Apr-19,1,1,0
16091,user_16091,1011,40,7,33,Feb-19,3,0,0
16092,user_16092,1664,75,55,20,Apr-19,1,1,0
16093,user_16093,174,25,10,15,Apr-19,1,1,0
16094,user_16094,336,21,9,12,May-19,0,1,1
16095,user_16095,1588,73,6,67,May-19,0,1,1
16096,user_16096,179,33,0,33,May-19,0,1,1
16098,user_16098,15,4,3,1,Apr-19,1,1,0
16099,user_16099,3555,45,14,31,Feb-19,3,0,0
16100,user_16100,1722,55,10,45,Apr-19,1,1,0
16101,user_16101,3629,72,38,34,May-19,0,1,1
16102,user_16102,863,16,4,12,Mar-19,2,0,0
16103,user_16103,18,3,3,0,Dec-18,5,0,0
16104,user_16104,2170,65,11,54,May-19,0,1,1
16105,user_16105,23159,178,33,145,May-19,0,1,1
16106,user_16106,5067,132,21,111,May-19,0,1,1
16107,user_16107,5154,49,35,14,Mar-19,2,0,0
16108,user_16108,3011,64,21,43,May-19,0,1,1
16109,user_16109,410,15,6,9,Mar-19,2,0,0
16110,user_16110,2039,75,30,45,May-19,0,0,1
16111,user_16111,101,3,0,3,Jan-19,4,0,0
16112,user_16112,273,6,4,2,May-19,0,0,1
16114,user_16114,264,34,6,28,Apr-19,1,1,0
16115,user_16115,3158,26,9,17,Jan-19,4,0,0
16116,user_16116,1698,41,10,31,May-19,0,1,1
16117,user_16117,4391,176,10,166,May-19,0,1,1
16118,user_16118,24586,394,91,303,May-19,0,1,1
16119,user_16119,399,26,2,24,Apr-19,1,1,0
16120,user_16120,672,35,8,27,May-19,0,1,1
16121,user_16121,21,3,3,0,Nov-18,6,0,0
16122,user_16122,1639,28,6,22,Apr-19,1,1,0
16123,user_16123,2152,221,25,196,May-19,0,1,1
16124,user_16124,2661,177,15,162,May-19,0,1,1
16125,user_16125,152,54,12,42,May-19,0,1,1
16127,user_16127,3623,269,63,206,May-19,0,1,1
16128,user_16128,1895,163,2,161,May-19,0,1,1
16129,user_16129,8476,450,13,437,May-19,0,1,1
16130,user_16130,19,3,3,0,Nov-18,6,0,0
16131,user_16131,1868,133,52,81,May-19,0,1,1
16132,user_16132,1183,109,78,31,Apr-19,1,1,0
16134,user_16134,233,19,4,15,Apr-19,1,1,0
16135,user_16135,80,6,4,2,Apr-19,1,1,0
16136,user_16136,2235,108,7,101,May-19,0,1,1
16138,user_16138,2762,67,10,57,Apr-19,1,1,0
16139,user_16139,4382,60,18,42,May-19,0,1,1
16140,user_16140,2871,76,7,69,Mar-19,2,0,0
16141,user_16141,59,26,11,15,Mar-19,2,0,0
16144,user_16144,18915,841,90,751,May-19,0,1,1
16145,user_16145,9534,84,8,76,May-19,0,1,1
16147,user_16147,12645,156,57,99,May-19,0,1,1
16148,user_16148,13,4,4,0,Nov-18,6,0,0
16149,user_16149,54120,256,39,217,May-19,0,1,1
16150,user_16150,4,2,2,0,Nov-18,6,0,0
16151,user_16151,3168,93,23,70,May-19,0,1,1
16153,user_16153,1778,143,13,130,May-19,0,1,1
16154,user_16154,394,21,2,19,May-19,0,1,1
16155,user_16155,8,2,1,1,Apr-19,1,1,0
16157,user_16157,3820,34,24,10,Jan-19,4,0,0
16158,user_16158,2201,14,7,7,Mar-19,2,0,0
16159,user_16159,830,48,10,38,May-19,0,1,1
16160,user_16160,154,8,3,5,Feb-19,3,0,0
16161,user_16161,2488,51,9,42,May-19,0,1,1
16162,user_16162,6806,229,7,222,May-19,0,1,1
16163,user_16163,724,37,19,18,Mar-19,2,0,0
16164,user_16164,1543,49,17,32,May-19,0,1,1
16165,user_16165,18484,127,8,119,May-19,0,1,1
16167,user_16167,717,27,7,20,Mar-19,2,0,0
16168,user_16168,18,1,1,0,Nov-18,6,0,0
16169,user_16169,2120,302,7,295,May-19,0,1,1
16170,user_16170,268,37,19,18,Apr-19,1,1,0
16171,user_16171,17579,541,83,458,May-19,0,1,1
16172,user_16172,2076,101,0,101,May-19,0,1,1
16173,user_16173,12644,399,99,300,May-19,0,1,1
16174,user_16174,4206,109,15,94,May-19,0,1,1
16175,user_16175,330,42,10,32,May-19,0,1,1
16177,user_16177,17,2,2,0,Nov-18,6,0,0
16178,user_16178,639,52,0,52,Apr-19,1,1,0
16179,user_16179,841,21,5,16,Apr-19,1,1,0
16180,user_16180,7971,32,10,22,Feb-19,3,0,0
16181,user_16181,411,14,14,0,Dec-18,5,0,0
16182,user_16182,1095,15,2,13,Mar-19,2,0,0
16183,user_16183,9297,221,2,219,May-19,0,1,1
16184,user_16184,489,27,2,25,Feb-19,3,0,0
16185,user_16185,5787,95,89,6,May-19,0,0,1
16186,user_16186,33533,83,30,53,Mar-19,2,0,0
16187,user_16187,442,24,20,4,Mar-19,2,0,0
16188,user_16188,58,5,3,2,May-19,0,0,1
16189,user_16189,1031,23,13,10,Apr-19,1,1,0
16190,user_16190,974,63,20,43,May-19,0,1,1
16191,user_16191,3585,181,58,123,May-19,0,1,1
16192,user_16192,31,11,3,8,Apr-19,1,1,0
16193,user_16193,1124,45,3,42,Mar-19,2,0,0
16194,user_16194,6613,141,44,97,May-19,0,1,1
16195,user_16195,1110,27,4,23,Apr-19,1,1,0
16196,user_16196,178,17,2,15,Apr-19,1,1,0
16197,user_16197,10085,193,43,150,May-19,0,1,1
16198,user_16198,27541,238,12,226,May-19,0,1,1
16199,user_16199,11,2,2,0,Nov-18,6,0,0
16200,user_16200,2499,43,21,22,Feb-19,3,0,0
16201,user_16201,328,49,9,40,May-19,0,1,1
16202,user_16202,19,3,1,2,Mar-19,2,0,0
16203,user_16203,4062,130,29,101,May-19,0,1,1
16204,user_16204,1182,51,26,25,May-19,0,1,1
16205,user_16205,544,13,4,9,Apr-19,1,1,0
16206,user_16206,700,25,2,23,May-19,0,1,1
16207,user_16207,2237,65,7,58,May-19,0,1,1
16208,user_16208,64,6,3,3,Jan-19,4,0,0
16209,user_16209,6551,433,12,421,May-19,0,1,1
16210,user_16210,2694,37,37,0,Dec-18,5,0,0
16211,user_16211,428,40,6,34,May-19,0,1,1
16212,user_16212,5193,123,24,99,Apr-19,1,1,0
16213,user_16213,818,55,35,20,Jan-19,4,0,0
16214,user_16214,902,30,18,12,May-19,0,1,1
16215,user_16215,656,30,25,5,Jan-19,4,0,0
16216,user_16216,8314,130,59,71,Apr-19,1,1,0
16218,user_16218,1013,77,15,62,Apr-19,1,1,0
16219,user_16219,2155,29,8,21,May-19,0,1,1
16220,user_16220,18,7,6,1,Jan-19,4,0,0
16221,user_16221,1481,11,3,8,Apr-19,1,1,0
16222,user_16222,61,5,5,0,Nov-18,6,0,0
16223,user_16223,77,8,5,3,May-19,0,1,1
16224,user_16224,1286,41,6,35,Mar-19,2,0,0
16225,user_16225,8694,77,40,37,Apr-19,1,1,0
16226,user_16226,259,26,3,23,May-19,0,1,1
16227,user_16227,9,2,2,0,Nov-18,6,0,0
16229,user_16229,2667,128,43,85,May-19,0,1,1
16230,user_16230,248,63,52,11,Jan-19,4,0,0
16231,user_16231,3285,240,40,200,May-19,0,1,1
16232,user_16232,5460,76,19,57,Apr-19,1,1,0
16233,user_16233,9,2,2,0,Nov-18,6,0,0
16234,user_16234,4988,50,0,50,Apr-19,1,1,0
16235,user_16235,2984,134,44,90,Mar-19,2,0,0
16236,user_16236,13,3,3,0,Nov-18,6,0,0
16237,user_16237,5216,92,37,55,Apr-19,1,1,0
16238,user_16238,1824,33,27,6,May-19,0,1,1
16239,user_16239,4174,139,10,129,May-19,0,1,1
16240,user_16240,3050,180,7,173,May-19,0,1,1
16241,user_16241,2486,74,3,71,Apr-19,1,1,0
16242,user_16242,32,15,12,3,Mar-19,2,0,0
16243,user_16243,7773,456,41,415,May-19,0,1,1
16244,user_16244,4070,106,10,96,Apr-19,1,1,0
16245,user_16245,7,4,2,2,Apr-19,1,1,0
16247,user_16247,4138,49,15,34,Apr-19,1,1,0
16248,user_16248,1302,35,23,12,Apr-19,1,1,0
16249,user_16249,2839,275,118,157,May-19,0,1,1
16251,user_16251,6703,72,8,64,Apr-19,1,1,0
16252,user_16252,11,2,2,0,Nov-18,6,0,0
16253,user_16253,698,47,17,30,May-19,0,1,1
16254,user_16254,2154,95,5,90,May-19,0,1,1
16255,user_16255,4,3,3,0,Dec-18,5,0,0
16256,user_16256,1454,74,18,56,Apr-19,1,1,0
16257,user_16257,542,29,5,24,Apr-19,1,1,0
16258,user_16258,206,10,10,0,Dec-18,5,0,0
16259,user_16259,4863,88,65,23,Jan-19,4,0,0
16260,user_16260,8,2,1,1,Jan-19,4,0,0
16261,user_16261,6821,44,0,44,Apr-19,1,1,0
16262,user_16262,8500,314,67,247,May-19,0,1,1
16263,user_16263,713,22,22,0,Dec-18,5,0,0
16264,user_16264,578,53,6,47,Apr-19,1,1,0
16265,user_16265,1074,31,11,20,May-19,0,0,1
16266,user_16266,2212,89,3,86,May-19,0,1,1
16267,user_16267,4020,7,7,0,Dec-18,5,0,0
16268,user_16268,2247,80,19,61,May-19,0,1,1
16269,user_16269,4270,195,2,193,May-19,0,1,1
16270,user_16270,12619,338,3,335,May-19,0,1,1
16271,user_16271,1972,56,8,48,May-19,0,1,1
16272,user_16272,1683,64,18,46,May-19,0,1,1
16273,user_16273,2413,67,2,65,May-19,0,1,1
16275,user_16275,2026,27,11,16,Mar-19,2,0,0
16276,user_16276,2651,47,17,30,Apr-19,1,1,0
16277,user_16277,1578,34,3,31,Apr-19,1,1,0
16278,user_16278,441,18,16,2,Apr-19,1,1,0
16279,user_16279,7470,90,16,74,May-19,0,1,1
16280,user_16280,45,6,3,3,Mar-19,2,0,0
16281,user_16281,19082,78,30,48,May-19,0,1,1
16282,user_16282,10301,514,38,476,May-19,0,1,1
16283,user_16283,33,4,4,0,Nov-18,6,0,0
16284,user_16284,18,3,0,3,Apr-19,1,1,0
16285,user_16285,5774,47,13,34,May-19,0,1,1
16286,user_16286,1455,77,4,73,May-19,0,1,1
16287,user_16287,361,113,0,113,May-19,0,1,1
16288,user_16288,543,14,13,1,Jan-19,4,0,0
16289,user_16289,150,5,2,3,Mar-19,2,0,0
16290,user_16290,1269,46,18,28,Feb-19,3,0,0
16291,user_16291,4,2,2,0,Nov-18,6,0,0
16292,user_16292,484,25,1,24,May-19,0,1,1
16293,user_16293,6607,164,74,90,Apr-19,1,1,0
16294,user_16294,3075,80,2,78,May-19,0,1,1
16295,user_16295,1032,42,35,7,Jan-19,4,0,0
16296,user_16296,52,6,4,2,Jan-19,4,0,0
16297,user_16297,1056,14,3,11,Apr-19,1,1,0
16298,user_16298,114,20,5,15,Apr-19,1,1,0
16299,user_16299,2419,201,0,201,Apr-19,1,1,0
16300,user_16300,1690,89,14,75,May-19,0,1,1
16301,user_16301,2476,108,18,90,May-19,0,1,1
16302,user_16302,154,4,4,0,Nov-18,6,0,0
16303,user_16303,9089,57,11,46,May-19,0,1,1
16304,user_16304,1063,26,16,10,Mar-19,2,0,0
16305,user_16305,35,5,5,0,Dec-18,5,0,0
16306,user_16306,290,42,8,34,Apr-19,1,1,0
16307,user_16307,650,85,27,58,Apr-19,1,1,0
16308,user_16308,90,8,8,0,Nov-18,6,0,0
16309,user_16309,17,1,1,0,Dec-18,5,0,0
16310,user_16310,18,3,3,0,Nov-18,6,0,0
16311,user_16311,4951,11,9,2,Feb-19,3,0,0
16312,user_16312,6037,167,0,167,May-19,0,1,1
16313,user_16313,224,11,6,5,Jan-19,4,0,0
16314,user_16314,11,2,2,0,Nov-18,6,0,0
16315,user_16315,471,30,4,26,May-19,0,1,1
16316,user_16316,13304,25,7,18,May-19,0,1,1
16317,user_16317,77,2,2,0,Dec-18,5,0,0
16318,user_16318,4207,242,7,235,May-19,0,1,1
16319,user_16319,44370,300,46,254,May-19,0,1,1
16320,user_16320,395,11,11,0,Nov-18,6,0,0
16321,user_16321,20,3,0,3,Feb-19,3,0,0
16322,user_16322,26,5,5,0,Nov-18,6,0,0
16323,user_16323,61,24,3,21,Apr-19,1,1,0
16324,user_16324,174,9,6,3,May-19,0,0,1
16325,user_16325,740,18,5,13,Apr-19,1,1,0
16326,user_16326,1675,11,6,5,Jan-19,4,0,0
16327,user_16327,4756,97,35,62,May-19,0,1,1
16328,user_16328,2534,45,9,36,May-19,0,1,1
16329,user_16329,1300,40,3,37,May-19,0,0,1
16330,user_16330,1606,68,20,48,Feb-19,3,0,0
16331,user_16331,409,19,8,11,Apr-19,1,1,0
16332,user_16332,18,8,8,0,Nov-18,6,0,0
16333,user_16333,566,21,3,18,Jan-19,4,0,0
16334,user_16334,12847,192,77,115,May-19,0,1,1
16335,user_16335,1167,53,10,43,May-19,0,1,1
16336,user_16336,12514,315,132,183,May-19,0,1,1
16337,user_16337,146,9,2,7,Feb-19,3,0,0
16338,user_16338,12,7,4,3,Mar-19,2,0,0
16339,user_16339,4014,112,1,111,Apr-19,1,1,0
16340,user_16340,328,8,8,0,Dec-18,5,0,0
16341,user_16341,6067,227,21,206,May-19,0,1,1
16342,user_16342,9,2,2,0,Nov-18,6,0,0
16343,user_16343,1405,46,3,43,Apr-19,1,1,0
16344,user_16344,9,1,1,0,Nov-18,6,0,0
16345,user_16345,51,2,2,0,Nov-18,6,0,0
16346,user_16346,1462,63,46,17,May-19,0,1,1
16347,user_16347,3724,22,3,19,Jan-19,4,0,0
16348,user_16348,4,1,1,0,Dec-18,5,0,0
16349,user_16349,76,7,3,4,Apr-19,1,1,0
16351,user_16351,10021,372,22,350,May-19,0,1,1
16352,user_16352,10147,491,82,409,May-19,0,1,1
16353,user_16353,6431,562,60,502,May-19,0,1,1
16354,user_16354,4518,45,0,45,Apr-19,1,1,0
16355,user_16355,14219,226,52,174,May-19,0,1,1
16356,user_16356,36,17,10,7,Mar-19,2,0,0
16357,user_16357,3616,108,4,104,May-19,0,1,1
16358,user_16358,1152,35,2,33,Mar-19,2,0,0
16359,user_16359,8353,40,17,23,May-19,0,1,1
16360,user_16360,14,3,1,2,Feb-19,3,0,0
16361,user_16361,23909,325,44,281,May-19,0,1,1
16362,user_16362,333,12,12,0,Dec-18,5,0,0
16363,user_16363,3327,26,2,24,May-19,0,1,1
16364,user_16364,3944,44,5,39,May-19,0,1,1
16365,user_16365,1519,31,28,3,Mar-19,2,0,0
16366,user_16366,113,15,10,5,Apr-19,1,1,0
16367,user_16367,13,7,0,7,May-19,0,1,1
16368,user_16368,1418,68,37,31,May-19,0,1,1
16369,user_16369,16827,50,18,32,Apr-19,1,1,0
16370,user_16370,435,33,12,21,Apr-19,1,1,0
16371,user_16371,4053,174,103,71,May-19,0,1,1
16372,user_16372,16628,471,170,301,May-19,0,1,1
16373,user_16373,8420,287,33,254,May-19,0,1,1
16374,user_16374,502,32,2,30,May-19,0,1,1
16375,user_16375,682,61,22,39,Apr-19,1,1,0
16376,user_16376,4905,244,94,150,May-19,0,1,1
16377,user_16377,343,15,15,0,Dec-18,5,0,0
16378,user_16378,820,91,8,83,May-19,0,1,1
16380,user_16380,13671,84,20,64,May-19,0,1,1
16381,user_16381,63267,1523,197,1326,May-19,0,1,1
16382,user_16382,1930,95,31,64,May-19,0,1,1
16383,user_16383,85,14,11,3,Apr-19,1,1,0
16384,user_16384,35,5,3,2,Jan-19,4,0,0
16385,user_16385,39,5,0,5,Apr-19,1,1,0
16386,user_16386,1933,37,27,10,Feb-19,3,0,0
16387,user_16387,2322,122,19,103,May-19,0,1,1
16388,user_16388,6702,66,52,14,Mar-19,2,0,0
16389,user_16389,6571,136,37,99,May-19,0,1,1
16390,user_16390,961,52,8,44,May-19,0,1,1
16391,user_16391,183,18,2,16,Apr-19,1,1,0
16392,user_16392,353,13,9,4,Apr-19,1,1,0
16393,user_16393,13581,26,10,16,May-19,0,1,1
16394,user_16394,114,5,0,5,Mar-19,2,0,0
16395,user_16395,30,2,0,2,Mar-19,2,0,0
16396,user_16396,320,8,0,8,Apr-19,1,1,0
16397,user_16397,12705,59,19,40,May-19,0,1,1
16398,user_16398,71,6,3,3,Feb-19,3,0,0
16399,user_16399,1183,28,23,5,Feb-19,3,0,0
16400,user_16400,123,45,8,37,Apr-19,1,1,0
16401,user_16401,1586,7,7,0,Dec-18,5,0,0
16402,user_16402,2071,35,19,16,May-19,0,1,1
16403,user_16403,13682,84,18,66,May-19,0,1,1
16404,user_16404,21,5,3,2,Mar-19,2,0,0
16405,user_16405,27830,278,3,275,May-19,0,1,1
16406,user_16406,4362,92,43,49,May-19,0,1,1
16407,user_16407,9558,35,0,35,May-19,0,0,1
16409,user_16409,0,2,2,0,Nov-18,6,0,0
16410,user_16410,7324,384,6,378,May-19,0,1,1
16411,user_16411,8804,155,37,118,May-19,0,1,1
16412,user_16412,4851,189,15,174,May-19,0,1,1
16413,user_16413,1257,100,22,78,May-19,0,1,1
16415,user_16415,4376,16,9,7,Apr-19,1,1,0
16416,user_16416,4,5,5,0,Nov-18,6,0,0
16417,user_16417,14819,8,2,6,Apr-19,1,1,0
16418,user_16418,2814,53,17,36,Apr-19,1,1,0
16419,user_16419,4,3,3,0,Nov-18,6,0,0
16420,user_16420,1167,60,4,56,Feb-19,3,0,0
16421,user_16421,4958,201,5,196,May-19,0,1,1
16422,user_16422,557,30,29,1,Mar-19,2,0,0
16423,user_16423,36,6,6,0,Dec-18,5,0,0
16424,user_16424,620,20,4,16,May-19,0,1,1
16425,user_16425,8,3,3,0,Nov-18,6,0,0
16426,user_16426,4625,110,29,81,Mar-19,2,0,0
16427,user_16427,3378,84,24,60,May-19,0,1,1
16428,user_16428,3437,184,2,182,May-19,0,1,1
16429,user_16429,460,42,16,26,May-19,0,1,1
16430,user_16430,32379,243,8,235,May-19,0,1,1
16431,user_16431,176,6,1,5,May-19,0,0,1
16432,user_16432,5159,430,40,390,May-19,0,1,1
16433,user_16433,21,16,4,12,Apr-19,1,1,0
16434,user_16434,678,64,5,59,May-19,0,1,1
16435,user_16435,2015,31,24,7,Mar-19,2,0,0
16436,user_16436,923,11,2,9,Mar-19,2,0,0
16437,user_16437,6031,86,29,57,May-19,0,1,1
16438,user_16438,42,6,3,3,Feb-19,3,0,0
16439,user_16439,418,51,42,9,Mar-19,2,0,0
16440,user_16440,170,14,0,14,Feb-19,3,0,0
16441,user_16441,1145,9,9,0,Nov-18,6,0,0
16442,user_16442,16931,297,3,294,May-19,0,1,1
16443,user_16443,61,13,4,9,May-19,0,1,1
16444,user_16444,36,4,4,0,Dec-18,5,0,0
16445,user_16445,12624,168,6,162,May-19,0,1,1
16446,user_16446,2243,103,77,26,May-19,0,1,1
16447,user_16447,66323,928,63,865,May-19,0,1,1
16448,user_16448,4221,167,42,125,Apr-19,1,1,0
16449,user_16449,4556,271,34,237,May-19,0,1,1
16450,user_16450,121,23,0,23,Apr-19,1,1,0
16451,user_16451,1642,137,89,48,May-19,0,1,1
16452,user_16452,9132,15,5,10,Apr-19,1,1,0
16453,user_16453,7153,260,45,215,May-19,0,1,1
16454,user_16454,13,4,2,2,Jan-19,4,0,0
16456,user_16456,11,2,2,0,Dec-18,5,0,0
16457,user_16457,17848,382,17,365,May-19,0,1,1
16458,user_16458,9050,334,49,285,May-19,0,1,1
16460,user_16460,1706,55,43,12,Jan-19,4,0,0
16461,user_16461,27549,358,51,307,May-19,0,1,1
16462,user_16462,4,2,2,0,Nov-18,6,0,0
16463,user_16463,1155,28,3,25,May-19,0,1,1
16464,user_16464,2595,20,14,6,Mar-19,2,0,0
16465,user_16465,3455,187,63,124,May-19,0,1,1
16466,user_16466,293,10,0,10,Apr-19,1,1,0
16467,user_16467,25,9,0,9,Feb-19,3,0,0
16468,user_16468,1924,93,43,50,May-19,0,1,1
16469,user_16469,716,36,10,26,May-19,0,1,1
16470,user_16470,7567,56,15,41,Apr-19,1,1,0
16471,user_16471,962,49,17,32,May-19,0,1,1
16472,user_16472,5750,103,16,87,May-19,0,0,1
16473,user_16473,1652,100,10,90,May-19,0,1,1
16474,user_16474,24,3,3,0,Dec-18,5,0,0
16475,user_16475,175,8,7,1,May-19,0,0,1
16476,user_16476,9,1,1,0,Nov-18,6,0,0
16477,user_16477,256,8,0,8,May-19,0,1,1
16478,user_16478,3010,27,5,22,May-19,0,1,1
16479,user_16479,7958,69,6,63,May-19,0,1,1
16480,user_16480,3499,156,5,151,May-19,0,1,1
16481,user_16481,2797,84,65,19,May-19,0,0,1
16482,user_16482,128324,364,2,362,Mar-19,2,0,0
16483,user_16483,5235,142,5,137,May-19,0,1,1
16484,user_16484,18863,132,51,81,May-19,0,1,1
16485,user_16485,5480,42,32,10,Feb-19,3,0,0
16486,user_16486,17314,157,6,151,May-19,0,1,1
16487,user_16487,82,29,0,29,Apr-19,1,1,0
16488,user_16488,6865,95,47,48,Apr-19,1,1,0
16489,user_16489,814,32,4,28,Apr-19,1,1,0
16490,user_16490,1169,61,53,8,Jan-19,4,0,0
16491,user_16491,59638,102,39,63,May-19,0,1,1
16492,user_16492,1944,48,10,38,Apr-19,1,1,0
16493,user_16493,93,15,0,15,Apr-19,1,1,0
16494,user_16494,539,20,0,20,May-19,0,1,1
16495,user_16495,129,6,0,6,Apr-19,1,1,0
16496,user_16496,279,5,3,2,Feb-19,3,0,0
16497,user_16497,2137,256,11,245,May-19,0,1,1
16498,user_16498,3912,192,32,160,May-19,0,1,1
16499,user_16499,19471,264,1,263,May-19,0,1,1
16500,user_16500,4944,196,50,146,May-19,0,1,1
16501,user_16501,5,2,0,2,Apr-19,1,1,0
16502,user_16502,31,3,2,1,Jan-19,4,0,0
16503,user_16503,775,28,3,25,May-19,0,1,1
16504,user_16504,2233,89,12,77,May-19,0,1,1
16505,user_16505,216,36,25,11,May-19,0,1,1
16506,user_16506,10,2,2,0,Nov-18,6,0,0
16507,user_16507,18,3,2,1,Mar-19,2,0,0
16508,user_16508,195,9,3,6,Apr-19,1,1,0
16510,user_16510,177,18,17,1,Mar-19,2,0,0
16511,user_16511,9099,216,4,212,May-19,0,1,1
16512,user_16512,1364,52,6,46,Apr-19,1,1,0
16513,user_16513,6,3,3,0,Nov-18,6,0,0
16514,user_16514,5532,17,17,0,Dec-18,5,0,0
16515,user_16515,4056,183,2,181,Feb-19,3,0,0
16516,user_16516,103,5,0,5,Mar-19,2,0,0
16517,user_16517,1658,22,0,22,May-19,0,1,1
16518,user_16518,407,150,6,144,May-19,0,1,1
16519,user_16519,6266,172,3,169,May-19,0,1,1
16520,user_16520,3681,72,36,36,May-19,0,1,1
16521,user_16521,13319,61,11,50,Apr-19,1,1,0
16522,user_16522,322,8,6,2,Apr-19,1,1,0
16523,user_16523,26,5,4,1,Jan-19,4,0,0
16524,user_16524,774,18,3,15,Feb-19,3,0,0
16525,user_16525,955,54,29,25,May-19,0,1,1
16526,user_16526,7715,138,2,136,May-19,0,1,1
16527,user_16527,4226,119,14,105,May-19,0,1,1
16529,user_16529,2385,41,5,36,May-19,0,1,1
16530,user_16530,7082,69,24,45,Apr-19,1,1,0
16531,user_16531,17,8,7,1,Jan-19,4,0,0
16532,user_16532,367,29,0,29,May-19,0,0,1
16533,user_16533,4097,146,17,129,May-19,0,1,1
16534,user_16534,1056,16,9,7,Jan-19,4,0,0
16535,user_16535,51,7,6,1,Apr-19,1,1,0
16536,user_16536,17,2,2,0,Nov-18,6,0,0
16537,user_16537,555,24,12,12,Feb-19,3,0,0
16538,user_16538,8358,178,10,168,May-19,0,1,1
16539,user_16539,220,17,13,4,Feb-19,3,0,0
16540,user_16540,98,10,10,0,Dec-18,5,0,0
16541,user_16541,19443,24,3,21,May-19,0,1,1
16542,user_16542,44,6,6,0,Nov-18,6,0,0
16543,user_16543,14,3,3,0,Nov-18,6,0,0
16544,user_16544,1561,7,2,5,Apr-19,1,1,0
16545,user_16545,2799,34,4,30,May-19,0,1,1
16546,user_16546,2629,39,23,16,May-19,0,0,1
16547,user_16547,652,69,21,48,May-19,0,1,1
16548,user_16548,1444,49,2,47,Mar-19,2,0,0
16549,user_16549,1162,7,7,0,Dec-18,5,0,0
16550,user_16550,2283,342,74,268,May-19,0,1,1
16551,user_16551,5785,293,34,259,May-19,0,1,1
16552,user_16552,4101,85,2,83,May-19,0,1,1
16553,user_16553,14,3,3,0,Nov-18,6,0,0
16554,user_16554,402,44,6,38,Apr-19,1,1,0
16555,user_16555,17334,123,11,112,May-19,0,1,1
16556,user_16556,2136,47,4,43,May-19,0,1,1
16557,user_16557,19,4,4,0,Dec-18,5,0,0
16558,user_16558,175,3,0,3,May-19,0,0,1
16559,user_16559,2114,42,9,33,May-19,0,1,1
16560,user_16560,3508,28,7,21,Apr-19,1,1,0
16561,user_16561,2873,21,2,19,May-19,0,0,1
16562,user_16562,400,8,3,5,Apr-19,1,1,0
16563,user_16563,397,4,4,0,Nov-18,6,0,0
16564,user_16564,1010,35,0,35,Apr-19,1,1,0
16565,user_16565,1846,64,20,44,Apr-19,1,1,0
16566,user_16566,26,2,2,0,Nov-18,6,0,0
16567,user_16567,1280,83,9,74,May-19,0,1,1
16568,user_16568,9917,6,5,1,Feb-19,3,0,0
16569,user_16569,155,23,0,23,May-19,0,1,1
16571,user_16571,106,3,3,0,Nov-18,6,0,0
16573,user_16573,11,2,2,0,Nov-18,6,0,0
16574,user_16574,48,20,1,19,May-19,0,1,1
16575,user_16575,14,8,0,8,May-19,0,0,1
16576,user_16576,1289,15,15,0,Dec-18,5,0,0
16577,user_16577,163,17,8,9,May-19,0,1,1
16578,user_16578,15,3,0,3,May-19,0,0,1
16579,user_16579,9,1,1,0,Nov-18,6,0,0
16580,user_16580,207,13,9,4,Mar-19,2,0,0
16581,user_16581,623,19,8,11,Mar-19,2,0,0
16582,user_16582,18274,45,27,18,May-19,0,1,1
16583,user_16583,2277,52,43,9,May-19,0,1,1
16584,user_16584,634,66,8,58,May-19,0,1,1
16585,user_16585,1164,25,2,23,Feb-19,3,0,0
16586,user_16586,3385,94,14,80,May-19,0,1,1
16587,user_16587,118,15,9,6,Mar-19,2,0,0
16588,user_16588,196,4,0,4,Mar-19,2,0,0
16589,user_16589,967,49,30,19,Apr-19,1,1,0
16590,user_16590,106,4,3,1,May-19,0,0,1
16592,user_16592,4372,254,73,181,May-19,0,1,1
16593,user_16593,12260,44,7,37,May-19,0,1,1
16594,user_16594,51,35,15,20,Apr-19,1,1,0
16595,user_16595,10503,198,71,127,May-19,0,1,1
16596,user_16596,11,9,8,1,Apr-19,1,1,0
16597,user_16597,13120,352,11,341,May-19,0,1,1
16598,user_16598,3483,11,11,0,Dec-18,5,0,0
16600,user_16600,170,3,1,2,Mar-19,2,0,0
16601,user_16601,53,4,4,0,Dec-18,5,0,0
16602,user_16602,2115,50,8,42,May-19,0,1,1
16603,user_16603,1356,50,17,33,May-19,0,1,1
16604,user_16604,4,2,2,0,Nov-18,6,0,0
16605,user_16605,23,3,2,1,Apr-19,1,1,0
16606,user_16606,6870,379,55,324,May-19,0,1,1
16607,user_16607,3031,17,0,17,Apr-19,1,1,0
16608,user_16608,1474,64,5,59,May-19,0,1,1
16609,user_16609,95884,115,11,104,May-19,0,1,1
16610,user_16610,124,11,3,8,Apr-19,1,1,0
16611,user_16611,862,34,14,20,May-19,0,1,1
16612,user_16612,4258,149,19,130,May-19,0,1,1
16614,user_16614,2664,23,4,19,May-19,0,0,1
16615,user_16615,19233,530,12,518,May-19,0,1,1
16616,user_16616,66,4,3,1,Mar-19,2,0,0
16617,user_16617,1120,38,26,12,Mar-19,2,0,0
16618,user_16618,869,56,2,54,Mar-19,2,0,0
16619,user_16619,10280,508,42,466,May-19,0,1,1
16621,user_16621,0,1,1,0,Nov-18,6,0,0
16622,user_16622,91,34,9,25,Apr-19,1,1,0
16623,user_16623,3090,76,9,67,May-19,0,1,1
16624,user_16624,3143,368,125,243,May-19,0,1,1
16625,user_16625,8,2,2,0,Nov-18,6,0,0
16626,user_16626,4,4,0,4,Apr-19,1,1,0
16627,user_16627,6081,97,9,88,Apr-19,1,1,0
16628,user_16628,881,45,15,30,May-19,0,1,1
16629,user_16629,16277,45,21,24,Apr-19,1,1,0
16630,user_16630,1638,48,34,14,Apr-19,1,1,0
16632,user_16632,17,2,2,0,Dec-18,5,0,0
16633,user_16633,9,6,1,5,May-19,0,0,1
16634,user_16634,611,64,2,62,May-19,0,1,1
16635,user_16635,3407,145,4,141,May-19,0,1,1
16636,user_16636,114155,521,15,506,May-19,0,1,1
16637,user_16637,1311,16,0,16,May-19,0,0,1
16638,user_16638,3259,20,3,17,May-19,0,1,1
16639,user_16639,221,5,5,0,Nov-18,6,0,0
16640,user_16640,4092,114,52,62,May-19,0,1,1
16641,user_16641,99049,204,17,187,May-19,0,1,1
16642,user_16642,15,4,4,0,Nov-18,6,0,0
16643,user_16643,2010,35,3,32,Apr-19,1,1,0
16644,user_16644,30995,498,58,440,May-19,0,1,1
16645,user_16645,9,2,2,0,Nov-18,6,0,0
16646,user_16646,1598,42,11,31,Apr-19,1,1,0
16647,user_16647,11,4,4,0,Nov-18,6,0,0
16648,user_16648,3129,57,30,27,May-19,0,1,1
16649,user_16649,101,21,0,21,Mar-19,2,0,0
16650,user_16650,361,25,9,16,Feb-19,3,0,0
16651,user_16651,15869,196,6,190,May-19,0,1,1
16652,user_16652,5582,236,85,151,May-19,0,1,1
16653,user_16653,10401,81,19,62,May-19,0,1,1
16654,user_16654,15,2,2,0,Nov-18,6,0,0
16655,user_16655,199,19,4,15,Mar-19,2,0,0
16656,user_16656,13786,209,34,175,May-19,0,1,1
16657,user_16657,9,1,1,0,Nov-18,6,0,0
16658,user_16658,1120,87,10,77,May-19,0,1,1
16659,user_16659,1444,48,3,45,May-19,0,1,1
16660,user_16660,119,5,2,3,Apr-19,1,1,0
16661,user_16661,3540,90,50,40,Apr-19,1,1,0
16662,user_16662,144,16,6,10,May-19,0,1,1
16663,user_16663,83,5,0,5,May-19,0,1,1
16664,user_16664,210,34,13,21,Apr-19,1,1,0
16665,user_16665,4617,35,7,28,May-19,0,1,1
16666,user_16666,5427,74,12,62,May-19,0,1,1
16667,user_16667,4371,258,47,211,May-19,0,1,1
16668,user_16668,9,2,2,0,Nov-18,6,0,0
16669,user_16669,1821,78,0,78,May-19,0,1,1
16670,user_16670,20,2,2,0,Nov-18,6,0,0
16672,user_16672,4,1,0,1,Apr-19,1,1,0
16673,user_16673,8747,104,25,79,May-19,0,1,1
16674,user_16674,3831,285,42,243,May-19,0,1,1
16675,user_16675,11,2,2,0,Nov-18,6,0,0
16676,user_16676,1685,64,52,12,May-19,0,1,1
16677,user_16677,214,6,4,2,Feb-19,3,0,0
16678,user_16678,4564,306,36,270,May-19,0,1,1
16679,user_16679,250,32,21,11,Mar-19,2,0,0
16680,user_16680,1792,86,18,68,May-19,0,1,1
16681,user_16681,3502,68,13,55,Mar-19,2,0,0
16682,user_16682,1542,56,26,30,Apr-19,1,1,0
16683,user_16683,15000,845,102,743,May-19,0,1,1
16684,user_16684,7766,65,7,58,Apr-19,1,1,0
16685,user_16685,3683,53,38,15,Apr-19,1,1,0
16686,user_16686,3632,120,5,115,May-19,0,1,1
16687,user_16687,870,68,3,65,Apr-19,1,1,0
16688,user_16688,2,2,2,0,Dec-18,5,0,0
16689,user_16689,8385,467,204,263,May-19,0,1,1
16690,user_16690,209,9,4,5,Mar-19,2,0,0
16692,user_16692,510,16,11,5,Feb-19,3,0,0
16693,user_16693,1387,71,28,43,May-19,0,1,1
16694,user_16694,18,3,3,0,Nov-18,6,0,0
16695,user_16695,17876,331,67,264,May-19,0,1,1
16696,user_16696,19,7,7,0,Dec-18,5,0,0
16697,user_16697,2575,126,10,116,Apr-19,1,1,0
16698,user_16698,135542,949,94,855,May-19,0,1,1
16699,user_16699,1373,17,2,15,Jan-19,4,0,0
16700,user_16700,110,9,8,1,Feb-19,3,0,0
16701,user_16701,909,29,14,15,May-19,0,0,1
16702,user_16702,1575,149,41,108,May-19,0,1,1
16703,user_16703,24565,1317,195,1122,May-19,0,1,1
16705,user_16705,17,3,2,1,Feb-19,3,0,0
16706,user_16706,41,3,3,0,Dec-18,5,0,0
16707,user_16707,107775,60,11,49,Mar-19,2,0,0
16708,user_16708,355,52,0,52,May-19,0,1,1
16709,user_16709,17,4,4,0,Nov-18,6,0,0
16710,user_16710,21,1,0,1,Feb-19,3,0,0
16711,user_16711,1833,113,46,67,May-19,0,1,1
16712,user_16712,461,94,22,72,Apr-19,1,1,0
16714,user_16714,94,4,4,0,Nov-18,6,0,0
16715,user_16715,6039,531,9,522,May-19,0,1,1
16716,user_16716,17316,495,53,442,May-19,0,1,1
16717,user_16717,114276,776,282,494,May-19,0,1,1
16718,user_16718,819,52,5,47,May-19,0,1,1
16719,user_16719,9,2,2,0,Nov-18,6,0,0
16720,user_16720,150,16,9,7,Jan-19,4,0,0
16721,user_16721,11,4,2,2,Mar-19,2,0,0
16722,user_16722,6048,156,45,111,May-19,0,1,1
16723,user_16723,13,3,3,0,Nov-18,6,0,0
16724,user_16724,9,3,3,0,Nov-18,6,0,0
16726,user_16726,716,8,3,5,Mar-19,2,0,0
16727,user_16727,3545,12,1,11,Apr-19,1,1,0
16728,user_16728,31,3,3,0,Dec-18,5,0,0
16729,user_16729,13450,137,5,132,May-19,0,1,1
16730,user_16730,1520,95,19,76,May-19,0,1,1
16731,user_16731,1929,43,16,27,May-19,0,1,1
16732,user_16732,101,6,3,3,Apr-19,1,1,0
16733,user_16733,9975,96,29,67,Apr-19,1,1,0
16734,user_16734,814,15,13,2,Jan-19,4,0,0
16735,user_16735,2691,33,3,30,Apr-19,1,1,0
16736,user_16736,398,79,34,45,Apr-19,1,1,0
16737,user_16737,5956,355,6,349,May-19,0,1,1
16738,user_16738,138,14,12,2,May-19,0,0,1
16739,user_16739,3881,217,69,148,May-19,0,1,1
16740,user_16740,10429,71,19,52,Apr-19,1,1,0
16741,user_16741,18823,139,3,136,May-19,0,1,1
16742,user_16742,1111,17,13,4,Apr-19,1,1,0
16743,user_16743,34,3,3,0,Nov-18,6,0,0
16744,user_16744,10437,252,67,185,May-19,0,1,1
16745,user_16745,537,17,12,5,Apr-19,1,1,0
16746,user_16746,1007,45,8,37,May-19,0,1,1
16747,user_16747,21,4,4,0,Nov-18,6,0,0
16748,user_16748,2323,77,7,70,May-19,0,1,1
16749,user_16749,6296,113,15,98,Apr-19,1,1,0
16750,user_16750,2783,85,62,23,Mar-19,2,0,0
16751,user_16751,8840,231,53,178,May-19,0,1,1
16752,user_16752,523,31,2,29,Apr-19,1,1,0
16753,user_16753,10811,83,24,59,Apr-19,1,1,0
16754,user_16754,376,18,5,13,May-19,0,0,1
16755,user_16755,2,2,2,0,Nov-18,6,0,0
16756,user_16756,540,5,3,2,Jan-19,4,0,0
16757,user_16757,90,3,3,0,Dec-18,5,0,0
16759,user_16759,2676,48,16,32,Apr-19,1,1,0
16760,user_16760,9,2,2,0,Nov-18,6,0,0
16761,user_16761,13,4,4,0,Nov-18,6,0,0
16762,user_16762,499,81,2,79,May-19,0,1,1
16763,user_16763,664,36,14,22,Apr-19,1,1,0
16764,user_16764,734,14,5,9,Feb-19,3,0,0
16766,user_16766,8904,564,96,468,May-19,0,1,1
16767,user_16767,49,7,3,4,Feb-19,3,0,0
16768,user_16768,355,17,16,1,Jan-19,4,0,0
16769,user_16769,1808,110,4,106,Apr-19,1,1,0
16770,user_16770,5446,26,2,24,May-19,0,1,1
16771,user_16771,36,7,0,7,May-19,0,1,1
16772,user_16772,1836,55,26,29,Apr-19,1,1,0
16773,user_16773,1070,26,10,16,May-19,0,1,1
16774,user_16774,1480,50,27,23,Mar-19,2,0,0
16775,user_16775,56,28,19,9,Apr-19,1,1,0
16776,user_16776,466,26,13,13,Feb-19,3,0,0
16777,user_16777,28274,84,25,59,Mar-19,2,0,0
16778,user_16778,19,4,0,4,Jan-19,4,0,0
16779,user_16779,9913,70,10,60,May-19,0,1,1
16780,user_16780,290160,112,69,43,May-19,0,1,1
16781,user_16781,2563,8,5,3,Apr-19,1,1,0
16782,user_16782,21,7,2,5,Mar-19,2,0,0
16783,user_16783,9460,334,116,218,May-19,0,1,1
16784,user_16784,1042,28,2,26,Apr-19,1,1,0
16785,user_16785,108,8,8,0,Nov-18,6,0,0
16787,user_16787,7341,78,2,76,Apr-19,1,1,0
16788,user_16788,3872,78,36,42,May-19,0,1,1
16789,user_16789,8251,219,0,219,May-19,0,1,1
16790,user_16790,31028,152,52,100,May-19,0,1,1
16791,user_16791,8305,492,80,412,May-19,0,1,1
16792,user_16792,6451,375,77,298,May-19,0,1,1
16793,user_16793,764,44,26,18,May-19,0,1,1
16794,user_16794,2925,125,24,101,Apr-19,1,1,0
16795,user_16795,65,6,3,3,Apr-19,1,1,0
16796,user_16796,1231,74,16,58,May-19,0,1,1
16797,user_16797,60,3,3,0,Dec-18,5,0,0
16798,user_16798,94,10,5,5,May-19,0,0,1
16799,user_16799,2280,60,60,0,Dec-18,5,0,0
16800,user_16800,48484,674,156,518,May-19,0,1,1
16801,user_16801,47,5,5,0,Dec-18,5,0,0
16802,user_16802,13404,150,8,142,May-19,0,1,1
16803,user_16803,153,16,16,0,Dec-18,5,0,0
16804,user_16804,5813,82,6,76,May-19,0,1,1
16805,user_16805,287,28,0,28,Feb-19,3,0,0
16806,user_16806,285,4,0,4,May-19,0,1,1
16807,user_16807,1066,29,3,26,Mar-19,2,0,0
16808,user_16808,481,20,19,1,Feb-19,3,0,0
16809,user_16809,16576,299,68,231,May-19,0,1,1
16810,user_16810,17042,314,56,258,May-19,0,1,1
16811,user_16811,2372,97,26,71,May-19,0,1,1
16812,user_16812,13314,218,2,216,May-19,0,1,1
16813,user_16813,587,25,3,22,Apr-19,1,1,0
16814,user_16814,2137,27,19,8,Apr-19,1,1,0
16815,user_16815,719,19,19,0,Dec-18,5,0,0
16816,user_16816,1301,41,3,38,May-19,0,1,1
16817,user_16817,856982,412,58,354,May-19,0,1,1
16818,user_16818,4347,98,81,17,Apr-19,1,1,0
16819,user_16819,1698,38,2,36,Apr-19,1,1,0
16822,user_16822,132,2,0,2,Jan-19,4,0,0
16823,user_16823,106,16,10,6,Apr-19,1,1,0
16824,user_16824,119,4,4,0,Dec-18,5,0,0
16825,user_16825,33,6,0,6,Feb-19,3,0,0
16826,user_16826,45,8,4,4,May-19,0,0,1
16827,user_16827,5899,327,46,281,May-19,0,1,1
16828,user_16828,3768,74,8,66,May-19,0,1,1
16829,user_16829,260,10,5,5,Feb-19,3,0,0
16830,user_16830,305,15,0,15,May-19,0,1,1
16831,user_16831,155,6,6,0,Nov-18,6,0,0
16832,user_16832,43,6,6,0,Dec-18,5,0,0
16833,user_16833,245,26,12,14,May-19,0,1,1
16834,user_16834,825,24,14,10,May-19,0,1,1
16835,user_16835,1642,17,7,10,Apr-19,1,1,0
16836,user_16836,11,2,2,0,Nov-18,6,0,0
16837,user_16837,3050,138,6,132,May-19,0,1,1
16838,user_16838,5638,138,12,126,May-19,0,1,1
16839,user_16839,1012,19,14,5,Jan-19,4,0,0
16840,user_16840,1199,95,3,92,May-19,0,1,1
16841,user_16841,4104,36,13,23,Mar-19,2,0,0
16842,user_16842,6974,146,38,108,May-19,0,1,1
16843,user_16843,155,14,1,13,May-19,0,1,1
16844,user_16844,2054,43,28,15,May-19,0,0,1
16845,user_16845,8773,270,4,266,May-19,0,1,1
16846,user_16846,443,21,16,5,May-19,0,0,1
16847,user_16847,22,5,0,5,Jan-19,4,0,0
16848,user_16848,5416,92,42,50,Mar-19,2,0,0
16849,user_16849,7844,123,84,39,May-19,0,1,1
16850,user_16850,1598,26,4,22,Apr-19,1,1,0
16851,user_16851,607,55,21,34,Apr-19,1,1,0
16852,user_16852,46822,99,12,87,Apr-19,1,1,0
16854,user_16854,992,36,7,29,May-19,0,1,1
16855,user_16855,595,67,21,46,May-19,0,1,1
16856,user_16856,218,9,3,6,Apr-19,1,1,0
16857,user_16857,1749,43,23,20,Jan-19,4,0,0
16858,user_16858,2954,78,27,51,May-19,0,1,1
16859,user_16859,550,56,0,56,Apr-19,1,1,0
16860,user_16860,10460,245,11,234,May-19,0,1,1
16861,user_16861,25,5,5,0,Nov-18,6,0,0
16862,user_16862,153,16,4,12,May-19,0,1,1
16863,user_16863,9,2,2,0,Nov-18,6,0,0
16864,user_16864,1402,41,24,17,Apr-19,1,1,0
16865,user_16865,2524,70,10,60,May-19,0,1,1
16866,user_16866,2906,50,36,14,May-19,0,1,1
16867,user_16867,8149,46,1,45,May-19,0,1,1
16868,user_16868,4303,55,2,53,May-19,0,1,1
16869,user_16869,4863,54,8,46,May-19,0,1,1
16870,user_16870,15200,195,21,174,May-19,0,1,1
16871,user_16871,177,9,6,3,Apr-19,1,1,0
16872,user_16872,20,2,1,1,Jan-19,4,0,0
16873,user_16873,12824,308,7,301,May-19,0,1,1
16874,user_16874,645,33,10,23,Apr-19,1,1,0
16875,user_16875,395,5,1,4,May-19,0,1,1
16876,user_16876,436,27,8,19,Apr-19,1,1,0
16877,user_16877,355,39,7,32,May-19,0,1,1
16878,user_16878,157,14,6,8,Apr-19,1,1,0
16879,user_16879,85,9,3,6,Mar-19,2,0,0
16880,user_16880,14,2,0,2,Mar-19,2,0,0
16881,user_16881,18,3,0,3,Jan-19,4,0,0
16882,user_16882,36,11,5,6,May-19,0,1,1
16883,user_16883,1978,68,9,59,May-19,0,1,1
16884,user_16884,1732,27,3,24,Mar-19,2,0,0
16885,user_16885,99383,239,64,175,May-19,0,1,1
16886,user_16886,555,23,0,23,Apr-19,1,1,0
16887,user_16887,5188,176,95,81,May-19,0,1,1
16888,user_16888,665,35,18,17,May-19,0,1,1
16889,user_16889,462,29,21,8,May-19,0,0,1
16890,user_16890,9224,390,87,303,May-19,0,1,1
16891,user_16891,2738,153,0,153,May-19,0,1,1
16892,user_16892,2669,65,32,33,May-19,0,1,1
16893,user_16893,1367,90,21,69,May-19,0,1,1
16894,user_16894,9,2,2,0,Nov-18,6,0,0
16895,user_16895,1989,252,4,248,May-19,0,1,1
16896,user_16896,33945,50,18,32,May-19,0,1,1
16897,user_16897,1262,61,3,58,May-19,0,1,1
16898,user_16898,276,14,12,2,May-19,0,0,1
16899,user_16899,10,1,1,0,Nov-18,6,0,0
16900,user_16900,252,20,7,13,Apr-19,1,1,0
16901,user_16901,4732,33,3,30,May-19,0,0,1
16902,user_16902,1423,31,22,9,Apr-19,1,1,0
16903,user_16903,8354,176,59,117,May-19,0,1,1
16904,user_16904,86,6,0,6,Apr-19,1,1,0
16905,user_16905,2667,77,75,2,Mar-19,2,0,0
16906,user_16906,4984,156,7,149,May-19,0,1,1
16907,user_16907,2589,123,2,121,May-19,0,1,1
16908,user_16908,8,3,2,1,May-19,0,0,1
16909,user_16909,338,11,5,6,Apr-19,1,1,0
16910,user_16910,9,1,1,0,Dec-18,5,0,0
16911,user_16911,1454,112,69,43,May-19,0,1,1
16912,user_16912,401,15,2,13,May-19,0,1,1
16913,user_16913,642,42,3,39,May-19,0,1,1
16914,user_16914,479,8,1,7,Apr-19,1,1,0
16915,user_16915,152,16,14,2,Jan-19,4,0,0
16916,user_16916,547,61,10,51,May-19,0,1,1
16917,user_16917,164,21,4,17,Apr-19,1,1,0
16918,user_16918,5454,301,34,267,May-19,0,1,1
16919,user_16919,72,11,1,10,Mar-19,2,0,0
16920,user_16920,517,16,2,14,Apr-19,1,1,0
16922,user_16922,2762,83,3,80,Apr-19,1,1,0
16923,user_16923,171,3,0,3,Jan-19,4,0,0
16924,user_16924,9742,30,11,19,Apr-19,1,1,0
16925,user_16925,574,50,0,50,May-19,0,1,1
16926,user_16926,11606,157,41,116,Apr-19,1,1,0
16927,user_16927,961,22,22,0,Dec-18,5,0,0
16928,user_16928,1089,7,4,3,Mar-19,2,0,0
16929,user_16929,90,3,3,0,Nov-18,6,0,0
16930,user_16930,2639,99,5,94,May-19,0,1,1
16931,user_16931,3183,138,46,92,Apr-19,1,1,0
16932,user_16932,1457,36,3,33,May-19,0,0,1
16933,user_16933,37,8,7,1,Apr-19,1,1,0
16934,user_16934,350,18,7,11,Apr-19,1,1,0
16935,user_16935,8457,196,44,152,May-19,0,1,1
16936,user_16936,841,21,21,0,Dec-18,5,0,0
16937,user_16937,15965,133,16,117,May-19,0,1,1
16938,user_16938,3659,204,48,156,May-19,0,1,1
16939,user_16939,26,5,5,0,Nov-18,6,0,0
16941,user_16941,1004,42,7,35,Apr-19,1,1,0
16942,user_16942,13,1,1,0,Nov-18,6,0,0
16945,user_16945,16079,119,26,93,May-19,0,1,1
16946,user_16946,1613,59,12,47,May-19,0,1,1
16947,user_16947,21,3,3,0,Nov-18,6,0,0
16948,user_16948,3062,84,2,82,May-19,0,1,1
16949,user_16949,286,7,0,7,Apr-19,1,1,0
16950,user_16950,15879,228,16,212,May-19,0,1,1
16951,user_16951,10263,98,2,96,May-19,0,1,1
16952,user_16952,1401,85,1,84,May-19,0,1,1
16953,user_16953,1840,133,9,124,May-19,0,1,1
16954,user_16954,137,8,8,0,Nov-18,6,0,0
16955,user_16955,105,26,21,5,Feb-19,3,0,0
16956,user_16956,14,3,3,0,Nov-18,6,0,0
16957,user_16957,5371,294,23,271,May-19,0,1,1
16958,user_16958,2003,15,4,11,Jan-19,4,0,0
16959,user_16959,7970,82,37,45,Apr-19,1,1,0
16961,user_16961,573,30,3,27,Feb-19,3,0,0
16962,user_16962,2834,32,6,26,Mar-19,2,0,0
16963,user_16963,585,26,13,13,Jan-19,4,0,0
16964,user_16964,14,3,3,0,Nov-18,6,0,0
16965,user_16965,10120,126,31,95,May-19,0,1,1
16966,user_16966,572,21,20,1,Jan-19,4,0,0
16967,user_16967,3733,43,17,26,Apr-19,1,1,0
16968,user_16968,656,10,10,0,Nov-18,6,0,0
16969,user_16969,15,2,2,0,Nov-18,6,0,0
16970,user_16970,2624,79,37,42,May-19,0,1,1
16971,user_16971,1751,31,26,5,Mar-19,2,0,0
16973,user_16973,596,8,7,1,Feb-19,3,0,0
16974,user_16974,6087,114,82,32,May-19,0,1,1
16975,user_16975,26,3,3,0,Nov-18,6,0,0
16976,user_16976,2029,238,60,178,May-19,0,1,1
16977,user_16977,427,4,4,0,Dec-18,5,0,0
16978,user_16978,537,39,11,28,May-19,0,1,1
16979,user_16979,5502,66,12,54,May-19,0,1,1
16980,user_16980,1529,97,8,89,May-19,0,1,1
16981,user_16981,3717,68,55,13,Jan-19,4,0,0
16982,user_16982,16,5,5,0,Nov-18,6,0,0
16983,user_16983,13624,472,6,466,May-19,0,1,1
16984,user_16984,13891,246,11,235,May-19,0,1,1
16985,user_16985,1048,156,45,111,May-19,0,1,1
16986,user_16986,2237,81,24,57,May-19,0,1,1
16987,user_16987,5916,78,59,19,Apr-19,1,1,0
16988,user_16988,745,23,11,12,Mar-19,2,0,0
16989,user_16989,2430,117,3,114,May-19,0,1,1
16990,user_16990,25925,507,118,389,May-19,0,1,1
16991,user_16991,1121,12,8,4,Apr-19,1,1,0
16992,user_16992,31355,1275,152,1123,May-19,0,1,1
16993,user_16993,11,2,2,0,Nov-18,6,0,0
16994,user_16994,7115,209,43,166,May-19,0,1,1
16995,user_16995,718,32,16,16,Apr-19,1,1,0
16996,user_16996,38,6,5,1,Jan-19,4,0,0
16997,user_16997,2281,83,44,39,May-19,0,1,1
16998,user_16998,997,15,2,13,Apr-19,1,1,0
16999,user_16999,38,5,3,2,Feb-19,3,0,0
17000,user_17000,1837,41,16,25,May-19,0,1,1
17001,user_17001,42,5,3,2,Apr-19,1,1,0
17002,user_17002,321,24,16,8,Apr-19,1,1,0
17003,user_17003,1391,11,3,8,Jan-19,4,0,0
17004,user_17004,1435,136,131,5,Mar-19,2,0,0
17005,user_17005,46902,290,59,231,May-19,0,1,1
17006,user_17006,1299,160,29,131,May-19,0,1,1
17007,user_17007,2274,15,4,11,Apr-19,1,1,0
17008,user_17008,168,26,22,4,Jan-19,4,0,0
17009,user_17009,503,28,8,20,May-19,0,0,1
17010,user_17010,2182,42,4,38,Apr-19,1,1,0
17012,user_17012,4183,188,18,170,May-19,0,1,1
17013,user_17013,11996,203,4,199,May-19,0,1,1
17014,user_17014,10,1,1,0,Nov-18,6,0,0
17015,user_17015,136,10,7,3,Feb-19,3,0,0
17016,user_17016,3630,169,29,140,May-19,0,1,1
17017,user_17017,1568,59,51,8,Apr-19,1,1,0
17018,user_17018,5457,76,11,65,Apr-19,1,1,0
17019,user_17019,7289,157,20,137,May-19,0,1,1
17020,user_17020,3071,64,10,54,May-19,0,0,1
17021,user_17021,189,8,3,5,Mar-19,2,0,0
17022,user_17022,35265,522,106,416,May-19,0,1,1
17023,user_17023,1111,22,8,14,May-19,0,1,1
17024,user_17024,898,69,59,10,Apr-19,1,1,0
17025,user_17025,26,3,2,1,Apr-19,1,1,0
17026,user_17026,202,25,25,0,Nov-18,6,0,0
17027,user_17027,936,2,1,1,May-19,0,0,1
17028,user_17028,448,23,18,5,Mar-19,2,0,0
17029,user_17029,1385,24,7,17,Mar-19,2,0,0
17030,user_17030,9315,124,47,77,May-19,0,1,1
17031,user_17031,139,11,1,10,Apr-19,1,1,0
17033,user_17033,584,33,31,2,Mar-19,2,0,0
17034,user_17034,94405,781,141,640,May-19,0,1,1
17035,user_17035,2603,115,83,32,Mar-19,2,0,0
17036,user_17036,264,8,6,2,Apr-19,1,1,0
17037,user_17037,10881,107,25,82,Apr-19,1,1,0
17038,user_17038,1247,25,19,6,Apr-19,1,1,0
17039,user_17039,1,1,1,0,Nov-18,6,0,0
17040,user_17040,5522,169,45,124,May-19,0,1,1
17041,user_17041,458,34,7,27,May-19,0,1,1
17042,user_17042,173,6,4,2,May-19,0,0,1
17043,user_17043,4007,56,42,14,Apr-19,1,1,0
17044,user_17044,22257,587,149,438,Apr-19,1,1,0
17045,user_17045,442,19,11,8,Apr-19,1,1,0
17046,user_17046,4504,358,17,341,May-19,0,1,1
17047,user_17047,8092,218,4,214,May-19,0,1,1
17048,user_17048,2270,39,3,36,Mar-19,2,0,0
17049,user_17049,20,10,8,2,Jan-19,4,0,0
17050,user_17050,5042,8,7,1,Mar-19,2,0,0
17051,user_17051,1554,32,4,28,May-19,0,1,1
17052,user_17052,21493,29,0,29,May-19,0,1,1
17053,user_17053,54382,54,2,52,May-19,0,1,1
17054,user_17054,118405,69,3,66,May-19,0,1,1
17055,user_17055,10,2,2,0,Dec-18,5,0,0
17056,user_17056,736,42,5,37,Mar-19,2,0,0
17057,user_17057,508,11,1,10,Apr-19,1,1,0
17058,user_17058,8170,342,4,338,May-19,0,1,1
17059,user_17059,831,9,4,5,Mar-19,2,0,0
17060,user_17060,1116,38,0,38,Apr-19,1,1,0
17061,user_17061,617,53,0,53,May-19,0,1,1
17062,user_17062,112,8,5,3,Mar-19,2,0,0
17063,user_17063,2853,118,46,72,Feb-19,3,0,0
17065,user_17065,1218,16,5,11,Apr-19,1,1,0
17066,user_17066,17,7,3,4,Jan-19,4,0,0
17067,user_17067,435,28,1,27,May-19,0,1,1
17068,user_17068,3647,147,32,115,May-19,0,1,1
17069,user_17069,4885,96,19,77,Apr-19,1,1,0
17070,user_17070,1423,54,2,52,May-19,0,1,1
17071,user_17071,6732,98,78,20,Feb-19,3,0,0
17072,user_17072,36914,940,5,935,May-19,0,1,1
17073,user_17073,21613,35,6,29,May-19,0,1,1
17074,user_17074,812,20,3,17,Mar-19,2,0,0
17075,user_17075,9,2,2,0,Dec-18,5,0,0
17076,user_17076,3105,159,0,159,May-19,0,1,1
17077,user_17077,928,53,3,50,May-19,0,1,1
17078,user_17078,214,8,0,8,Mar-19,2,0,0
17079,user_17079,4519,257,2,255,May-19,0,1,1
17080,user_17080,3352,130,30,100,May-19,0,1,1
17081,user_17081,1502,17,7,10,Apr-19,1,1,0
17082,user_17082,124,41,15,26,Apr-19,1,1,0
17083,user_17083,314,30,1,29,May-19,0,1,1
17084,user_17084,209,15,0,15,May-19,0,1,1
17085,user_17085,2486,31,2,29,Apr-19,1,1,0
17086,user_17086,4675,235,2,233,May-19,0,1,1
17087,user_17087,414,43,0,43,Apr-19,1,1,0
17088,user_17088,9,1,1,0,Dec-18,5,0,0
17089,user_17089,2161,29,2,27,May-19,0,1,1
17090,user_17090,1502,16,13,3,Feb-19,3,0,0
17091,user_17091,100,8,2,6,Feb-19,3,0,0
17093,user_17093,437,6,3,3,Jan-19,4,0,0
17094,user_17094,3774,28,1,27,Apr-19,1,1,0
17095,user_17095,679,37,20,17,Apr-19,1,1,0
17096,user_17096,1264,37,2,35,May-19,0,1,1
17097,user_17097,15849,450,28,422,May-19,0,1,1
17098,user_17098,1502,54,4,50,Apr-19,1,1,0
17100,user_17100,668,32,8,24,May-19,0,1,1
17101,user_17101,1294,41,2,39,Apr-19,1,1,0
17102,user_17102,3998,47,32,15,Jan-19,4,0,0
17103,user_17103,854756,248,0,248,May-19,0,1,1
17104,user_17104,1117,39,4,35,Apr-19,1,1,0
17105,user_17105,3093,79,13,66,May-19,0,1,1
17106,user_17106,1904,24,2,22,May-19,0,1,1
17107,user_17107,358,20,0,20,May-19,0,1,1
17109,user_17109,2351,20,6,14,Apr-19,1,1,0
17110,user_17110,978,23,23,0,Dec-18,5,0,0
17111,user_17111,738,106,3,103,May-19,0,1,1
17112,user_17112,226,11,3,8,Apr-19,1,1,0
17113,user_17113,136,10,3,7,Apr-19,1,1,0
17114,user_17114,2100,51,3,48,Feb-19,3,0,0
17115,user_17115,200,13,2,11,Jan-19,4,0,0
17116,user_17116,18,3,1,2,Feb-19,3,0,0
17117,user_17117,1412,26,1,25,Apr-19,1,1,0
17118,user_17118,2526,65,6,59,Apr-19,1,1,0
17119,user_17119,121,4,2,2,Apr-19,1,1,0
17121,user_17121,111,3,3,0,Dec-18,5,0,0
17122,user_17122,9,2,2,0,Dec-18,5,0,0
17123,user_17123,979,18,3,15,May-19,0,1,1
17124,user_17124,9,2,2,0,Dec-18,5,0,0
17125,user_17125,345,14,2,12,Apr-19,1,1,0
17126,user_17126,1557,113,1,112,Apr-19,1,1,0
17127,user_17127,382,21,2,19,May-19,0,0,1
17128,user_17128,11211,167,9,158,May-19,0,1,1
17129,user_17129,446,13,3,10,Mar-19,2,0,0
17130,user_17130,145385,208,15,193,Apr-19,1,1,0
17131,user_17131,714,38,2,36,May-19,0,1,1
17132,user_17132,122,6,3,3,Jan-19,4,0,0
17133,user_17133,2207,31,15,16,Apr-19,1,1,0
17134,user_17134,349,32,7,25,May-19,0,1,1
17135,user_17135,2190,23,2,21,Apr-19,1,1,0
17136,user_17136,3301,189,0,189,May-19,0,1,1
17137,user_17137,1148,14,2,12,May-19,0,0,1
17138,user_17138,3527,143,0,143,May-19,0,1,1
17139,user_17139,3522,175,3,172,May-19,0,1,1
17140,user_17140,1237,29,1,28,May-19,0,1,1
17142,user_17142,9212,335,21,314,May-19,0,1,1
17143,user_17143,1074,11,2,9,Mar-19,2,0,0
17144,user_17144,35777,414,2,412,May-19,0,1,1
17145,user_17145,20,4,2,2,Feb-19,3,0,0
17146,user_17146,4171,83,3,80,Feb-19,3,0,0
17147,user_17147,472,12,2,10,Apr-19,1,1,0
17148,user_17148,378,34,2,32,Apr-19,1,1,0
17149,user_17149,16,4,4,0,Dec-18,5,0,0
17150,user_17150,91,3,3,0,Dec-18,5,0,0
17151,user_17151,417,16,2,14,May-19,0,1,1
17152,user_17152,13645,147,2,145,May-19,0,1,1
17153,user_17153,1016,14,0,14,Mar-19,2,0,0
17154,user_17154,362,51,0,51,May-19,0,1,1
17156,user_17156,35,7,1,6,Jan-19,4,0,0
17157,user_17157,28,4,0,4,May-19,0,0,1
17158,user_17158,1118,20,2,18,May-19,0,0,1
17159,user_17159,4255,71,8,63,May-19,0,1,1
17160,user_17160,123,4,4,0,Dec-18,5,0,0
17161,user_17161,1930,38,2,36,May-19,0,1,1
17162,user_17162,11,2,2,0,Dec-18,5,0,0
17163,user_17163,10,2,0,2,Jan-19,4,0,0
17164,user_17164,189,7,2,5,Feb-19,3,0,0
17165,user_17165,16850,935,28,907,May-19,0,1,1
17166,user_17166,4504,291,2,289,May-19,0,1,1
17167,user_17167,9861,36,0,36,Apr-19,1,1,0
17168,user_17168,3153,146,5,141,May-19,0,1,1
17169,user_17169,22,2,0,2,Mar-19,2,0,0
17171,user_17171,4508,162,3,159,May-19,0,1,1
17172,user_17172,33383,96,3,93,May-19,0,1,1
17173,user_17173,811,13,3,10,May-19,0,1,1
17174,user_17174,251,9,0,9,Feb-19,3,0,0
17175,user_17175,24,8,2,6,Apr-19,1,1,0
17176,user_17176,3961,23,7,16,May-19,0,1,1
17177,user_17177,6344,66,16,50,Feb-19,3,0,0
17178,user_17178,5572,59,9,50,Apr-19,1,1,0
17181,user_17181,6259,30,3,27,May-19,0,1,1
17182,user_17182,1113,13,3,10,Apr-19,1,1,0
17183,user_17183,8254,151,16,135,Apr-19,1,1,0
17184,user_17184,185,31,4,27,Apr-19,1,1,0
17185,user_17185,103,17,0,17,Apr-19,1,1,0
17186,user_17186,8,3,3,0,Dec-18,5,0,0
17188,user_17188,1284,40,2,38,May-19,0,1,1
17189,user_17189,2368,118,4,114,May-19,0,1,1
17190,user_17190,65,3,3,0,Dec-18,5,0,0
17191,user_17191,56,4,1,3,Mar-19,2,0,0
17192,user_17192,45691,86,2,84,May-19,0,1,1
17193,user_17193,1,1,1,0,Dec-18,5,0,0
17194,user_17194,898,49,0,49,Mar-19,2,0,0
17195,user_17195,4296,35,2,33,May-19,0,1,1
17196,user_17196,292,13,8,5,Mar-19,2,0,0
17197,user_17197,4148,92,4,88,May-19,0,1,1
17198,user_17198,103,3,0,3,May-19,0,0,1
17199,user_17199,19,7,2,5,Mar-19,2,0,0
17200,user_17200,36500,123,11,112,May-19,0,1,1
17201,user_17201,2365,72,2,70,Apr-19,1,1,0
17202,user_17202,3618,40,13,27,May-19,0,1,1
17203,user_17203,4,1,1,0,Dec-18,5,0,0
17204,user_17204,12,6,0,6,Feb-19,3,0,0
17205,user_17205,1656,5,2,3,Jan-19,4,0,0
17206,user_17206,19,4,4,0,Dec-18,5,0,0
17207,user_17207,85456,25,17,8,Mar-19,2,0,0
17208,user_17208,12655,687,2,685,May-19,0,1,1
17209,user_17209,559,25,13,12,Mar-19,2,0,0
17211,user_17211,35372,121,6,115,May-19,0,1,1
17212,user_17212,1121,84,2,82,May-19,0,1,1
17213,user_17213,119827,219,2,217,May-19,0,1,1
17214,user_17214,9,2,2,0,Dec-18,5,0,0
17215,user_17215,128231,358,12,346,May-19,0,1,1
17216,user_17216,1688,67,16,51,Feb-19,3,0,0
17217,user_17217,3862,13,3,10,Jan-19,4,0,0
17218,user_17218,6779,187,19,168,May-19,0,1,1
17219,user_17219,175,26,13,13,Mar-19,2,0,0
17220,user_17220,1779,33,2,31,Apr-19,1,1,0
17221,user_17221,74,5,0,5,Jan-19,4,0,0
17222,user_17222,54,10,10,0,Dec-18,5,0,0
17223,user_17223,102,9,0,9,May-19,0,1,1
17224,user_17224,58,9,2,7,May-19,0,1,1
17225,user_17225,2041,48,4,44,May-19,0,1,1
17226,user_17226,11,2,2,0,Dec-18,5,0,0
17227,user_17227,268,37,2,35,Apr-19,1,1,0
17228,user_17228,3,4,4,0,Dec-18,5,0,0
17229,user_17229,297,21,3,18,Apr-19,1,1,0
17230,user_17230,859715,9,0,9,Mar-19,2,0,0
17231,user_17231,515,28,3,25,May-19,0,0,1
17232,user_17232,7418,29,14,15,Apr-19,1,1,0
17233,user_17233,646,32,3,29,May-19,0,1,1
17234,user_17234,1972,97,12,85,May-19,0,1,1
17235,user_17235,11,2,2,0,Dec-18,5,0,0
17236,user_17236,323,13,6,7,May-19,0,0,1
17237,user_17237,8114,58,55,3,Feb-19,3,0,0
17238,user_17238,3693,30,13,17,Mar-19,2,0,0
17239,user_17239,2107,23,23,0,Dec-18,5,0,0
17240,user_17240,4156,48,8,40,Apr-19,1,1,0
17241,user_17241,251,12,7,5,Jan-19,4,0,0
17242,user_17242,104,13,1,12,Apr-19,1,1,0
17243,user_17243,2961,136,2,134,Apr-19,1,1,0
17244,user_17244,6435,153,28,125,May-19,0,1,1
17245,user_17245,5577,146,7,139,May-19,0,1,1
17246,user_17246,526,15,2,13,Apr-19,1,1,0
17247,user_17247,9,2,2,0,Dec-18,5,0,0
17248,user_17248,17052,99,12,87,May-19,0,1,1
17249,user_17249,3881,66,3,63,May-19,0,1,1
17250,user_17250,715,41,0,41,May-19,0,1,1
17251,user_17251,9821,72,19,53,Apr-19,1,1,0
17252,user_17252,1131,33,0,33,Mar-19,2,0,0
17253,user_17253,6481,204,0,204,May-19,0,1,1
17254,user_17254,526,12,2,10,May-19,0,1,1
17255,user_17255,968,16,14,2,Jan-19,4,0,0
17256,user_17256,4017,130,21,109,May-19,0,1,1
17257,user_17257,270,12,2,10,Mar-19,2,0,0
17258,user_17258,6793,122,27,95,May-19,0,1,1
17259,user_17259,1618,36,10,26,May-19,0,1,1
17260,user_17260,3275,133,26,107,May-19,0,1,1
17261,user_17261,5397,15,6,9,Apr-19,1,1,0
17262,user_17262,145,14,2,12,May-19,0,0,1
17263,user_17263,1710,57,0,57,May-19,0,1,1
17264,user_17264,9282,290,7,283,May-19,0,1,1
17265,user_17265,771,34,0,34,May-19,0,1,1
17266,user_17266,14649,164,2,162,May-19,0,1,1
17268,user_17268,350,18,3,15,Mar-19,2,0,0
17269,user_17269,27,3,1,2,Feb-19,3,0,0
17270,user_17270,9,2,2,0,Dec-18,5,0,0
17271,user_17271,1429,154,15,139,May-19,0,1,1
17272,user_17272,660,17,5,12,Feb-19,3,0,0
17273,user_17273,2452,302,7,295,May-19,0,1,1
17274,user_17274,438,32,0,32,May-19,0,1,1
17275,user_17275,24983,709,86,623,May-19,0,1,1
17276,user_17276,34,8,1,7,May-19,0,0,1
17277,user_17277,6878,213,2,211,May-19,0,1,1
17278,user_17278,19,5,0,5,Feb-19,3,0,0
17279,user_17279,981,43,0,43,May-19,0,1,1
17280,user_17280,1041,77,14,63,Apr-19,1,1,0
17281,user_17281,12519,98,2,96,May-19,0,1,1
17282,user_17282,1359,31,0,31,Feb-19,3,0,0
17283,user_17283,6276,291,2,289,May-19,0,1,1
17284,user_17284,1102,42,17,25,Apr-19,1,1,0
17285,user_17285,35654,50,3,47,May-19,0,1,1
17286,user_17286,333,3,3,0,Dec-18,5,0,0
17287,user_17287,2838,115,0,115,May-19,0,1,1
17288,user_17288,6593,47,3,44,May-19,0,1,1
17289,user_17289,555,59,19,40,Apr-19,1,1,0
17290,user_17290,2567,56,2,54,May-19,0,1,1
17291,user_17291,1664,64,6,58,May-19,0,1,1
17292,user_17292,5311,263,2,261,May-19,0,1,1
17293,user_17293,672,22,2,20,Apr-19,1,1,0
17294,user_17294,78,11,0,11,May-19,0,1,1
17295,user_17295,31218,156,2,154,May-19,0,1,1
17296,user_17296,9,1,1,0,Dec-18,5,0,0
17297,user_17297,60,14,0,14,Apr-19,1,1,0
17298,user_17298,3,4,4,0,Dec-18,5,0,0
17300,user_17300,10,9,2,7,Feb-19,3,0,0
17301,user_17301,6,4,4,0,Dec-18,5,0,0
17302,user_17302,10,1,1,0,Dec-18,5,0,0
17303,user_17303,137,6,0,6,May-19,0,0,1
17304,user_17304,195009,76,15,61,May-19,0,1,1
17305,user_17305,1269,69,7,62,May-19,0,1,1
17306,user_17306,203,8,0,8,Mar-19,2,0,0
17307,user_17307,14289,86,5,81,May-19,0,1,1
17308,user_17308,198,28,0,28,Jan-19,4,0,0
17309,user_17309,524,67,52,15,May-19,0,0,1
17310,user_17310,894,29,9,20,Apr-19,1,1,0
17311,user_17311,31,5,3,2,Apr-19,1,1,0
17312,user_17312,9497,739,3,736,May-19,0,1,1
17313,user_17313,6285,94,2,92,May-19,0,1,1
17314,user_17314,187,10,3,7,Apr-19,1,1,0
17316,user_17316,63342,92,6,86,May-19,0,1,1
17317,user_17317,767,8,0,8,May-19,0,0,1
17319,user_17319,1453,33,9,24,May-19,0,1,1
17320,user_17320,5661,260,49,211,May-19,0,1,1
17321,user_17321,2834,47,2,45,Mar-19,2,0,0
17322,user_17322,5751,63,3,60,May-19,0,1,1
17323,user_17323,845,11,2,9,Apr-19,1,1,0
17324,user_17324,12,3,0,3,Jan-19,4,0,0
17325,user_17325,111,16,0,16,May-19,0,0,1
17327,user_17327,857,37,0,37,Feb-19,3,0,0
17328,user_17328,798,31,0,31,Feb-19,3,0,0
17329,user_17329,10594,298,31,267,May-19,0,1,1
17330,user_17330,3451,44,26,18,May-19,0,0,1
17331,user_17331,587,50,28,22,Jan-19,4,0,0
17333,user_17333,672,10,0,10,May-19,0,0,1
17334,user_17334,2044,87,0,87,May-19,0,1,1
17335,user_17335,186,5,4,1,Jan-19,4,0,0
17336,user_17336,80,8,4,4,May-19,0,0,1
17337,user_17337,426,5,5,0,Dec-18,5,0,0
17338,user_17338,20,2,2,0,Dec-18,5,0,0
17339,user_17339,46,5,0,5,Mar-19,2,0,0
17340,user_17340,1124,29,0,29,Apr-19,1,1,0
17341,user_17341,372,11,2,9,Jan-19,4,0,0
17342,user_17342,8,4,2,2,May-19,0,0,1
17343,user_17343,9,2,0,2,Feb-19,3,0,0
17344,user_17344,1438,28,2,26,Apr-19,1,1,0
17345,user_17345,67,11,8,3,Jan-19,4,0,0
17346,user_17346,40,6,5,1,Feb-19,3,0,0
17347,user_17347,1402,35,2,33,May-19,0,1,1
17349,user_17349,2194,54,2,52,Apr-19,1,1,0
17350,user_17350,504,40,1,39,Apr-19,1,1,0
17351,user_17351,1,1,1,0,Dec-18,5,0,0
17352,user_17352,398,20,3,17,Mar-19,2,0,0
17353,user_17353,9558,179,0,179,May-19,0,1,1
17354,user_17354,1696,225,7,218,May-19,0,1,1
17355,user_17355,37,5,1,4,Jan-19,4,0,0
17356,user_17356,6141,119,0,119,May-19,0,1,1
17357,user_17357,100,13,3,10,Jan-19,4,0,0
17358,user_17358,180,7,2,5,Apr-19,1,1,0
17359,user_17359,13256,228,2,226,May-19,0,1,1
17361,user_17361,1235,14,0,14,Mar-19,2,0,0
17362,user_17362,18824,589,2,587,May-19,0,1,1
17363,user_17363,11,2,2,0,Dec-18,5,0,0
17364,user_17364,47,5,0,5,May-19,0,1,1
17366,user_17366,639,4,4,0,Dec-18,5,0,0
17367,user_17367,2083,72,9,63,May-19,0,1,1
17368,user_17368,335,32,4,28,May-19,0,1,1
17369,user_17369,3249,374,11,363,May-19,0,1,1
17370,user_17370,6049,542,2,540,May-19,0,1,1
17371,user_17371,12322,211,5,206,May-19,0,1,1
17372,user_17372,8718,261,71,190,May-19,0,1,1
17373,user_17373,681589,374,0,374,May-19,0,1,1
17374,user_17374,66,11,2,9,Apr-19,1,1,0
17375,user_17375,14,7,7,0,Dec-18,5,0,0
17376,user_17376,166,12,5,7,May-19,0,0,1
17377,user_17377,7424,124,18,106,May-19,0,1,1
17378,user_17378,7856,71,5,66,Mar-19,2,0,0
17379,user_17379,74096,86,5,81,May-19,0,1,1
17381,user_17381,9,2,2,0,Dec-18,5,0,0
17382,user_17382,86,2,2,0,Dec-18,5,0,0
17383,user_17383,2771,124,7,117,May-19,0,1,1
17384,user_17384,1330,62,5,57,Apr-19,1,1,0
17385,user_17385,1385,25,5,20,Mar-19,2,0,0
17386,user_17386,3945,241,2,239,May-19,0,1,1
17387,user_17387,677,47,3,44,Apr-19,1,1,0
17388,user_17388,742,47,2,45,May-19,0,1,1
17389,user_17389,113,11,2,9,May-19,0,1,1
17390,user_17390,132,6,0,6,Apr-19,1,1,0
17392,user_17392,1609,73,6,67,Apr-19,1,1,0
17393,user_17393,121,14,7,7,Apr-19,1,1,0
17394,user_17394,1852,78,5,73,May-19,0,1,1
17395,user_17395,1597,100,13,87,May-19,0,1,1
17396,user_17396,295,8,4,4,Apr-19,1,1,0
17397,user_17397,10607,399,0,399,May-19,0,1,1
17398,user_17398,4937,389,0,389,May-19,0,1,1
17399,user_17399,3371,267,9,258,May-19,0,1,1
17400,user_17400,645,36,4,32,May-19,0,0,1
17401,user_17401,8479,47,5,42,Feb-19,3,0,0
17402,user_17402,3757,37,2,35,May-19,0,1,1
17403,user_17403,9845,62,13,49,May-19,0,1,1
17404,user_17404,9,2,2,0,Dec-18,5,0,0
17405,user_17405,23001,92,8,84,May-19,0,1,1
17406,user_17406,29,5,0,5,May-19,0,0,1
17407,user_17407,1402,58,0,58,Apr-19,1,1,0
17408,user_17408,374,19,3,16,May-19,0,1,1
17409,user_17409,10826,79,0,79,May-19,0,1,1
17410,user_17410,155,48,0,48,May-19,0,1,1
17411,user_17411,705,37,6,31,May-19,0,1,1
17412,user_17412,5757,101,10,91,May-19,0,1,1
17413,user_17413,10,3,0,3,Jan-19,4,0,0
17414,user_17414,9,2,2,0,Dec-18,5,0,0
17415,user_17415,6795,356,36,320,May-19,0,1,1
17416,user_17416,2465,55,0,55,Apr-19,1,1,0
17417,user_17417,86,25,0,25,May-19,0,1,1
17418,user_17418,308,33,2,31,Apr-19,1,1,0
17419,user_17419,1,1,1,0,Dec-18,5,0,0
17420,user_17420,5888,55,19,36,May-19,0,1,1
17421,user_17421,1006,39,2,37,Mar-19,2,0,0
17422,user_17422,492,45,9,36,May-19,0,1,1
17423,user_17423,172,4,4,0,Dec-18,5,0,0
17424,user_17424,18,2,2,0,Dec-18,5,0,0
17425,user_17425,9,2,2,0,Dec-18,5,0,0
17426,user_17426,16,3,0,3,Apr-19,1,1,0
17428,user_17428,1445,146,17,129,Mar-19,2,0,0
17429,user_17429,3219,62,17,45,May-19,0,1,1
17430,user_17430,412,5,5,0,Dec-18,5,0,0
17431,user_17431,587,16,3,13,Apr-19,1,1,0
17432,user_17432,17063,87,13,74,Apr-19,1,1,0
17433,user_17433,186,8,2,6,Jan-19,4,0,0
17434,user_17434,1295,23,9,14,Mar-19,2,0,0
17435,user_17435,158,8,2,6,Jan-19,4,0,0
17436,user_17436,131,16,9,7,Apr-19,1,1,0
17437,user_17437,192,9,2,7,May-19,0,0,1
17438,user_17438,83,19,3,16,Apr-19,1,1,0
17439,user_17439,16701,546,11,535,May-19,0,1,1
17440,user_17440,1034,34,0,34,Apr-19,1,1,0
17441,user_17441,8197,59,0,59,May-19,0,1,1
17442,user_17442,2445,45,2,43,Apr-19,1,1,0
17443,user_17443,15962,62,4,58,May-19,0,1,1
17444,user_17444,2268,155,2,153,May-19,0,1,1
17445,user_17445,6823,146,12,134,May-19,0,1,1
17446,user_17446,4727,65,25,40,Jan-19,4,0,0
17447,user_17447,1583,55,5,50,May-19,0,1,1
17448,user_17448,96,7,3,4,Feb-19,3,0,0
17449,user_17449,10,1,1,0,Dec-18,5,0,0
17450,user_17450,1699,18,2,16,May-19,0,1,1
17451,user_17451,9,2,2,0,Dec-18,5,0,0
17452,user_17452,1528,31,2,29,May-19,0,1,1
17453,user_17453,558,17,4,13,May-19,0,1,1
17454,user_17454,8587,143,2,141,May-19,0,1,1
17455,user_17455,4199,258,8,250,May-19,0,1,1
17456,user_17456,2440,115,18,97,May-19,0,1,1
17457,user_17457,1487,29,3,26,May-19,0,1,1
17458,user_17458,4214,78,17,61,May-19,0,1,1
17459,user_17459,12483,83,4,79,Apr-19,1,1,0
17460,user_17460,795,37,0,37,Mar-19,2,0,0
17461,user_17461,205,28,1,27,May-19,0,1,1
17462,user_17462,21,3,3,0,Dec-18,5,0,0
17463,user_17463,272,10,0,10,May-19,0,1,1
17464,user_17464,1669,43,4,39,May-19,0,1,1
17465,user_17465,262,93,1,92,May-19,0,1,1
17467,user_17467,732,36,2,34,Mar-19,2,0,0
17468,user_17468,67,8,2,6,Jan-19,4,0,0
17469,user_17469,14,3,2,1,Mar-19,2,0,0
17470,user_17470,185,5,3,2,Feb-19,3,0,0
17472,user_17472,16,5,0,5,Feb-19,3,0,0
17474,user_17474,1932,68,7,61,Apr-19,1,1,0
17475,user_17475,8,2,2,0,Dec-18,5,0,0
17476,user_17476,9,2,2,0,Dec-18,5,0,0
17477,user_17477,776,57,5,52,May-19,0,1,1
17478,user_17478,18,4,4,0,Dec-18,5,0,0
17479,user_17479,3642,100,2,98,May-19,0,1,1
17480,user_17480,501,7,2,5,Jan-19,4,0,0
17481,user_17481,248,32,10,22,May-19,0,1,1
17482,user_17482,30,10,2,8,Feb-19,3,0,0
17483,user_17483,10545,117,2,115,May-19,0,0,1
17484,user_17484,5603,334,12,322,May-19,0,1,1
17485,user_17485,2124,39,2,37,May-19,0,1,1
17486,user_17486,1789,40,3,37,Apr-19,1,1,0
17487,user_17487,699,6,6,0,Dec-18,5,0,0
17488,user_17488,32,4,0,4,Feb-19,3,0,0
17489,user_17489,16760,581,2,579,May-19,0,1,1
17490,user_17490,1,1,0,1,May-19,0,0,1
17491,user_17491,2489,88,2,86,May-19,0,1,1
17492,user_17492,304,16,2,14,Apr-19,1,1,0
17493,user_17493,12,3,0,3,Mar-19,2,0,0
17494,user_17494,1578,63,12,51,May-19,0,1,1
17495,user_17495,5,2,0,2,Apr-19,1,1,0
17496,user_17496,1043,112,16,96,May-19,0,1,1
17498,user_17498,843,21,3,18,May-19,0,1,1
17499,user_17499,595,42,3,39,May-19,0,1,1
17500,user_17500,53275,150,5,145,May-19,0,1,1
17501,user_17501,894,66,0,66,Mar-19,2,0,0
17502,user_17502,43,2,2,0,Dec-18,5,0,0
17503,user_17503,288,12,2,10,Mar-19,2,0,0
17504,user_17504,4510,83,14,69,Apr-19,1,1,0
17505,user_17505,18510,43,2,41,May-19,0,1,1
17508,user_17508,11581,247,9,238,May-19,0,1,1
17509,user_17509,2046,285,2,283,May-19,0,1,1
17510,user_17510,8653,12,12,0,Dec-18,5,0,0
17511,user_17511,11,2,2,0,Dec-18,5,0,0
17512,user_17512,1451,23,0,23,May-19,0,1,1
17513,user_17513,20299,440,12,428,May-19,0,1,1
17514,user_17514,3276,44,6,38,May-19,0,1,1
17515,user_17515,118,6,3,3,Jan-19,4,0,0
17516,user_17516,27,5,5,0,Dec-18,5,0,0
17517,user_17517,5249,64,7,57,May-19,0,1,1
17518,user_17518,1114,52,2,50,Apr-19,1,1,0
17519,user_17519,31,4,2,2,Mar-19,2,0,0
17520,user_17520,603,50,0,50,May-19,0,1,1
17521,user_17521,243,14,4,10,May-19,0,0,1
17522,user_17522,6573,96,0,96,May-19,0,1,1
17523,user_17523,2208,26,2,24,May-19,0,1,1
17524,user_17524,14647,260,3,257,May-19,0,1,1
17525,user_17525,2230,259,2,257,May-19,0,1,1
17526,user_17526,849,34,0,34,Apr-19,1,1,0
17527,user_17527,2861,182,6,176,May-19,0,1,1
17528,user_17528,1,2,0,2,Jan-19,4,0,0
17529,user_17529,7533,165,37,128,May-19,0,1,1
17531,user_17531,1049,20,2,18,Apr-19,1,1,0
17532,user_17532,1567,46,5,41,Apr-19,1,1,0
17533,user_17533,2172,19,5,14,May-19,0,1,1
17534,user_17534,20,1,1,0,Dec-18,5,0,0
17535,user_17535,148,11,0,11,May-19,0,1,1
17536,user_17536,3570,152,9,143,May-19,0,1,1
17537,user_17537,16318,68,9,59,May-19,0,1,1
17538,user_17538,155,12,1,11,Apr-19,1,1,0
17540,user_17540,57,15,0,15,May-19,0,1,1
17541,user_17541,32,6,2,4,Apr-19,1,1,0
17542,user_17542,421,18,3,15,Mar-19,2,0,0
17543,user_17543,126,6,3,3,Jan-19,4,0,0
17544,user_17544,28,5,0,5,Jan-19,4,0,0
17545,user_17545,1350,52,2,50,Mar-19,2,0,0
17546,user_17546,4,3,3,0,Dec-18,5,0,0
17547,user_17547,960,92,3,89,Mar-19,2,0,0
17548,user_17548,374,51,1,50,May-19,0,1,1
17549,user_17549,603,45,14,31,Apr-19,1,1,0
17550,user_17550,18,3,3,0,Dec-18,5,0,0
17551,user_17551,2387,32,2,30,Apr-19,1,1,0
17552,user_17552,657,24,2,22,May-19,0,1,1
17553,user_17553,2310,26,14,12,May-19,0,1,1
17554,user_17554,15547,83,2,81,May-19,0,1,1
17555,user_17555,11,2,2,0,Dec-18,5,0,0
17556,user_17556,6300,500,6,494,May-19,0,1,1
17557,user_17557,275,22,15,7,Feb-19,3,0,0
17558,user_17558,762,90,9,81,May-19,0,1,1
17559,user_17559,23866,203,2,201,May-19,0,1,1
17560,user_17560,9,2,2,0,Dec-18,5,0,0
17562,user_17562,9689,168,27,141,Apr-19,1,1,0
17563,user_17563,8077,53,2,51,May-19,0,1,1
17565,user_17565,632,23,4,19,Apr-19,1,1,0
17566,user_17566,295,17,3,14,Apr-19,1,1,0
17567,user_17567,1784,62,7,55,May-19,0,1,1
17568,user_17568,35,12,0,12,Apr-19,1,1,0
17569,user_17569,2647,36,0,36,May-19,0,1,1
17570,user_17570,43,5,0,5,May-19,0,1,1
17571,user_17571,281,5,0,5,Apr-19,1,1,0
17572,user_17572,31702,207,3,204,May-19,0,1,1
17573,user_17573,1335,141,1,140,May-19,0,1,1
17574,user_17574,11,2,2,0,Dec-18,5,0,0
17575,user_17575,17951,288,0,288,May-19,0,1,1
17576,user_17576,311,10,2,8,May-19,0,0,1
17577,user_17577,155,10,0,10,May-19,0,1,1
17578,user_17578,2623,181,12,169,Apr-19,1,1,0
17579,user_17579,9,2,2,0,Dec-18,5,0,0
17580,user_17580,1056,30,2,28,May-19,0,1,1
17581,user_17581,1347,23,4,19,Apr-19,1,1,0
17582,user_17582,4,1,1,0,Dec-18,5,0,0
17583,user_17583,6686,292,3,289,May-19,0,1,1
17585,user_17585,18,3,3,0,Dec-18,5,0,0
17586,user_17586,685,35,7,28,Apr-19,1,1,0
17587,user_17587,1147,91,4,87,May-19,0,1,1
17588,user_17588,683,60,2,58,May-19,0,1,1
17590,user_17590,2428,13,9,4,Apr-19,1,1,0
17591,user_17591,16599,208,3,205,May-19,0,1,1
17592,user_17592,3570,50,7,43,Apr-19,1,1,0
17593,user_17593,400,18,4,14,May-19,0,0,1
17594,user_17594,2125,27,7,20,Apr-19,1,1,0
17595,user_17595,23,5,4,1,Jan-19,4,0,0
17597,user_17597,11209,399,23,376,May-19,0,1,1
17598,user_17598,470,14,8,6,May-19,0,0,1
17599,user_17599,7082,87,0,87,Apr-19,1,1,0
17600,user_17600,16044,886,20,866,May-19,0,1,1
17601,user_17601,2309,106,16,90,May-19,0,1,1
17602,user_17602,4287,112,4,108,May-19,0,1,1
17603,user_17603,8410,38,4,34,May-19,0,1,1
17604,user_17604,123,4,0,4,Jan-19,4,0,0
17605,user_17605,775,15,0,15,Mar-19,2,0,0
17606,user_17606,8,4,3,1,Apr-19,1,1,0
17607,user_17607,59107,19,4,15,May-19,0,0,1
17609,user_17609,2720,38,2,36,Apr-19,1,1,0
17610,user_17610,255,31,5,26,Apr-19,1,1,0
17612,user_17612,199,10,2,8,Jan-19,4,0,0
17613,user_17613,1230,62,2,60,May-19,0,1,1
17614,user_17614,4,1,1,0,Dec-18,5,0,0
17615,user_17615,7085,77,11,66,May-19,0,1,1
17616,user_17616,13475,668,0,668,May-19,0,1,1
17617,user_17617,2865,99,2,97,May-19,0,1,1
17618,user_17618,3644,41,0,41,Apr-19,1,1,0
17619,user_17619,299,18,4,14,May-19,0,0,1
17620,user_17620,334,4,4,0,Dec-18,5,0,0
17621,user_17621,536,32,0,32,May-19,0,1,1
17622,user_17622,1624,39,2,37,Apr-19,1,1,0
17623,user_17623,936,88,0,88,May-19,0,1,1
17624,user_17624,18,3,3,0,Dec-18,5,0,0
17625,user_17625,817,11,1,10,Mar-19,2,0,0
17626,user_17626,18,5,5,0,Dec-18,5,0,0
17627,user_17627,366,15,9,6,Apr-19,1,1,0
17628,user_17628,5350,405,1,404,May-19,0,1,1
17629,user_17629,29772,120,21,99,May-19,0,1,1
17630,user_17630,615,18,5,13,Apr-19,1,1,0
17631,user_17631,46,9,6,3,May-19,0,0,1
17632,user_17632,1610,132,6,126,May-19,0,1,1
17633,user_17633,1476,23,13,10,May-19,0,1,1
17634,user_17634,10728,243,2,241,May-19,0,1,1
17635,user_17635,8788,190,8,182,May-19,0,1,1
17636,user_17636,514,17,3,14,Apr-19,1,1,0
17637,user_17637,58,4,4,0,Dec-18,5,0,0
17638,user_17638,13960,286,9,277,May-19,0,1,1
17639,user_17639,1438,13,2,11,Jan-19,4,0,0
17640,user_17640,792,55,0,55,May-19,0,1,1
17641,user_17641,1246,208,0,208,May-19,0,1,1
17644,user_17644,2315,25,2,23,Mar-19,2,0,0
17645,user_17645,34,7,4,3,Feb-19,3,0,0
17646,user_17646,245,3,3,0,Dec-18,5,0,0
17647,user_17647,2616,42,3,39,May-19,0,1,1
17648,user_17648,824,129,3,126,May-19,0,1,1
17649,user_17649,1459,76,0,76,May-19,0,1,1
17650,user_17650,50,4,0,4,Feb-19,3,0,0
17651,user_17651,28331,333,5,328,May-19,0,1,1
17652,user_17652,1114,49,0,49,May-19,0,1,1
17653,user_17653,2621,245,13,232,May-19,0,1,1
17654,user_17654,410,10,2,8,May-19,0,1,1
17655,user_17655,993,87,0,87,May-19,0,1,1
17656,user_17656,4536,62,17,45,May-19,0,1,1
17657,user_17657,196,18,0,18,Apr-19,1,1,0
17658,user_17658,12057,207,4,203,May-19,0,1,1
17659,user_17659,12649,57,7,50,Apr-19,1,1,0
17660,user_17660,8426,31,2,29,May-19,0,1,1
17661,user_17661,148292,341,5,336,May-19,0,1,1
17662,user_17662,205,26,2,24,Apr-19,1,1,0
17663,user_17663,1741,59,4,55,May-19,0,1,1
17664,user_17664,579,24,3,21,May-19,0,1,1
17665,user_17665,2979,123,4,119,May-19,0,1,1
17666,user_17666,1449,45,4,41,May-19,0,1,1
17667,user_17667,12,3,2,1,Jan-19,4,0,0
17668,user_17668,11,2,2,0,Dec-18,5,0,0
17669,user_17669,16681,93,7,86,Apr-19,1,1,0
17670,user_17670,55,21,0,21,Apr-19,1,1,0
17671,user_17671,6097,120,2,118,May-19,0,1,1
17672,user_17672,18,3,3,0,Dec-18,5,0,0
17673,user_17673,2683,259,2,257,May-19,0,1,1
17674,user_17674,88,7,4,3,Jan-19,4,0,0
17675,user_17675,247,23,0,23,May-19,0,1,1
17677,user_17677,259,26,4,22,Apr-19,1,1,0
17678,user_17678,27,8,2,6,Mar-19,2,0,0
17679,user_17679,2244,33,1,32,Feb-19,3,0,0
17680,user_17680,847,25,2,23,Apr-19,1,1,0
17681,user_17681,4,1,1,0,Dec-18,5,0,0
17682,user_17682,1090,27,6,21,Mar-19,2,0,0
17683,user_17683,0,1,1,0,Dec-18,5,0,0
17684,user_17684,5,3,2,1,Apr-19,1,1,0
17685,user_17685,3461,69,2,67,May-19,0,1,1
17686,user_17686,8791,194,19,175,May-19,0,1,1
17687,user_17687,125043,87,1,86,May-19,0,1,1
17688,user_17688,3569,267,3,264,May-19,0,1,1
17689,user_17689,7091,311,0,311,May-19,0,1,1
17690,user_17690,13,4,3,1,Jan-19,4,0,0
17691,user_17691,70,8,4,4,May-19,0,1,1
17692,user_17692,1427,81,16,65,May-19,0,1,1
17693,user_17693,4196,18,6,12,Mar-19,2,0,0
17694,user_17694,15191,262,2,260,Apr-19,1,1,0
17695,user_17695,2033,22,7,15,Apr-19,1,1,0
17696,user_17696,0,2,2,0,Dec-18,5,0,0
17697,user_17697,684,88,3,85,May-19,0,1,1
17698,user_17698,105,19,8,11,May-19,0,0,1
17699,user_17699,8848,24,0,24,Mar-19,2,0,0
17700,user_17700,1866,63,5,58,May-19,0,1,1
17701,user_17701,552,51,5,46,May-19,0,1,1
17702,user_17702,293,26,2,24,Mar-19,2,0,0
17703,user_17703,7,9,0,9,Apr-19,1,1,0
17704,user_17704,18,2,2,0,Dec-18,5,0,0
17705,user_17705,273,35,2,33,May-19,0,1,1
17706,user_17706,93,20,1,19,May-19,0,1,1
17707,user_17707,78,15,3,12,Apr-19,1,1,0
17708,user_17708,203,21,8,13,May-19,0,1,1
17709,user_17709,896,118,13,105,May-19,0,1,1
17710,user_17710,16967,215,3,212,May-19,0,1,1
17711,user_17711,1535,57,34,23,Mar-19,2,0,0
17712,user_17712,60,4,2,2,May-19,0,0,1
17713,user_17713,4238,85,0,85,May-19,0,1,1
17715,user_17715,461,33,9,24,Apr-19,1,1,0
17716,user_17716,6109,234,103,131,May-19,0,1,1
17717,user_17717,636,15,3,12,May-19,0,1,1
17719,user_17719,123,25,2,23,May-19,0,1,1
17720,user_17720,1476,81,5,76,May-19,0,1,1
17721,user_17721,6378,349,2,347,May-19,0,1,1
17722,user_17722,2011,62,3,59,May-19,0,1,1
17723,user_17723,215,7,0,7,May-19,0,1,1
17724,user_17724,805,88,3,85,May-19,0,1,1
17725,user_17725,1762,50,20,30,May-19,0,1,1
17726,user_17726,27,5,5,0,Dec-18,5,0,0
17727,user_17727,1441,22,7,15,Feb-19,3,0,0
17728,user_17728,520,18,3,15,Mar-19,2,0,0
17729,user_17729,9,2,2,0,Dec-18,5,0,0
17730,user_17730,3224,272,6,266,May-19,0,1,1
17731,user_17731,1060,5,0,5,Mar-19,2,0,0
17732,user_17732,1968,58,1,57,Apr-19,1,1,0
17733,user_17733,310,5,0,5,May-19,0,1,1
17734,user_17734,1697,335,76,259,Apr-19,1,1,0
17735,user_17735,6572,276,8,268,May-19,0,1,1
17736,user_17736,15228,234,22,212,May-19,0,1,1
17737,user_17737,3079,17,4,13,Jan-19,4,0,0
17739,user_17739,9,2,0,2,Jan-19,4,0,0
17740,user_17740,5307,186,49,137,May-19,0,1,1
17741,user_17741,3201,55,2,53,Apr-19,1,1,0
17742,user_17742,295,35,2,33,Apr-19,1,1,0
17743,user_17743,11,2,2,0,Dec-18,5,0,0
17745,user_17745,2332,54,16,38,May-19,0,1,1
17746,user_17746,34,15,0,15,Apr-19,1,1,0
17747,user_17747,21,3,2,1,Jan-19,4,0,0
17748,user_17748,10007,140,2,138,May-19,0,1,1
17749,user_17749,547,49,0,49,May-19,0,1,1
17750,user_17750,12,11,2,9,Feb-19,3,0,0
17751,user_17751,13445,456,5,451,May-19,0,1,1
17752,user_17752,5031,88,9,79,May-19,0,1,1
17753,user_17753,12052,20,13,7,Apr-19,1,1,0
17754,user_17754,97,16,1,15,Apr-19,1,1,0
17755,user_17755,490,43,10,33,May-19,0,1,1
17756,user_17756,11358,127,11,116,May-19,0,1,1
17757,user_17757,1703,43,2,41,May-19,0,1,1
17758,user_17758,798,20,2,18,May-19,0,0,1
17759,user_17759,1714,207,2,205,May-19,0,1,1
17760,user_17760,1454,45,2,43,Apr-19,1,1,0
17761,user_17761,266,36,8,28,May-19,0,1,1
17762,user_17762,9603,67,4,63,May-19,0,1,1
17763,user_17763,1298,37,8,29,May-19,0,1,1
17764,user_17764,644,25,0,25,May-19,0,1,1
17765,user_17765,851,29,5,24,Mar-19,2,0,0
17766,user_17766,3022,81,3,78,Apr-19,1,1,0
17767,user_17767,682,44,2,42,May-19,0,1,1
17768,user_17768,2383,149,30,119,May-19,0,1,1
17769,user_17769,8043,340,2,338,May-19,0,1,1
17770,user_17770,10526,41,2,39,May-19,0,1,1
17771,user_17771,1474,54,8,46,May-19,0,1,1
17772,user_17772,1719,16,6,10,Apr-19,1,1,0
17773,user_17773,24420,348,2,346,May-19,0,1,1
17775,user_17775,4857,17,1,16,May-19,0,1,1
17776,user_17776,1029,50,2,48,Apr-19,1,1,0
17777,user_17777,2295,140,5,135,May-19,0,1,1
17778,user_17778,516,20,0,20,May-19,0,1,1
17779,user_17779,2336,124,0,124,May-19,0,1,1
17780,user_17780,221,21,5,16,May-19,0,1,1
17781,user_17781,1118,61,4,57,Apr-19,1,1,0
17782,user_17782,17,2,1,1,May-19,0,0,1
17783,user_17783,34,3,0,3,May-19,0,0,1
17784,user_17784,3233,53,2,51,Feb-19,3,0,0
17785,user_17785,4794,306,0,306,May-19,0,1,1
17786,user_17786,3432,24,2,22,Mar-19,2,0,0
17787,user_17787,11,3,2,1,Feb-19,3,0,0
17788,user_17788,141,18,0,18,Apr-19,1,1,0
17789,user_17789,83,11,7,4,Feb-19,3,0,0
17790,user_17790,340,4,0,4,Feb-19,3,0,0
17791,user_17791,1724,55,1,54,May-19,0,1,1
17792,user_17792,983,12,3,9,May-19,0,1,1
17793,user_17793,535,28,2,26,Apr-19,1,1,0
17794,user_17794,18,3,2,1,Jan-19,4,0,0
17795,user_17795,1296,51,3,48,Feb-19,3,0,0
17796,user_17796,260,10,1,9,May-19,0,0,1
17797,user_17797,2336,47,3,44,May-19,0,1,1
17798,user_17798,1674,78,41,37,May-19,0,1,1
17799,user_17799,7324,184,2,182,May-19,0,1,1
17800,user_17800,1507,49,6,43,May-19,0,1,1
17801,user_17801,1369,87,0,87,Apr-19,1,1,0
17802,user_17802,1535,57,2,55,May-19,0,1,1
17803,user_17803,180,5,2,3,Mar-19,2,0,0
17804,user_17804,1236,51,4,47,May-19,0,1,1
17805,user_17805,4528,60,3,57,May-19,0,1,1
17806,user_17806,420,15,1,14,May-19,0,1,1
17807,user_17807,28,11,1,10,Apr-19,1,1,0
17808,user_17808,2484,202,6,196,May-19,0,1,1
17809,user_17809,1179,117,24,93,May-19,0,1,1
17810,user_17810,4377,144,4,140,May-19,0,1,1
17812,user_17812,25,3,2,1,Jan-19,4,0,0
17813,user_17813,197,5,3,2,Apr-19,1,1,0
17814,user_17814,177,14,13,1,Mar-19,2,0,0
17815,user_17815,12,3,2,1,Jan-19,4,0,0
17816,user_17816,1,1,1,0,Dec-18,5,0,0
17817,user_17817,934,45,0,45,May-19,0,1,1
17818,user_17818,1079,72,13,59,May-19,0,0,1
17819,user_17819,732858,22,3,19,Apr-19,1,1,0
17820,user_17820,2266,125,2,123,May-19,0,1,1
17821,user_17821,1176,38,2,36,May-19,0,1,1
17822,user_17822,1659,197,3,194,May-19,0,1,1
17823,user_17823,39,5,5,0,Dec-18,5,0,0
17824,user_17824,3,3,2,1,Mar-19,2,0,0
17825,user_17825,551,16,2,14,Apr-19,1,1,0
17826,user_17826,4413,104,2,102,May-19,0,1,1
17827,user_17827,2586,58,31,27,Apr-19,1,1,0
17828,user_17828,1299,15,2,13,Apr-19,1,1,0
17829,user_17829,804,8,2,6,Mar-19,2,0,0
17830,user_17830,1554,50,12,38,Apr-19,1,1,0
17831,user_17831,3288,30,5,25,May-19,0,1,1
17833,user_17833,37,8,8,0,Dec-18,5,0,0
17834,user_17834,15249,277,16,261,May-19,0,1,1
17835,user_17835,7117,52,2,50,May-19,0,1,1
17836,user_17836,9,2,2,0,Dec-18,5,0,0
17837,user_17837,161,3,3,0,Dec-18,5,0,0
17838,user_17838,16,3,0,3,Jan-19,4,0,0
17839,user_17839,301,14,0,14,Apr-19,1,1,0
17840,user_17840,1958,98,16,82,May-19,0,1,1
17841,user_17841,5833,478,3,475,May-19,0,1,1
17843,user_17843,2214,83,8,75,May-19,0,1,1
17844,user_17844,11,2,2,0,Dec-18,5,0,0
17845,user_17845,16,8,1,7,Jan-19,4,0,0
17846,user_17846,574,47,3,44,Apr-19,1,1,0
17847,user_17847,89,16,3,13,May-19,0,0,1
17848,user_17848,452,18,11,7,Apr-19,1,1,0
17849,user_17849,900,59,0,59,May-19,0,1,1
17850,user_17850,66,8,1,7,Feb-19,3,0,0
17851,user_17851,5609,116,10,106,May-19,0,1,1
17852,user_17852,932,38,10,28,May-19,0,1,1
17853,user_17853,740,24,2,22,Mar-19,2,0,0
17854,user_17854,18,3,3,0,Dec-18,5,0,0
17855,user_17855,1315,15,1,14,Apr-19,1,1,0
17856,user_17856,372,25,2,23,May-19,0,1,1
17857,user_17857,25150,249,4,245,Mar-19,2,0,0
17858,user_17858,16438,132,35,97,Apr-19,1,1,0
17859,user_17859,7108,341,35,306,May-19,0,1,1
17860,user_17860,362,10,4,6,Jan-19,4,0,0
17861,user_17861,69,9,9,0,Dec-18,5,0,0
17863,user_17863,10,3,0,3,Mar-19,2,0,0
17864,user_17864,822,41,33,8,Feb-19,3,0,0
17865,user_17865,473,15,3,12,May-19,0,1,1
17866,user_17866,14,3,2,1,Jan-19,4,0,0
17867,user_17867,1897,49,0,49,Feb-19,3,0,0
17868,user_17868,7280,359,90,269,May-19,0,1,1
17869,user_17869,52,3,1,2,Apr-19,1,1,0
17870,user_17870,80,10,0,10,Apr-19,1,1,0
17871,user_17871,9479,168,2,166,May-19,0,1,1
17872,user_17872,25428,498,104,394,May-19,0,1,1
17873,user_17873,880,33,10,23,Apr-19,1,1,0
17874,user_17874,17,1,0,1,Jan-19,4,0,0
17875,user_17875,864,12,4,8,Apr-19,1,1,0
17876,user_17876,1880,22,0,22,May-19,0,1,1
17877,user_17877,1554,36,2,34,Apr-19,1,1,0
17878,user_17878,429,19,8,11,Apr-19,1,1,0
17879,user_17879,935,135,1,134,Feb-19,3,0,0
17880,user_17880,2118,38,7,31,May-19,0,1,1
17882,user_17882,23,4,0,4,Mar-19,2,0,0
17883,user_17883,1898,27,2,25,May-19,0,1,1
17884,user_17884,1721,122,27,95,May-19,0,1,1
17885,user_17885,170,77,0,77,May-19,0,1,1
17887,user_17887,567,20,2,18,Apr-19,1,1,0
17888,user_17888,1790,58,1,57,May-19,0,1,1
17889,user_17889,3961,51,3,48,May-19,0,1,1
17891,user_17891,47,2,0,2,Apr-19,1,1,0
17892,user_17892,6176,106,0,106,May-19,0,1,1
17893,user_17893,11,2,2,0,Dec-18,5,0,0
17894,user_17894,10001,356,49,307,May-19,0,1,1
17895,user_17895,5283,200,0,200,May-19,0,1,1
17896,user_17896,6025,122,3,119,May-19,0,1,1
17897,user_17897,1055,68,0,68,May-19,0,1,1
17899,user_17899,1558,65,5,60,May-19,0,1,1
17900,user_17900,2441,62,7,55,May-19,0,1,1
17901,user_17901,1526,35,2,33,Mar-19,2,0,0
17902,user_17902,6488,251,27,224,May-19,0,1,1
17903,user_17903,4305,55,4,51,Apr-19,1,1,0
17904,user_17904,1363,78,0,78,May-19,0,1,1
17905,user_17905,1204,26,1,25,Feb-19,3,0,0
17906,user_17906,266,8,3,5,Mar-19,2,0,0
17907,user_17907,6761,454,0,454,May-19,0,1,1
17908,user_17908,800,18,3,15,May-19,0,1,1
17909,user_17909,9238,134,6,128,May-19,0,1,1
17910,user_17910,484,13,1,12,Mar-19,2,0,0
17911,user_17911,11160,780,0,780,May-19,0,1,1
17912,user_17912,1388,21,0,21,Jan-19,4,0,0
17913,user_17913,278,19,2,17,Apr-19,1,1,0
17914,user_17914,3917,144,2,142,May-19,0,1,1
17915,user_17915,27,5,5,0,Dec-18,5,0,0
17916,user_17916,39145,370,13,357,May-19,0,1,1
17917,user_17917,2272,89,2,87,May-19,0,0,1
17919,user_17919,11,2,2,0,Dec-18,5,0,0
17920,user_17920,4247,213,3,210,May-19,0,1,1
17921,user_17921,250,16,3,13,Apr-19,1,1,0
17922,user_17922,10327,188,5,183,May-19,0,1,1
17923,user_17923,11,2,2,0,Dec-18,5,0,0
17924,user_17924,452,17,1,16,May-19,0,0,1
17925,user_17925,167,4,4,0,Dec-18,5,0,0
17926,user_17926,6184,127,2,125,May-19,0,1,1
17927,user_17927,9,2,2,0,Dec-18,5,0,0
17928,user_17928,9,2,2,0,Dec-18,5,0,0
17929,user_17929,171,7,6,1,Feb-19,3,0,0
17930,user_17930,77,5,2,3,May-19,0,0,1
17931,user_17931,14104,65,0,65,May-19,0,1,1
17932,user_17932,154,16,3,13,Apr-19,1,1,0
17933,user_17933,1091,34,0,34,May-19,0,1,1
17934,user_17934,3835,49,8,41,Feb-19,3,0,0
17935,user_17935,343,8,3,5,Feb-19,3,0,0
17936,user_17936,946,35,2,33,Apr-19,1,1,0
17937,user_17937,18,3,0,3,Feb-19,3,0,0
17938,user_17938,13,3,2,1,Jan-19,4,0,0
17939,user_17939,105,13,2,11,May-19,0,1,1
17940,user_17940,7877,275,4,271,May-19,0,1,1
17941,user_17941,1026,59,2,57,Apr-19,1,1,0
17942,user_17942,11,2,2,0,Dec-18,5,0,0
17943,user_17943,10021,61,25,36,May-19,0,0,1
17944,user_17944,1084,74,9,65,May-19,0,1,1
17945,user_17945,27,5,0,5,Apr-19,1,1,0
17947,user_17947,6139,124,2,122,May-19,0,1,1
17948,user_17948,3094,26,5,21,Apr-19,1,1,0
17949,user_17949,5725,113,15,98,May-19,0,1,1
17950,user_17950,5286,304,37,267,May-19,0,1,1
17951,user_17951,16175,62,6,56,Apr-19,1,1,0
17952,user_17952,880,15,0,15,Mar-19,2,0,0
17953,user_17953,7019,210,0,210,May-19,0,1,1
17954,user_17954,1304,18,2,16,Apr-19,1,1,0
17955,user_17955,2020,51,12,39,Apr-19,1,1,0
17956,user_17956,2240,31,3,28,May-19,0,1,1
17957,user_17957,3990,108,7,101,May-19,0,1,1
17958,user_17958,3818,59,7,52,May-19,0,1,1
17959,user_17959,10193,184,3,181,May-19,0,1,1
17960,user_17960,1361,99,2,97,May-19,0,1,1
17962,user_17962,7590,107,6,101,May-19,0,1,1
17963,user_17963,362,7,6,1,Jan-19,4,0,0
17964,user_17964,4,2,2,0,Dec-18,5,0,0
17965,user_17965,26,7,2,5,Mar-19,2,0,0
17966,user_17966,5195,153,27,126,Mar-19,2,0,0
17967,user_17967,23,12,2,10,Apr-19,1,1,0
17968,user_17968,1698,70,4,66,May-19,0,1,1
17969,user_17969,1504,176,5,171,May-19,0,1,1
17970,user_17970,1812,68,2,66,May-19,0,1,1
17971,user_17971,12134,176,10,166,May-19,0,1,1
17972,user_17972,1187,123,0,123,May-19,0,1,1
17973,user_17973,3716,391,10,381,May-19,0,1,1
17974,user_17974,182,14,2,12,Apr-19,1,1,0
17975,user_17975,35633,117,2,115,May-19,0,1,1
17976,user_17976,69711,323,28,295,May-19,0,1,1
17977,user_17977,40,9,3,6,Feb-19,3,0,0
17978,user_17978,8114,45,14,31,May-19,0,1,1
17979,user_17979,491,10,2,8,Mar-19,2,0,0
17980,user_17980,3186,81,11,70,May-19,0,1,1
17981,user_17981,537,66,9,57,Apr-19,1,1,0
17982,user_17982,575,19,6,13,Apr-19,1,1,0
17983,user_17983,92,19,7,12,Apr-19,1,1,0
17984,user_17984,3152,27,1,26,May-19,0,1,1
17985,user_17985,1287,48,13,35,May-19,0,1,1
17986,user_17986,63,6,2,4,Jan-19,4,0,0
17987,user_17987,1567,7,2,5,May-19,0,1,1
17988,user_17988,5233,45,1,44,May-19,0,1,1
17989,user_17989,78,29,2,27,Mar-19,2,0,0
17990,user_17990,310,19,3,16,Apr-19,1,1,0
17991,user_17991,8979,12,3,9,Apr-19,1,1,0
17992,user_17992,4593,106,3,103,May-19,0,1,1
17993,user_17993,909,33,5,28,Apr-19,1,1,0
17995,user_17995,69,1,1,0,Dec-18,5,0,0
17996,user_17996,304,30,2,28,May-19,0,1,1
17997,user_17997,7507,144,5,139,Apr-19,1,1,0
17998,user_17998,30002,252,1,251,May-19,0,1,1
17999,user_17999,1584,18,0,18,May-19,0,1,1
18000,user_18000,20,3,0,3,Jan-19,4,0,0
18001,user_18001,304,9,2,7,May-19,0,0,1
18002,user_18002,3583,78,0,78,May-19,0,1,1
18003,user_18003,3142,34,8,26,Apr-19,1,1,0
18004,user_18004,9431,192,0,192,Apr-19,1,1,0
18005,user_18005,11,2,2,0,Dec-18,5,0,0
18006,user_18006,3363,166,4,162,May-19,0,1,1
18007,user_18007,8530,204,9,195,May-19,0,1,1
18008,user_18008,18,3,3,0,Dec-18,5,0,0
18009,user_18009,7524,145,2,143,May-19,0,1,1
18010,user_18010,433,10,0,10,May-19,0,0,1
18011,user_18011,689,19,2,17,May-19,0,1,1
18012,user_18012,25,6,5,1,Jan-19,4,0,0
18013,user_18013,24,4,2,2,Apr-19,1,1,0
18014,user_18014,1496,24,14,10,Feb-19,3,0,0
18015,user_18015,1018,21,1,20,Apr-19,1,1,0
18016,user_18016,7,8,0,8,Jan-19,4,0,0
18017,user_18017,8,3,2,1,Jan-19,4,0,0
18018,user_18018,2679,53,4,49,May-19,0,1,1
18019,user_18019,1532,49,2,47,May-19,0,1,1
18020,user_18020,2143,49,10,39,May-19,0,1,1
18021,user_18021,208,27,7,20,Apr-19,1,1,0
18022,user_18022,5934,222,2,220,May-19,0,1,1
18023,user_18023,192,17,2,15,May-19,0,1,1
18024,user_18024,9640,53,15,38,May-19,0,1,1
18025,user_18025,3790,79,2,77,May-19,0,1,1
18026,user_18026,9,2,2,0,Dec-18,5,0,0
18028,user_18028,85,14,2,12,Apr-19,1,1,0
18029,user_18029,19,11,0,11,May-19,0,1,1
18030,user_18030,26,4,3,1,May-19,0,0,1
18031,user_18031,14665,97,5,92,Apr-19,1,1,0
18032,user_18032,1330,48,15,33,May-19,0,0,1
18034,user_18034,742,9,2,7,Apr-19,1,1,0
18035,user_18035,10399,53,0,53,May-19,0,1,1
18036,user_18036,1820,55,2,53,Mar-19,2,0,0
18037,user_18037,217,6,5,1,Jan-19,4,0,0
18038,user_18038,9,2,2,0,Dec-18,5,0,0
18039,user_18039,557,52,2,50,Mar-19,2,0,0
18040,user_18040,79,16,16,0,Dec-18,5,0,0
18041,user_18041,736,14,3,11,May-19,0,1,1
18043,user_18043,2367,58,5,53,May-19,0,1,1
18044,user_18044,21,3,3,0,Dec-18,5,0,0
18046,user_18046,1475,59,6,53,Apr-19,1,1,0
18047,user_18047,7248,21,1,20,Apr-19,1,1,0
18048,user_18048,318,25,0,25,Apr-19,1,1,0
18049,user_18049,7150,338,4,334,May-19,0,1,1
18050,user_18050,1394,80,0,80,May-19,0,1,1
18051,user_18051,27372,97,1,96,Apr-19,1,1,0
18052,user_18052,20282,78,1,77,May-19,0,1,1
18053,user_18053,795,8,0,8,May-19,0,0,1
18054,user_18054,1502,44,2,42,May-19,0,1,1
18055,user_18055,43,2,2,0,Dec-18,5,0,0
18056,user_18056,846,31,0,31,Apr-19,1,1,0
18057,user_18057,538,41,4,37,Apr-19,1,1,0
18058,user_18058,7896,166,4,162,May-19,0,1,1
18059,user_18059,4702,28,7,21,Apr-19,1,1,0
18060,user_18060,80,15,0,15,Apr-19,1,1,0
18061,user_18061,166,6,4,2,Feb-19,3,0,0
18062,user_18062,655,28,5,23,Mar-19,2,0,0
18063,user_18063,10,5,3,2,Mar-19,2,0,0
18064,user_18064,6019,35,1,34,May-19,0,1,1
18065,user_18065,221,11,3,8,Feb-19,3,0,0
18066,user_18066,959,19,12,7,Feb-19,3,0,0
18067,user_18067,6,3,3,0,Dec-18,5,0,0
18069,user_18069,396,5,4,1,May-19,0,0,1
18070,user_18070,1047,13,2,11,Feb-19,3,0,0
18071,user_18071,26,4,4,0,Dec-18,5,0,0
18072,user_18072,15873,98,38,60,May-19,0,1,1
18073,user_18073,18855,195,3,192,May-19,0,1,1
18074,user_18074,458,28,0,28,May-19,0,1,1
18075,user_18075,2987,78,3,75,May-19,0,1,1
18076,user_18076,9,2,2,0,Dec-18,5,0,0
18077,user_18077,222,15,0,15,Apr-19,1,1,0
18078,user_18078,162,18,6,12,Feb-19,3,0,0
18079,user_18079,17611,412,6,406,May-19,0,1,1
18080,user_18080,6040,290,47,243,Apr-19,1,1,0
18081,user_18081,1504,246,16,230,May-19,0,1,1
18082,user_18082,1144,32,5,27,Apr-19,1,1,0
18083,user_18083,910,65,4,61,May-19,0,1,1
18084,user_18084,1,1,0,1,Apr-19,1,1,0
18085,user_18085,1282,47,7,40,May-19,0,1,1
18086,user_18086,477,14,4,10,Apr-19,1,1,0
18087,user_18087,165,19,3,16,Feb-19,3,0,0
18088,user_18088,1875,74,0,74,Apr-19,1,1,0
18089,user_18089,809,37,3,34,Apr-19,1,1,0
18090,user_18090,20,6,2,4,Jan-19,4,0,0
18091,user_18091,9002,212,28,184,May-19,0,1,1
18092,user_18092,7884,167,3,164,Apr-19,1,1,0
18093,user_18093,4666,112,22,90,May-19,0,1,1
18094,user_18094,37,5,2,3,Feb-19,3,0,0
18095,user_18095,1144,32,1,31,Apr-19,1,1,0
18096,user_18096,632,27,0,27,May-19,0,1,1
18097,user_18097,67,12,7,5,Apr-19,1,1,0
18098,user_18098,2263,19,2,17,Apr-19,1,1,0
18099,user_18099,10358,153,43,110,May-19,0,1,1
18100,user_18100,20027,106,4,102,May-19,0,1,1
18101,user_18101,967,29,0,29,Apr-19,1,1,0
18102,user_18102,1691,44,2,42,May-19,0,1,1
18103,user_18103,428,13,2,11,Apr-19,1,1,0
18104,user_18104,94,28,11,17,Apr-19,1,1,0
18105,user_18105,8661,133,2,131,May-19,0,1,1
18106,user_18106,2193,21,2,19,Apr-19,1,1,0
18107,user_18107,1538,52,2,50,May-19,0,1,1
18108,user_18108,26,2,0,2,Feb-19,3,0,0
18109,user_18109,13768,250,5,245,May-19,0,1,1
18110,user_18110,1346,86,2,84,Apr-19,1,1,0
18111,user_18111,9,2,2,0,Dec-18,5,0,0
18112,user_18112,4822,52,2,50,Jan-19,4,0,0
18113,user_18113,5717,62,2,60,May-19,0,1,1
18114,user_18114,9,2,2,0,Dec-18,5,0,0
18115,user_18115,442,17,2,15,Apr-19,1,1,0
18116,user_18116,1155,21,1,20,Apr-19,1,1,0
18117,user_18117,4006,68,1,67,Apr-19,1,1,0
18118,user_18118,6303,183,6,177,May-19,0,1,1
18119,user_18119,3892,138,14,124,May-19,0,1,1
18120,user_18120,94,4,1,3,May-19,0,1,1
18121,user_18121,22112,420,3,417,May-19,0,1,1
18122,user_18122,2575,32,0,32,May-19,0,1,1
18123,user_18123,20,5,1,4,May-19,0,0,1
18124,user_18124,1047,15,5,10,Apr-19,1,1,0
18126,user_18126,299,24,2,22,Apr-19,1,1,0
18127,user_18127,96757,168,0,168,Apr-19,1,1,0
18128,user_18128,3801,137,0,137,May-19,0,1,1
18129,user_18129,738,28,0,28,May-19,0,1,1
18130,user_18130,223,13,6,7,Mar-19,2,0,0
18131,user_18131,1102,35,1,34,Apr-19,1,1,0
18132,user_18132,203,9,9,0,Dec-18,5,0,0
18133,user_18133,4165,61,2,59,May-19,0,1,1
18134,user_18134,21,3,3,0,Dec-18,5,0,0
18135,user_18135,7190,154,15,139,May-19,0,1,1
18136,user_18136,53634,106,12,94,May-19,0,1,1
18137,user_18137,69,9,0,9,Apr-19,1,1,0
18139,user_18139,17,2,1,1,Mar-19,2,0,0
18140,user_18140,20,5,3,2,Jan-19,4,0,0
18141,user_18141,840,40,2,38,Mar-19,2,0,0
18142,user_18142,35,5,5,0,Dec-18,5,0,0
18143,user_18143,933,30,10,20,May-19,0,1,1
18144,user_18144,958,13,0,13,Apr-19,1,1,0
18146,user_18146,882,35,0,35,Apr-19,1,1,0
18148,user_18148,7141,326,4,322,May-19,0,1,1
18149,user_18149,35,11,5,6,Feb-19,3,0,0
18150,user_18150,32,7,7,0,Dec-18,5,0,0
18151,user_18151,89,9,0,9,Feb-19,3,0,0
18152,user_18152,5431,14,4,10,Apr-19,1,1,0
18153,user_18153,316,18,5,13,Feb-19,3,0,0
18154,user_18154,28,6,6,0,Dec-18,5,0,0
18155,user_18155,0,2,0,2,Feb-19,3,0,0
18156,user_18156,1047,50,19,31,May-19,0,1,1
18157,user_18157,3048,128,1,127,May-19,0,1,1
18158,user_18158,2212,95,1,94,May-19,0,1,1
18160,user_18160,4882,42,2,40,May-19,0,1,1
18161,user_18161,4,2,2,0,Dec-18,5,0,0
18162,user_18162,15,5,2,3,Apr-19,1,1,0
18163,user_18163,3212,333,3,330,May-19,0,1,1
18164,user_18164,9,2,2,0,Dec-18,5,0,0
18166,user_18166,5,3,1,2,Apr-19,1,1,0
18167,user_18167,449,17,2,15,Jan-19,4,0,0
18168,user_18168,1081,40,2,38,May-19,0,1,1
18169,user_18169,11,2,2,0,Dec-18,5,0,0
18170,user_18170,89,12,3,9,Jan-19,4,0,0
18171,user_18171,3889,47,0,47,Apr-19,1,1,0
18172,user_18172,867,19,6,13,Mar-19,2,0,0
18173,user_18173,5563,114,7,107,May-19,0,1,1
18174,user_18174,365,19,4,15,Mar-19,2,0,0
18175,user_18175,9133,143,0,143,May-19,0,1,1
18176,user_18176,5482,286,13,273,May-19,0,1,1
18179,user_18179,69,5,3,2,Jan-19,4,0,0
18180,user_18180,914,28,3,25,May-19,0,1,1
18181,user_18181,3927,42,2,40,Apr-19,1,1,0
18182,user_18182,9,2,0,2,Apr-19,1,1,0
18183,user_18183,1509,68,12,56,May-19,0,1,1
18184,user_18184,307,14,0,14,May-19,0,1,1
18185,user_18185,3362,60,12,48,Mar-19,2,0,0
18186,user_18186,11552,102,2,100,May-19,0,1,1
18188,user_18188,12675,240,19,221,May-19,0,1,1
18189,user_18189,511,105,0,105,May-19,0,1,1
18190,user_18190,646,37,2,35,May-19,0,0,1
18191,user_18191,9,2,2,0,Dec-18,5,0,0
18192,user_18192,234,10,2,8,May-19,0,0,1
18193,user_18193,103,7,0,7,Mar-19,2,0,0
18194,user_18194,667,29,16,13,Apr-19,1,1,0
18195,user_18195,34190,123,5,118,May-19,0,1,1
18196,user_18196,7240,73,3,70,May-19,0,1,1
18197,user_18197,2398,134,2,132,May-19,0,1,1
18198,user_18198,9,2,0,2,Jan-19,4,0,0
18200,user_18200,2656,33,20,13,Jan-19,4,0,0
18201,user_18201,1159,38,0,38,Apr-19,1,1,0
18202,user_18202,3,3,3,0,Dec-18,5,0,0
18204,user_18204,476,11,3,8,Apr-19,1,1,0
18205,user_18205,7529,172,21,151,May-19,0,1,1
18206,user_18206,1,3,3,0,Dec-18,5,0,0
18207,user_18207,27671,198,3,195,May-19,0,1,1
18208,user_18208,790,54,0,54,Apr-19,1,1,0
18209,user_18209,3257,99,7,92,May-19,0,1,1
18211,user_18211,1453,30,2,28,Apr-19,1,1,0
18212,user_18212,3719,137,5,132,May-19,0,1,1
18213,user_18213,411,10,2,8,Apr-19,1,1,0
18214,user_18214,210,27,2,25,Feb-19,3,0,0
18215,user_18215,327,30,5,25,May-19,0,1,1
18216,user_18216,265,164,4,160,May-19,0,1,1
18217,user_18217,212,6,2,4,Feb-19,3,0,0
18218,user_18218,3304,130,5,125,Apr-19,1,1,0
18219,user_18219,21,4,0,4,Apr-19,1,1,0
18220,user_18220,41,7,3,4,Feb-19,3,0,0
18221,user_18221,112,14,13,1,Feb-19,3,0,0
18222,user_18222,4938,53,8,45,Mar-19,2,0,0
18223,user_18223,7,1,1,0,Dec-18,5,0,0
18224,user_18224,390,9,2,7,Mar-19,2,0,0
18225,user_18225,1975,22,2,20,May-19,0,0,1
18226,user_18226,3792,49,6,43,May-19,0,0,1
18228,user_18228,6,7,7,0,Dec-18,5,0,0
18229,user_18229,3496,199,1,198,May-19,0,1,1
18230,user_18230,9346,70,0,70,May-19,0,1,1
18231,user_18231,2929,20,6,14,Apr-19,1,1,0
18232,user_18232,45,16,0,16,Mar-19,2,0,0
18233,user_18233,17264,329,8,321,May-19,0,1,1
18234,user_18234,911,45,3,42,Apr-19,1,1,0
18235,user_18235,118,18,2,16,Apr-19,1,1,0
18236,user_18236,30745,768,56,712,May-19,0,1,1
18237,user_18237,21,3,3,0,Dec-18,5,0,0
18238,user_18238,20460,389,2,387,May-19,0,1,1
18239,user_18239,234,14,3,11,Apr-19,1,1,0
18240,user_18240,2273,128,5,123,May-19,0,1,1
18241,user_18241,522,23,9,14,Feb-19,3,0,0
18242,user_18242,27,4,1,3,Jan-19,4,0,0
18245,user_18245,251,10,2,8,May-19,0,0,1
18246,user_18246,2520,54,16,38,Mar-19,2,0,0
18247,user_18247,2754,50,5,45,Feb-19,3,0,0
18248,user_18248,41,4,3,1,Mar-19,2,0,0
18249,user_18249,535,33,0,33,May-19,0,1,1
18250,user_18250,9015,22,0,22,Apr-19,1,1,0
18251,user_18251,19,3,3,0,Dec-18,5,0,0
18252,user_18252,53410,176,13,163,May-19,0,1,1
18254,user_18254,1833,81,30,51,Mar-19,2,0,0
18255,user_18255,13,3,2,1,Jan-19,4,0,0
18256,user_18256,966,26,2,24,May-19,0,1,1
18257,user_18257,1278,28,1,27,Mar-19,2,0,0
18258,user_18258,25,4,2,2,Mar-19,2,0,0
18259,user_18259,1735,36,2,34,Mar-19,2,0,0
18260,user_18260,500,5,3,2,Mar-19,2,0,0
18261,user_18261,2365,36,0,36,May-19,0,1,1
18262,user_18262,7276,81,21,60,May-19,0,0,1
18263,user_18263,14182,391,34,357,May-19,0,1,1
18264,user_18264,638,34,1,33,Feb-19,3,0,0
18265,user_18265,4885,241,2,239,May-19,0,1,1
18266,user_18266,4850,279,3,276,May-19,0,1,1
18267,user_18267,268,8,1,7,Feb-19,3,0,0
18268,user_18268,3139,180,2,178,May-19,0,1,1
18269,user_18269,196,12,2,10,Mar-19,2,0,0
18270,user_18270,3536,227,9,218,May-19,0,1,1
18271,user_18271,12122,137,3,134,May-19,0,1,1
18272,user_18272,1070,26,5,21,Apr-19,1,1,0
18273,user_18273,26,3,3,0,Dec-18,5,0,0
18274,user_18274,7002,64,1,63,Apr-19,1,1,0
18275,user_18275,4299,42,3,39,May-19,0,1,1
18276,user_18276,1138,8,3,5,Jan-19,4,0,0
18277,user_18277,3879,63,2,61,May-19,0,1,1
18279,user_18279,1001,12,1,11,Apr-19,1,1,0
18280,user_18280,310,14,2,12,Apr-19,1,1,0
18281,user_18281,877,13,12,1,Apr-19,1,1,0
18282,user_18282,61,3,3,0,Dec-18,5,0,0
18283,user_18283,152,6,6,0,Dec-18,5,0,0
18284,user_18284,10,2,2,0,Dec-18,5,0,0
18285,user_18285,454,9,3,6,Mar-19,2,0,0
18286,user_18286,666,75,3,72,May-19,0,1,1
18287,user_18287,6679,178,2,176,May-19,0,1,1
18288,user_18288,6197,15,3,12,Apr-19,1,1,0
18289,user_18289,120,5,5,0,Dec-18,5,0,0
18290,user_18290,2759,48,3,45,May-19,0,1,1
18291,user_18291,1370,13,2,11,May-19,0,1,1
18292,user_18292,8615,284,2,282,May-19,0,1,1
18293,user_18293,3742,78,2,76,May-19,0,1,1
18294,user_18294,18,3,2,1,Jan-19,4,0,0
18295,user_18295,349,11,2,9,Apr-19,1,1,0
18296,user_18296,93136,416,2,414,May-19,0,1,1
18297,user_18297,2999,45,6,39,Apr-19,1,1,0
18298,user_18298,171,6,4,2,Jan-19,4,0,0
18299,user_18299,1104,15,1,14,May-19,0,1,1
18300,user_18300,1805,22,6,16,May-19,0,1,1
18302,user_18302,9894,218,28,190,May-19,0,1,1
18303,user_18303,3219,95,4,91,May-19,0,1,1
18304,user_18304,2083,16,10,6,Apr-19,1,1,0
18305,user_18305,10442,278,2,276,May-19,0,1,1
18306,user_18306,1264,39,2,37,May-19,0,1,1
18307,user_18307,14,6,4,2,Jan-19,4,0,0
18308,user_18308,2577,79,1,78,Apr-19,1,1,0
18309,user_18309,4609,125,5,120,May-19,0,1,1
18310,user_18310,11327,71,4,67,May-19,0,1,1
18311,user_18311,9,3,2,1,Jan-19,4,0,0
18312,user_18312,253,29,1,28,Apr-19,1,1,0
18313,user_18313,4780,55,2,53,Apr-19,1,1,0
18314,user_18314,246,8,3,5,Jan-19,4,0,0
18315,user_18315,606,42,2,40,May-19,0,1,1
18316,user_18316,151,35,6,29,Apr-19,1,1,0
18317,user_18317,1165,34,3,31,Apr-19,1,1,0
18318,user_18318,17,1,1,0,Dec-18,5,0,0
18319,user_18319,369,9,7,2,May-19,0,0,1
18320,user_18320,986,21,2,19,May-19,0,1,1
18321,user_18321,6844,134,11,123,May-19,0,1,1
18322,user_18322,221,16,3,13,May-19,0,1,1
18323,user_18323,259,10,0,10,Apr-19,1,1,0
18324,user_18324,339,24,7,17,May-19,0,1,1
18325,user_18325,1793,19,19,0,Dec-18,5,0,0
18326,user_18326,2181,91,9,82,May-19,0,1,1
18327,user_18327,9921,27,6,21,May-19,0,1,1
18328,user_18328,171,6,6,0,Dec-18,5,0,0
18329,user_18329,812,39,19,20,Jan-19,4,0,0
18330,user_18330,844,11,1,10,May-19,0,1,1
18331,user_18331,12912,146,3,143,May-19,0,1,1
18333,user_18333,332,57,0,57,May-19,0,1,1
18334,user_18334,5204,38,3,35,Apr-19,1,1,0
18335,user_18335,2809,27,0,27,Apr-19,1,1,0
18336,user_18336,1210,29,4,25,Apr-19,1,1,0
18337,user_18337,5968,186,3,183,May-19,0,1,1
18338,user_18338,9,2,2,0,Dec-18,5,0,0
18339,user_18339,8,7,0,7,Feb-19,3,0,0
18340,user_18340,9,2,2,0,Dec-18,5,0,0
18341,user_18341,2629,145,2,143,May-19,0,1,1
18342,user_18342,2156,184,2,182,Apr-19,1,1,0
18343,user_18343,182,3,1,2,Jan-19,4,0,0
18344,user_18344,7886,141,1,140,Apr-19,1,1,0
18346,user_18346,96,12,3,9,Apr-19,1,1,0
18347,user_18347,334,12,0,12,Feb-19,3,0,0
18348,user_18348,50,12,6,6,Jan-19,4,0,0
18349,user_18349,88,18,4,14,Apr-19,1,1,0
18350,user_18350,7349,109,5,104,May-19,0,1,1
18351,user_18351,4068,247,36,211,May-19,0,1,1
18352,user_18352,676,13,6,7,Mar-19,2,0,0
18353,user_18353,96,9,0,9,Apr-19,1,1,0
18354,user_18354,1223,75,5,70,May-19,0,1,1
18355,user_18355,384,8,0,8,May-19,0,1,1
18356,user_18356,2236,39,30,9,Jan-19,4,0,0
18357,user_18357,2045,26,2,24,Feb-19,3,0,0
18358,user_18358,1220,62,9,53,May-19,0,1,1
18360,user_18360,3,3,3,0,Dec-18,5,0,0
18361,user_18361,45,8,8,0,Dec-18,5,0,0
18362,user_18362,9872,89,33,56,May-19,0,1,1
18363,user_18363,2964,184,0,184,May-19,0,1,1
18364,user_18364,139,12,8,4,Apr-19,1,1,0
18365,user_18365,1,1,1,0,Dec-18,5,0,0
18366,user_18366,144,50,0,50,May-19,0,1,1
18367,user_18367,443,9,8,1,Feb-19,3,0,0
18368,user_18368,58,13,3,10,May-19,0,1,1
18369,user_18369,2527,284,5,279,May-19,0,1,1
18370,user_18370,1265,29,2,27,May-19,0,1,1
18371,user_18371,3505,128,0,128,May-19,0,1,1
18372,user_18372,71,12,11,1,Jan-19,4,0,0
18373,user_18373,583,42,0,42,May-19,0,1,1
18374,user_18374,676,84,10,74,Apr-19,1,1,0
18375,user_18375,2089,16,9,7,May-19,0,1,1
18376,user_18376,25,5,0,5,Jan-19,4,0,0
18377,user_18377,15081,512,3,509,May-19,0,1,1
18379,user_18379,1156,83,35,48,Apr-19,1,1,0
18380,user_18380,736,47,11,36,Apr-19,1,1,0
18381,user_18381,1205,78,6,72,Apr-19,1,1,0
18382,user_18382,251,13,3,10,Apr-19,1,1,0
18383,user_18383,6992,112,9,103,May-19,0,1,1
18384,user_18384,95,4,2,2,Apr-19,1,1,0
18385,user_18385,1401,70,0,70,May-19,0,1,1
18386,user_18386,4601,91,1,90,May-19,0,1,1
18387,user_18387,3873,146,8,138,May-19,0,1,1
18388,user_18388,14202,244,16,228,May-19,0,1,1
18389,user_18389,1673,105,1,104,May-19,0,1,1
18390,user_18390,344,6,0,6,Apr-19,1,1,0
18391,user_18391,976,49,2,47,Apr-19,1,1,0
18392,user_18392,2215,284,4,280,May-19,0,1,1
18393,user_18393,1209,86,20,66,May-19,0,1,1
18394,user_18394,3932,105,3,102,Apr-19,1,1,0
18395,user_18395,357,21,5,16,Apr-19,1,1,0
18396,user_18396,30227,223,0,223,May-19,0,1,1
18397,user_18397,9,2,0,2,Jan-19,4,0,0
18398,user_18398,41,5,2,3,Apr-19,1,1,0
18399,user_18399,2750,7,3,4,May-19,0,0,1
18400,user_18400,3467,103,0,103,May-19,0,1,1
18401,user_18401,20306,115,2,113,May-19,0,1,1
18402,user_18402,4,1,0,1,Jan-19,4,0,0
18403,user_18403,692,23,5,18,Apr-19,1,1,0
18404,user_18404,693,44,10,34,Apr-19,1,1,0
18405,user_18405,23,4,4,0,Dec-18,5,0,0
18406,user_18406,464,4,4,0,Dec-18,5,0,0
18407,user_18407,378,16,2,14,Apr-19,1,1,0
18408,user_18408,2658,51,3,48,May-19,0,1,1
18409,user_18409,563,5,3,2,Feb-19,3,0,0
18410,user_18410,212,16,2,14,May-19,0,1,1
18411,user_18411,84,9,1,8,Mar-19,2,0,0
18412,user_18412,667,101,15,86,May-19,0,1,1
18413,user_18413,2338,25,3,22,May-19,0,1,1
18414,user_18414,532,6,2,4,Jan-19,4,0,0
18415,user_18415,3414,158,3,155,Apr-19,1,1,0
18416,user_18416,9,1,1,0,Dec-18,5,0,0
18417,user_18417,9369,129,2,127,May-19,0,1,1
18418,user_18418,154,4,2,2,Feb-19,3,0,0
18419,user_18419,9,2,2,0,Dec-18,5,0,0
18420,user_18420,204,5,1,4,Apr-19,1,1,0
18421,user_18421,26,3,2,1,Jan-19,4,0,0
18422,user_18422,287,18,5,13,May-19,0,1,1
18423,user_18423,905,32,0,32,Jan-19,4,0,0
18424,user_18424,3988,374,0,374,May-19,0,1,1
18425,user_18425,515,48,2,46,May-19,0,1,1
18426,user_18426,533,20,1,19,Apr-19,1,1,0
18427,user_18427,67,5,2,3,Mar-19,2,0,0
18428,user_18428,68,9,0,9,May-19,0,1,1
18429,user_18429,388,8,2,6,Feb-19,3,0,0
18430,user_18430,83,4,0,4,Apr-19,1,1,0
18431,user_18431,57,9,2,7,Apr-19,1,1,0
18432,user_18432,769,11,2,9,Feb-19,3,0,0
18433,user_18433,1707,54,0,54,Apr-19,1,1,0
18434,user_18434,1501,35,0,35,Apr-19,1,1,0
18435,user_18435,21,3,3,0,Dec-18,5,0,0
18436,user_18436,5989,111,1,110,May-19,0,1,1
18437,user_18437,9,2,2,0,Dec-18,5,0,0
18438,user_18438,7389,478,0,478,May-19,0,1,1
18439,user_18439,588,64,17,47,Mar-19,2,0,0
18440,user_18440,263,38,3,35,May-19,0,0,1
18441,user_18441,722,92,0,92,May-19,0,1,1
18442,user_18442,1882,44,11,33,May-19,0,1,1
18443,user_18443,28,12,2,10,Feb-19,3,0,0
18444,user_18444,4192,80,41,39,Apr-19,1,1,0
18445,user_18445,57,5,2,3,May-19,0,0,1
18446,user_18446,2121,38,3,35,Apr-19,1,1,0
18447,user_18447,57,6,2,4,May-19,0,1,1
18448,user_18448,2392,40,4,36,May-19,0,1,1
18449,user_18449,9486,1064,54,1010,May-19,0,1,1
18450,user_18450,920,18,3,15,Feb-19,3,0,0
18451,user_18451,619,50,5,45,May-19,0,1,1
18452,user_18452,10077,87,2,85,May-19,0,1,1
18453,user_18453,3021,63,0,63,May-19,0,1,1
18454,user_18454,20,6,2,4,Mar-19,2,0,0
18455,user_18455,9503,462,17,445,May-19,0,1,1
18456,user_18456,3598,73,2,71,May-19,0,1,1
18457,user_18457,5813,27,3,24,May-19,0,0,1
18458,user_18458,156,20,4,16,Apr-19,1,1,0
18460,user_18460,1613,65,3,62,May-19,0,1,1
18461,user_18461,17290,76,10,66,May-19,0,1,1
18462,user_18462,69,4,2,2,Jan-19,4,0,0
18463,user_18463,78704,99,8,91,May-19,0,1,1
18464,user_18464,152,12,1,11,Mar-19,2,0,0
18465,user_18465,28112,571,61,510,May-19,0,1,1
18466,user_18466,5996,81,2,79,Apr-19,1,1,0
18467,user_18467,203,24,2,22,Apr-19,1,1,0
18468,user_18468,181,14,2,12,May-19,0,1,1
18469,user_18469,29300,102,28,74,May-19,0,1,1
18470,user_18470,7779,257,2,255,May-19,0,1,1
18471,user_18471,2406,102,2,100,May-19,0,1,1
18472,user_18472,11,4,4,0,Dec-18,5,0,0
18473,user_18473,192,19,2,17,May-19,0,1,1
18474,user_18474,448,52,2,50,Apr-19,1,1,0
18475,user_18475,9,2,2,0,Dec-18,5,0,0
18476,user_18476,46,7,0,7,Mar-19,2,0,0
18477,user_18477,1320,51,5,46,May-19,0,1,1
18478,user_18478,6806,180,17,163,Apr-19,1,1,0
18479,user_18479,9,2,2,0,Dec-18,5,0,0
18480,user_18480,106,21,6,15,Apr-19,1,1,0
18481,user_18481,3695,32,4,28,Apr-19,1,1,0
18482,user_18482,16807,327,28,299,May-19,0,1,1
18483,user_18483,62,7,0,7,Mar-19,2,0,0
18484,user_18484,934,62,0,62,May-19,0,1,1
18485,user_18485,410,48,2,46,Apr-19,1,1,0
18486,user_18486,1105,16,2,14,Mar-19,2,0,0
18487,user_18487,1711,23,11,12,May-19,0,1,1
18488,user_18488,10,1,1,0,Dec-18,5,0,0
18489,user_18489,98,20,0,20,Apr-19,1,1,0
18490,user_18490,1778,100,2,98,Apr-19,1,1,0
18491,user_18491,2571,12,3,9,May-19,0,1,1
18492,user_18492,207,19,9,10,May-19,0,1,1
18493,user_18493,677,16,2,14,May-19,0,0,1
18494,user_18494,6663,39,0,39,Apr-19,1,1,0
18495,user_18495,43,2,0,2,Jan-19,4,0,0
18496,user_18496,4923,55,2,53,May-19,0,1,1
18497,user_18497,9,2,2,0,Dec-18,5,0,0
18498,user_18498,12,3,3,0,Dec-18,5,0,0
18499,user_18499,1835,54,0,54,May-19,0,1,1
18500,user_18500,186,6,6,0,Dec-18,5,0,0
18501,user_18501,43,4,2,2,Jan-19,4,0,0
18502,user_18502,323,8,0,8,Apr-19,1,1,0
18503,user_18503,4779,36,2,34,Apr-19,1,1,0
18504,user_18504,5943,300,17,283,May-19,0,1,1
18505,user_18505,15,8,1,7,Apr-19,1,1,0
18506,user_18506,961,60,0,60,May-19,0,1,1
18507,user_18507,290,16,1,15,Apr-19,1,1,0
18508,user_18508,18563,122,4,118,May-19,0,1,1
18509,user_18509,1210,56,4,52,May-19,0,1,1
18510,user_18510,37,5,0,5,Apr-19,1,1,0
18511,user_18511,2796,79,7,72,May-19,0,1,1
18512,user_18512,2933,126,7,119,May-19,0,1,1
18513,user_18513,439,12,2,10,Mar-19,2,0,0
18514,user_18514,4597,21,0,21,May-19,0,1,1
18515,user_18515,1256,50,9,41,May-19,0,1,1
18516,user_18516,153,10,2,8,Apr-19,1,1,0
18517,user_18517,1973,23,1,22,May-19,0,1,1
18518,user_18518,369,22,8,14,May-19,0,1,1
18519,user_18519,10225,22,3,19,May-19,0,1,1
18520,user_18520,276,45,6,39,May-19,0,1,1
18521,user_18521,28,6,1,5,Feb-19,3,0,0
18522,user_18522,155,19,0,19,May-19,0,1,1
18523,user_18523,1022,5,5,0,Dec-18,5,0,0
18524,user_18524,911,5,1,4,Mar-19,2,0,0
18525,user_18525,1100,35,2,33,May-19,0,1,1
18526,user_18526,14015,419,16,403,May-19,0,1,1
18527,user_18527,759,47,2,45,Mar-19,2,0,0
18528,user_18528,341,12,1,11,Jan-19,4,0,0
18529,user_18529,18,3,3,0,Dec-18,5,0,0
18530,user_18530,1408,21,4,17,May-19,0,1,1
18531,user_18531,947,47,1,46,May-19,0,1,1
18532,user_18532,15068,254,0,254,May-19,0,1,1
18533,user_18533,2512,72,5,67,Mar-19,2,0,0
18534,user_18534,1161,20,0,20,May-19,0,0,1
18535,user_18535,1143,74,2,72,May-19,0,1,1
18536,user_18536,4430,22,5,17,Apr-19,1,1,0
18537,user_18537,65,6,3,3,Jan-19,4,0,0
18538,user_18538,321,33,0,33,May-19,0,0,1
18539,user_18539,185,16,16,0,Dec-18,5,0,0
18541,user_18541,9,2,2,0,Dec-18,5,0,0
18542,user_18542,727,38,0,38,Apr-19,1,1,0
18543,user_18543,733,21,3,18,May-19,0,1,1
18544,user_18544,1129,39,2,37,May-19,0,1,1
18545,user_18545,498,28,0,28,May-19,0,1,1
18546,user_18546,940,23,6,17,May-19,0,1,1
18547,user_18547,103,9,2,7,Mar-19,2,0,0
18548,user_18548,7880,147,4,143,May-19,0,1,1
18549,user_18549,542,11,4,7,Feb-19,3,0,0
18550,user_18550,45688,127,0,127,May-19,0,1,1
18551,user_18551,9630,190,37,153,May-19,0,1,1
18553,user_18553,930,39,18,21,Apr-19,1,1,0
18554,user_18554,9105,115,2,113,May-19,0,1,1
18555,user_18555,266,34,3,31,Apr-19,1,1,0
18556,user_18556,4272,125,8,117,Apr-19,1,1,0
18557,user_18557,3353,280,5,275,May-19,0,1,1
18558,user_18558,36,10,2,8,Apr-19,1,1,0
18559,user_18559,45,7,4,3,Jan-19,4,0,0
18560,user_18560,35,4,3,1,Feb-19,3,0,0
18561,user_18561,24,6,4,2,Jan-19,4,0,0
18562,user_18562,3565,128,9,119,May-19,0,1,1
18563,user_18563,2348,49,0,49,Apr-19,1,1,0
18564,user_18564,5871,61,2,59,Mar-19,2,0,0
18565,user_18565,48,7,0,7,Mar-19,2,0,0
18566,user_18566,71861,31,2,29,Mar-19,2,0,0
18567,user_18567,9,2,2,0,Dec-18,5,0,0
18568,user_18568,11,2,2,0,Dec-18,5,0,0
18569,user_18569,233,56,13,43,May-19,0,1,1
18570,user_18570,9,2,2,0,Dec-18,5,0,0
18571,user_18571,455,4,0,4,May-19,0,0,1
18572,user_18572,341,5,5,0,Dec-18,5,0,0
18573,user_18573,1241,15,2,13,Apr-19,1,1,0
18574,user_18574,599,58,1,57,Apr-19,1,1,0
18575,user_18575,9,2,2,0,Dec-18,5,0,0
18576,user_18576,4,2,2,0,Dec-18,5,0,0
18577,user_18577,915,18,2,16,Apr-19,1,1,0
18578,user_18578,11,2,2,0,Dec-18,5,0,0
18579,user_18579,10825,313,9,304,May-19,0,1,1
18581,user_18581,576,29,19,10,Apr-19,1,1,0
18582,user_18582,2491,55,3,52,Apr-19,1,1,0
18583,user_18583,9,4,0,4,Apr-19,1,1,0
18584,user_18584,292,14,2,12,Mar-19,2,0,0
18585,user_18585,4026,27,23,4,Feb-19,3,0,0
18586,user_18586,11,1,0,1,Apr-19,1,1,0
18587,user_18587,3338,181,39,142,Apr-19,1,1,0
18588,user_18588,92,11,2,9,Apr-19,1,1,0
18589,user_18589,43,2,0,2,Jan-19,4,0,0
18590,user_18590,5542,262,4,258,May-19,0,1,1
18591,user_18591,290,17,2,15,Apr-19,1,1,0
18592,user_18592,5273,97,7,90,May-19,0,1,1
18593,user_18593,694,29,14,15,May-19,0,0,1
18594,user_18594,28,11,2,9,May-19,0,1,1
18595,user_18595,307,66,1,65,May-19,0,1,1
18596,user_18596,1278,14,0,14,May-19,0,1,1
18597,user_18597,1209,30,2,28,May-19,0,1,1
18598,user_18598,3992,54,13,41,May-19,0,1,1
18599,user_18599,484,27,4,23,Apr-19,1,1,0
18600,user_18600,1442,8,6,2,Mar-19,2,0,0
18601,user_18601,54,9,0,9,Jan-19,4,0,0
18602,user_18602,2702,87,7,80,May-19,0,1,1
18603,user_18603,195,32,2,30,May-19,0,1,1
18604,user_18604,835,44,2,42,Apr-19,1,1,0
18605,user_18605,2135,39,2,37,May-19,0,1,1
18606,user_18606,1321,143,18,125,May-19,0,1,1
18607,user_18607,182,13,2,11,Mar-19,2,0,0
18608,user_18608,6757,73,14,59,May-19,0,1,1
18609,user_18609,414,24,1,23,May-19,0,1,1
18610,user_18610,13,4,2,2,Mar-19,2,0,0
18611,user_18611,99,10,2,8,Apr-19,1,1,0
18612,user_18612,82,3,0,3,Apr-19,1,1,0
18613,user_18613,2611,95,3,92,May-19,0,1,1
18614,user_18614,1935,29,20,9,Jan-19,4,0,0
18615,user_18615,2418,286,27,259,May-19,0,1,1
18616,user_18616,8453,505,46,459,May-19,0,1,1
18617,user_18617,40,5,2,3,Apr-19,1,1,0
18618,user_18618,105,13,4,9,May-19,0,0,1
18619,user_18619,2949,94,8,86,May-19,0,1,1
18620,user_18620,7111,286,3,283,May-19,0,1,1
18621,user_18621,30,3,0,3,Jan-19,4,0,0
18622,user_18622,10480,238,11,227,May-19,0,1,1
18623,user_18623,202,35,1,34,Apr-19,1,1,0
18624,user_18624,4623,290,0,290,May-19,0,1,1
18625,user_18625,34678,110,3,107,May-19,0,1,1
18626,user_18626,448,5,0,5,May-19,0,1,1
18627,user_18627,890,23,0,23,Mar-19,2,0,0
18628,user_18628,1454,32,2,30,May-19,0,1,1
18629,user_18629,896,40,2,38,May-19,0,1,1
18630,user_18630,222,41,0,41,May-19,0,1,1
18631,user_18631,27,7,5,2,Jan-19,4,0,0
18632,user_18632,385,76,0,76,May-19,0,1,1
18633,user_18633,6339,166,17,149,Apr-19,1,1,0
18634,user_18634,186,23,2,21,May-19,0,1,1
18635,user_18635,41,6,5,1,Mar-19,2,0,0
18636,user_18636,51,5,0,5,Jan-19,4,0,0
18637,user_18637,2,1,0,1,Jan-19,4,0,0
18638,user_18638,10,1,1,0,Dec-18,5,0,0
18639,user_18639,717,89,4,85,May-19,0,1,1
18640,user_18640,98,9,3,6,Apr-19,1,1,0
18641,user_18641,11,1,0,1,Mar-19,2,0,0
18642,user_18642,37,11,8,3,May-19,0,0,1
18643,user_18643,8028,295,55,240,May-19,0,1,1
18644,user_18644,1279,137,2,135,May-19,0,1,1
18645,user_18645,14,11,0,11,Mar-19,2,0,0
18646,user_18646,1058,17,4,13,Mar-19,2,0,0
18647,user_18647,750,20,3,17,May-19,0,1,1
18648,user_18648,2719,191,1,190,May-19,0,1,1
18649,user_18649,8427,596,5,591,May-19,0,1,1
18650,user_18650,11,2,0,2,Apr-19,1,1,0
18651,user_18651,258,35,10,25,Apr-19,1,1,0
18652,user_18652,21967,85,3,82,Apr-19,1,1,0
18653,user_18653,17,4,0,4,Apr-19,1,1,0
18654,user_18654,9,2,2,0,Dec-18,5,0,0
18655,user_18655,3,2,0,2,May-19,0,0,1
18657,user_18657,2,3,0,3,Apr-19,1,1,0
18658,user_18658,288197,117,23,94,May-19,0,1,1
18659,user_18659,126,3,3,0,Dec-18,5,0,0
18661,user_18661,150,19,12,7,Mar-19,2,0,0
18662,user_18662,7300,221,9,212,May-19,0,1,1
18664,user_18664,1068,16,7,9,May-19,0,0,1
18665,user_18665,1900,59,3,56,May-19,0,1,1
18666,user_18666,468,8,0,8,Mar-19,2,0,0
18667,user_18667,596,27,6,21,May-19,0,1,1
18668,user_18668,43,1,0,1,Jan-19,4,0,0
18669,user_18669,2580,57,0,57,Apr-19,1,1,0
18670,user_18670,269,31,4,27,May-19,0,1,1
18671,user_18671,82,12,2,10,Apr-19,1,1,0
18672,user_18672,505,5,0,5,Apr-19,1,1,0
18673,user_18673,308,8,2,6,Feb-19,3,0,0
18674,user_18674,1483,57,22,35,Apr-19,1,1,0
18675,user_18675,1334,69,28,41,Feb-19,3,0,0
18676,user_18676,750,38,1,37,Apr-19,1,1,0
18677,user_18677,947,59,11,48,Apr-19,1,1,0
18678,user_18678,5371,75,2,73,May-19,0,1,1
18679,user_18679,1890,24,0,24,Apr-19,1,1,0
18682,user_18682,194,11,0,11,Mar-19,2,0,0
18683,user_18683,54,14,3,11,Apr-19,1,1,0
18684,user_18684,150,43,6,37,May-19,0,1,1
18685,user_18685,54,23,3,20,Apr-19,1,1,0
18686,user_18686,2833,92,7,85,May-19,0,1,1
18687,user_18687,19,5,3,2,Feb-19,3,0,0
18688,user_18688,12,4,2,2,Jan-19,4,0,0
18690,user_18690,4206,260,2,258,May-19,0,1,1
18691,user_18691,412,24,5,19,Mar-19,2,0,0
18692,user_18692,1781,27,2,25,May-19,0,1,1
18693,user_18693,263,14,8,6,May-19,0,1,1
18694,user_18694,27,6,2,4,May-19,0,1,1
18695,user_18695,9,1,0,1,Feb-19,3,0,0
18696,user_18696,10381,270,10,260,May-19,0,1,1
18697,user_18697,1,1,1,0,Dec-18,5,0,0
18698,user_18698,1331,160,5,155,May-19,0,1,1
18700,user_18700,227,30,0,30,May-19,0,1,1
18701,user_18701,171,20,12,8,Apr-19,1,1,0
18702,user_18702,45,6,6,0,Dec-18,5,0,0
18703,user_18703,4461,127,2,125,Mar-19,2,0,0
18704,user_18704,3071,115,6,109,May-19,0,1,1
18705,user_18705,9,2,2,0,Dec-18,5,0,0
18706,user_18706,16,5,2,3,Mar-19,2,0,0
18708,user_18708,8990,528,17,511,May-19,0,1,1
18709,user_18709,2143,13,1,12,Mar-19,2,0,0
18710,user_18710,30,9,0,9,Mar-19,2,0,0
18711,user_18711,34228,104,2,102,Apr-19,1,1,0
18712,user_18712,17,3,3,0,Dec-18,5,0,0
18713,user_18713,3954,81,40,41,May-19,0,1,1
18714,user_18714,16,3,2,1,Jan-19,4,0,0
18716,user_18716,18,3,3,0,Dec-18,5,0,0
18717,user_18717,268,11,10,1,Jan-19,4,0,0
18718,user_18718,275,35,2,33,Apr-19,1,1,0
18719,user_18719,506,22,0,22,May-19,0,1,1
18720,user_18720,4518,46,3,43,May-19,0,1,1
18721,user_18721,13339,130,3,127,Apr-19,1,1,0
18722,user_18722,655,17,15,2,Apr-19,1,1,0
18724,user_18724,390,30,13,17,Feb-19,3,0,0
18725,user_18725,1134,46,3,43,May-19,0,0,1
18726,user_18726,1542,98,4,94,May-19,0,1,1
18727,user_18727,83,11,11,0,Dec-18,5,0,0
18728,user_18728,1805,36,3,33,May-19,0,1,1
18729,user_18729,1907,73,5,68,May-19,0,1,1
18730,user_18730,19,4,0,4,Apr-19,1,1,0
18731,user_18731,11,2,2,0,Dec-18,5,0,0
18732,user_18732,2428,75,2,73,May-19,0,1,1
18733,user_18733,4295,125,1,124,May-19,0,1,1
18734,user_18734,64,38,2,36,May-19,0,1,1
18735,user_18735,14,5,2,3,Jan-19,4,0,0
18736,user_18736,2164,136,0,136,May-19,0,1,1
18737,user_18737,137,6,3,3,Apr-19,1,1,0
18739,user_18739,1753,63,3,60,May-19,0,1,1
18740,user_18740,2963,73,9,64,Feb-19,3,0,0
18741,user_18741,943,8,0,8,Apr-19,1,1,0
18742,user_18742,86,20,2,18,Mar-19,2,0,0
18743,user_18743,9656,419,40,379,May-19,0,1,1
18744,user_18744,1626,95,2,93,May-19,0,1,1
18746,user_18746,82,4,1,3,Mar-19,2,0,0
18747,user_18747,6079,124,24,100,May-19,0,1,1
18748,user_18748,8757,884,174,710,May-19,0,1,1
18749,user_18749,719,6,1,5,Mar-19,2,0,0
18750,user_18750,89,14,3,11,May-19,0,0,1
18751,user_18751,3399,50,0,50,May-19,0,1,1
18752,user_18752,3012,66,0,66,May-19,0,1,1
18753,user_18753,55,21,6,15,Mar-19,2,0,0
18754,user_18754,4735,18,0,18,Apr-19,1,1,0
18755,user_18755,1391,205,0,205,May-19,0,1,1
18756,user_18756,11,2,2,0,Dec-18,5,0,0
18757,user_18757,18,2,2,0,Dec-18,5,0,0
18758,user_18758,1444,38,2,36,Apr-19,1,1,0
18759,user_18759,16482,338,9,329,May-19,0,1,1
18760,user_18760,6686,104,4,100,May-19,0,1,1
18761,user_18761,1199,49,17,32,Mar-19,2,0,0
18762,user_18762,183,18,5,13,May-19,0,1,1
18763,user_18763,162,22,2,20,May-19,0,1,1
18764,user_18764,1713,141,8,133,May-19,0,1,1
18765,user_18765,90,13,5,8,Apr-19,1,1,0
18766,user_18766,1031,71,3,68,Apr-19,1,1,0
18768,user_18768,4316,70,0,70,May-19,0,1,1
18769,user_18769,916,8,2,6,Apr-19,1,1,0
18770,user_18770,37,10,7,3,Mar-19,2,0,0
18771,user_18771,71,8,1,7,Mar-19,2,0,0
18772,user_18772,1641,61,3,58,Feb-19,3,0,0
18773,user_18773,14,3,3,0,Dec-18,5,0,0
18774,user_18774,2214,69,3,66,May-19,0,1,1
18775,user_18775,111,16,2,14,May-19,0,1,1
18776,user_18776,4762,108,2,106,Apr-19,1,1,0
18777,user_18777,18,2,2,0,Dec-18,5,0,0
18778,user_18778,79,12,1,11,Jan-19,4,0,0
18779,user_18779,11,2,2,0,Dec-18,5,0,0
18780,user_18780,10730,211,0,211,Apr-19,1,1,0
18781,user_18781,641,31,3,28,May-19,0,1,1
18782,user_18782,208854,16,0,16,Jan-19,4,0,0
18783,user_18783,164,21,3,18,Mar-19,2,0,0
18784,user_18784,2084,146,1,145,May-19,0,1,1
18785,user_18785,310,19,2,17,Apr-19,1,1,0
18786,user_18786,6044,271,52,219,May-19,0,1,1
18787,user_18787,2422,84,6,78,May-19,0,0,1
18788,user_18788,7974,661,26,635,May-19,0,1,1
18790,user_18790,12484,234,0,234,May-19,0,1,1
18791,user_18791,4734,116,11,105,Feb-19,3,0,0
18792,user_18792,2780,88,0,88,May-19,0,1,1
18793,user_18793,15570,113,0,113,May-19,0,1,1
18794,user_18794,1053,71,5,66,May-19,0,0,1
18795,user_18795,1857,944,0,944,May-19,0,1,1
18796,user_18796,66,20,2,18,Feb-19,3,0,0
18797,user_18797,710,47,0,47,May-19,0,1,1
18798,user_18798,575,31,4,27,Mar-19,2,0,0
18799,user_18799,10853,150,35,115,Apr-19,1,1,0
18800,user_18800,2586,10,3,7,Mar-19,2,0,0
18801,user_18801,9,2,2,0,Dec-18,5,0,0
18802,user_18802,5907,202,3,199,May-19,0,1,1
18803,user_18803,749,32,0,32,Jan-19,4,0,0
18804,user_18804,36,10,10,0,Dec-18,5,0,0
18805,user_18805,1891,19,12,7,Feb-19,3,0,0
18806,user_18806,655,61,6,55,May-19,0,0,1
18807,user_18807,865,22,3,19,May-19,0,1,1
18808,user_18808,5895,80,3,77,Mar-19,2,0,0
18809,user_18809,3894,339,0,339,May-19,0,1,1
18810,user_18810,810,9,3,6,Apr-19,1,1,0
18811,user_18811,44,3,3,0,Dec-18,5,0,0
18812,user_18812,1030,8,0,8,Apr-19,1,1,0
18813,user_18813,67,5,5,0,Dec-18,5,0,0
18814,user_18814,1719,35,2,33,May-19,0,1,1
18815,user_18815,41,8,3,5,Feb-19,3,0,0
18816,user_18816,2235,77,19,58,May-19,0,0,1
18817,user_18817,8,2,2,0,Dec-18,5,0,0
18818,user_18818,6816,357,0,357,May-19,0,1,1
18819,user_18819,213,23,2,21,Apr-19,1,1,0
18820,user_18820,111,7,1,6,Apr-19,1,1,0
18821,user_18821,1927,46,6,40,May-19,0,1,1
18822,user_18822,35,16,16,0,Dec-18,5,0,0
18823,user_18823,20,5,5,0,Dec-18,5,0,0
18824,user_18824,181,20,2,18,Mar-19,2,0,0
18825,user_18825,4996,99,46,53,May-19,0,1,1
18826,user_18826,233,11,3,8,May-19,0,1,1
18827,user_18827,85,6,2,4,Mar-19,2,0,0
18828,user_18828,21,3,3,0,Dec-18,5,0,0
18829,user_18829,1217,39,2,37,May-19,0,1,1
18830,user_18830,364,52,6,46,May-19,0,1,1
18831,user_18831,3988,22,22,0,Dec-18,5,0,0
18832,user_18832,1460,29,21,8,Apr-19,1,1,0
18833,user_18833,1280,15,2,13,Feb-19,3,0,0
18834,user_18834,20766,14,14,0,Dec-18,5,0,0
18835,user_18835,1904,17,1,16,May-19,0,0,1
18836,user_18836,3189,217,3,214,May-19,0,1,1
18837,user_18837,163,8,0,8,Apr-19,1,1,0
18838,user_18838,152,15,3,12,Apr-19,1,1,0
18839,user_18839,149,25,9,16,Feb-19,3,0,0
18840,user_18840,5424,182,0,182,May-19,0,1,1
18841,user_18841,9,2,2,0,Dec-18,5,0,0
18842,user_18842,237,6,1,5,Apr-19,1,1,0
18843,user_18843,13,3,2,1,Feb-19,3,0,0
18844,user_18844,108,5,4,1,May-19,0,0,1
18845,user_18845,20,9,2,7,Mar-19,2,0,0
18846,user_18846,2041,130,4,126,May-19,0,1,1
18847,user_18847,30,8,2,6,Jan-19,4,0,0
18848,user_18848,26,3,2,1,Apr-19,1,1,0
18849,user_18849,10,1,1,0,Dec-18,5,0,0
18850,user_18850,2675,51,5,46,May-19,0,1,1
18851,user_18851,876,10,2,8,Mar-19,2,0,0
18852,user_18852,174,9,2,7,May-19,0,0,1
18853,user_18853,15,4,0,4,Apr-19,1,1,0
18854,user_18854,157,6,2,4,Jan-19,4,0,0
18855,user_18855,442,11,0,11,Mar-19,2,0,0
18856,user_18856,1176,101,54,47,Mar-19,2,0,0
18857,user_18857,3149,41,0,41,May-19,0,1,1
18858,user_18858,7027,70,4,66,May-19,0,1,1
18859,user_18859,1356,24,12,12,Jan-19,4,0,0
18860,user_18860,14858,582,11,571,May-19,0,1,1
18861,user_18861,3332,125,0,125,May-19,0,1,1
18863,user_18863,183,7,3,4,Apr-19,1,1,0
18864,user_18864,1813,22,2,20,May-19,0,1,1
18865,user_18865,30,3,1,2,Jan-19,4,0,0
18866,user_18866,9,2,2,0,Dec-18,5,0,0
18867,user_18867,11,2,2,0,Dec-18,5,0,0
18868,user_18868,1965,35,3,32,May-19,0,1,1
18869,user_18869,87,20,12,8,Apr-19,1,1,0
18870,user_18870,6507,152,2,150,May-19,0,1,1
18871,user_18871,14,2,1,1,May-19,0,0,1
18872,user_18872,5733,61,11,50,Apr-19,1,1,0
18873,user_18873,70,3,3,0,Dec-18,5,0,0
18874,user_18874,2009,111,21,90,May-19,0,1,1
18875,user_18875,2314,85,13,72,May-19,0,1,1
18876,user_18876,4522,98,1,97,May-19,0,1,1
18877,user_18877,606,10,9,1,Jan-19,4,0,0
18878,user_18878,2703,24,5,19,Apr-19,1,1,0
18879,user_18879,871,62,1,61,Apr-19,1,1,0
18880,user_18880,1326,32,2,30,May-19,0,1,1
18881,user_18881,3092,59,8,51,Mar-19,2,0,0
18882,user_18882,308,12,0,12,Mar-19,2,0,0
18883,user_18883,567,13,3,10,May-19,0,1,1
18884,user_18884,1390,15,2,13,Apr-19,1,1,0
18886,user_18886,1202,14,0,14,Apr-19,1,1,0
18887,user_18887,22,12,0,12,Feb-19,3,0,0
18888,user_18888,96,14,14,0,Dec-18,5,0,0
18889,user_18889,805,15,2,13,Jan-19,4,0,0
18890,user_18890,752,15,2,13,Mar-19,2,0,0
18891,user_18891,3237,58,2,56,May-19,0,1,1
18892,user_18892,3197,160,0,160,May-19,0,1,1
18893,user_18893,41648,410,8,402,May-19,0,1,1
18894,user_18894,28,5,3,2,Apr-19,1,1,0
18895,user_18895,265,17,5,12,May-19,0,1,1
18896,user_18896,14151,520,15,505,May-19,0,1,1
18897,user_18897,9,1,1,0,Dec-18,5,0,0
18898,user_18898,185,22,1,21,May-19,0,1,1
18899,user_18899,20,5,3,2,Jan-19,4,0,0
18900,user_18900,2064,32,3,29,Apr-19,1,1,0
18901,user_18901,13,5,2,3,May-19,0,0,1
18902,user_18902,3399,277,2,275,May-19,0,1,1
18903,user_18903,1283,53,3,50,May-19,0,1,1
18904,user_18904,836,20,2,18,Apr-19,1,1,0
18905,user_18905,27,5,3,2,Feb-19,3,0,0
18906,user_18906,615,21,10,11,May-19,0,1,1
18907,user_18907,93,13,7,6,Apr-19,1,1,0
18908,user_18908,132,9,0,9,Apr-19,1,1,0
18909,user_18909,3786,89,3,86,Apr-19,1,1,0
18910,user_18910,201,7,4,3,Apr-19,1,1,0
18911,user_18911,38,4,0,4,Apr-19,1,1,0
18912,user_18912,2915,118,10,108,May-19,0,1,1
18913,user_18913,9,3,0,3,Apr-19,1,1,0
18914,user_18914,3161,40,2,38,May-19,0,1,1
18915,user_18915,43,5,2,3,Jan-19,4,0,0
18916,user_18916,427,7,7,0,Dec-18,5,0,0
18917,user_18917,5854,523,15,508,May-19,0,1,1
18918,user_18918,18,3,3,0,Dec-18,5,0,0
18919,user_18919,65,12,3,9,May-19,0,1,1
18920,user_18920,707,76,3,73,May-19,0,1,1
18921,user_18921,40,5,3,2,Jan-19,4,0,0
18922,user_18922,1126,25,6,19,May-19,0,1,1
18923,user_18923,51,4,0,4,May-19,0,1,1
18924,user_18924,335,14,8,6,Apr-19,1,1,0
18925,user_18925,10488,167,47,120,May-19,0,0,1
18926,user_18926,1675,79,2,77,Mar-19,2,0,0
18927,user_18927,559,21,2,19,May-19,0,1,1
18928,user_18928,2,1,1,0,Dec-18,5,0,0
18929,user_18929,982,24,9,15,Mar-19,2,0,0
18930,user_18930,8,3,3,0,Dec-18,5,0,0
18931,user_18931,2312,60,0,60,May-19,0,1,1
18932,user_18932,247,16,2,14,May-19,0,1,1
18933,user_18933,1348,36,19,17,May-19,0,0,1
18934,user_18934,428,7,2,5,Apr-19,1,1,0
18935,user_18935,5207,137,1,136,May-19,0,1,1
18936,user_18936,272,32,3,29,May-19,0,1,1
18937,user_18937,15263,171,44,127,May-19,0,0,1
18938,user_18938,419,3,3,0,Dec-18,5,0,0
18939,user_18939,64,10,9,1,Jan-19,4,0,0
18940,user_18940,279,12,2,10,Apr-19,1,1,0
18941,user_18941,2997,105,58,47,May-19,0,1,1
18942,user_18942,744,47,2,45,May-19,0,1,1
18943,user_18943,478,63,9,54,May-19,0,1,1
18944,user_18944,103,7,1,6,Apr-19,1,1,0
18945,user_18945,8128,77,40,37,May-19,0,0,1
18946,user_18946,629,37,2,35,May-19,0,1,1
18947,user_18947,2643,52,2,50,May-19,0,1,1
18948,user_18948,1209,10,1,9,Apr-19,1,1,0
18949,user_18949,1015,40,0,40,Apr-19,1,1,0
18950,user_18950,1659,89,2,87,May-19,0,1,1
18951,user_18951,18,3,2,1,Jan-19,4,0,0
18952,user_18952,9,2,2,0,Dec-18,5,0,0
18953,user_18953,37,3,1,2,Apr-19,1,1,0
18955,user_18955,47966,159,7,152,May-19,0,1,1
18956,user_18956,1981,159,6,153,May-19,0,1,1
18957,user_18957,454,20,0,20,Jan-19,4,0,0
18958,user_18958,7757,607,4,603,May-19,0,1,1
18959,user_18959,2691,71,20,51,May-19,0,1,1
18960,user_18960,1233,45,2,43,May-19,0,1,1
18961,user_18961,180,6,2,4,Feb-19,3,0,0
18962,user_18962,121,3,3,0,Dec-18,5,0,0
18963,user_18963,2319,10,0,10,Mar-19,2,0,0
18964,user_18964,3236,76,2,74,May-19,0,1,1
18965,user_18965,163,8,3,5,Mar-19,2,0,0
18966,user_18966,20700,326,2,324,May-19,0,1,1
18967,user_18967,1,1,1,0,Dec-18,5,0,0
18968,user_18968,158,12,1,11,Apr-19,1,1,0
18969,user_18969,15,3,0,3,Feb-19,3,0,0
18970,user_18970,7877,118,4,114,May-19,0,1,1
18971,user_18971,2371,34,31,3,Apr-19,1,1,0
18973,user_18973,11,2,2,0,Dec-18,5,0,0
18974,user_18974,5331,145,5,140,May-19,0,1,1
18975,user_18975,17,7,3,4,May-19,0,1,1
18976,user_18976,9,1,0,1,Jan-19,4,0,0
18978,user_18978,4,2,2,0,Dec-18,5,0,0
18979,user_18979,4,2,2,0,Dec-18,5,0,0
18981,user_18981,4558,114,2,112,Apr-19,1,1,0
18982,user_18982,1322,116,23,93,May-19,0,1,1
18983,user_18983,350,24,7,17,Apr-19,1,1,0
18984,user_18984,9,2,2,0,Dec-18,5,0,0
18985,user_18985,9,2,2,0,Dec-18,5,0,0
18987,user_18987,3121,58,2,56,May-19,0,1,1
18988,user_18988,1799,64,2,62,May-19,0,1,1
18989,user_18989,329,30,2,28,May-19,0,1,1
18990,user_18990,10,1,0,1,Apr-19,1,1,0
18991,user_18991,1330,45,9,36,May-19,0,1,1
18992,user_18992,34,8,2,6,Apr-19,1,1,0
18993,user_18993,260,12,2,10,Mar-19,2,0,0
18994,user_18994,93,8,4,4,Feb-19,3,0,0
18995,user_18995,29,5,4,1,Jan-19,4,0,0
18996,user_18996,4864,126,2,124,May-19,0,1,1
18997,user_18997,2822,218,6,212,May-19,0,1,1
18998,user_18998,919,18,3,15,May-19,0,1,1
18999,user_18999,343,9,0,9,Apr-19,1,1,0
19000,user_19000,7129,128,14,114,May-19,0,1,1
19001,user_19001,92,6,4,2,Apr-19,1,1,0
19002,user_19002,15797,477,8,469,May-19,0,1,1
19003,user_19003,9,2,2,0,Dec-18,5,0,0
19004,user_19004,46636,560,5,555,May-19,0,1,1
19005,user_19005,5889,232,5,227,May-19,0,1,1
19006,user_19006,4,1,0,1,Jan-19,4,0,0
19007,user_19007,110965,13,7,6,Jan-19,4,0,0
19008,user_19008,566,63,16,47,Apr-19,1,1,0
19009,user_19009,3670,136,2,134,May-19,0,1,1
19010,user_19010,494,60,0,60,May-19,0,1,1
19011,user_19011,1994,141,4,137,Apr-19,1,1,0
19014,user_19014,11496,128,4,124,May-19,0,1,1
19015,user_19015,667,67,2,65,May-19,0,1,1
19016,user_19016,748,21,5,16,Apr-19,1,1,0
19017,user_19017,226,14,2,12,Apr-19,1,1,0
19018,user_19018,1377,76,4,72,May-19,0,1,1
19019,user_19019,3978,67,6,61,May-19,0,1,1
19020,user_19020,512,23,1,22,May-19,0,1,1
19021,user_19021,8285,55,3,52,May-19,0,1,1
19022,user_19022,11229,52,0,52,Mar-19,2,0,0
19023,user_19023,715,13,3,10,May-19,0,1,1
19025,user_19025,342,25,0,25,May-19,0,1,1
19026,user_19026,5287,38,0,38,May-19,0,1,1
19027,user_19027,2413,77,7,70,May-19,0,1,1
19028,user_19028,3919,148,11,137,Apr-19,1,1,0
19029,user_19029,2909,200,4,196,May-19,0,1,1
19030,user_19030,11725,181,4,177,May-19,0,1,1
19031,user_19031,10991,131,2,129,May-19,0,1,1
19032,user_19032,73,5,2,3,Feb-19,3,0,0
19033,user_19033,102,1,1,0,Dec-18,5,0,0
19034,user_19034,5641,136,4,132,May-19,0,1,1
19035,user_19035,528,18,2,16,May-19,0,1,1
19037,user_19037,168,5,0,5,Feb-19,3,0,0
19038,user_19038,539,52,0,52,May-19,0,1,1
19039,user_19039,2496,40,12,28,Feb-19,3,0,0
19040,user_19040,149,10,0,10,Mar-19,2,0,0
19041,user_19041,901,36,2,34,Apr-19,1,1,0
19042,user_19042,133,11,0,11,May-19,0,1,1
19043,user_19043,52,4,0,4,Apr-19,1,1,0
19044,user_19044,959,74,3,71,Apr-19,1,1,0
19045,user_19045,233,25,3,22,May-19,0,1,1
19046,user_19046,86,3,2,1,Mar-19,2,0,0
19047,user_19047,10,2,0,2,Jan-19,4,0,0
19048,user_19048,1267,30,2,28,May-19,0,1,1
19049,user_19049,40,2,2,0,Dec-18,5,0,0
19050,user_19050,2255,19,0,19,Apr-19,1,1,0
19051,user_19051,380,18,0,18,Apr-19,1,1,0
19052,user_19052,2193,128,4,124,May-19,0,1,1
19053,user_19053,9714,436,95,341,May-19,0,0,1
19054,user_19054,4608,117,0,117,May-19,0,1,1
19055,user_19055,20,2,2,0,Dec-18,5,0,0
19056,user_19056,476,12,5,7,May-19,0,0,1
19057,user_19057,72,21,8,13,Apr-19,1,1,0
19058,user_19058,351,49,0,49,Apr-19,1,1,0
19059,user_19059,119,16,3,13,Apr-19,1,1,0
19060,user_19060,9004,112,4,108,May-19,0,1,1
19061,user_19061,61,6,2,4,Mar-19,2,0,0
19062,user_19062,123,24,6,18,May-19,0,0,1
19063,user_19063,32,13,2,11,Apr-19,1,1,0
19064,user_19064,351,8,6,2,Feb-19,3,0,0
19065,user_19065,38,23,4,19,May-19,0,1,1
19066,user_19066,3299,362,2,360,May-19,0,1,1
19067,user_19067,183,31,8,23,May-19,0,1,1
19068,user_19068,2202,153,17,136,May-19,0,1,1
19069,user_19069,76,9,9,0,Dec-18,5,0,0
19070,user_19070,185,13,2,11,Mar-19,2,0,0
19071,user_19071,59,23,5,18,Apr-19,1,1,0
19072,user_19072,41,4,2,2,Jan-19,4,0,0
19073,user_19073,159,13,13,0,Dec-18,5,0,0
19074,user_19074,63,6,6,0,Dec-18,5,0,0
19075,user_19075,2100,151,0,151,May-19,0,1,1
19076,user_19076,834,26,2,24,May-19,0,0,1
19077,user_19077,8,5,5,0,Dec-18,5,0,0
19078,user_19078,7958,38,2,36,Apr-19,1,1,0
19079,user_19079,6830,358,8,350,May-19,0,1,1
19080,user_19080,12403,10,2,8,May-19,0,1,1
19081,user_19081,8138,348,1,347,May-19,0,1,1
19082,user_19082,16,3,2,1,Jan-19,4,0,0
19083,user_19083,9049,30,0,30,May-19,0,1,1
19084,user_19084,7107,53,0,53,Apr-19,1,1,0
19085,user_19085,11189,150,22,128,May-19,0,1,1
19086,user_19086,9,2,0,2,Jan-19,4,0,0
19087,user_19087,1084,22,2,20,Mar-19,2,0,0
19088,user_19088,1283,63,0,63,May-19,0,1,1
19089,user_19089,851854,71,2,69,May-19,0,1,1
19090,user_19090,1791,91,4,87,May-19,0,1,1
19091,user_19091,437,28,0,28,Jan-19,4,0,0
19092,user_19092,1803,68,0,68,May-19,0,1,1
19093,user_19093,123,9,0,9,Jan-19,4,0,0
19095,user_19095,9,10,10,0,Dec-18,5,0,0
19097,user_19097,302,6,2,4,Mar-19,2,0,0
19098,user_19098,109,12,2,10,May-19,0,1,1
19099,user_19099,12257,172,29,143,May-19,0,1,1
19101,user_19101,1562,61,2,59,May-19,0,0,1
19102,user_19102,9,1,1,0,Dec-18,5,0,0
19103,user_19103,885,103,1,102,Apr-19,1,1,0
19104,user_19104,60,8,3,5,Jan-19,4,0,0
19105,user_19105,9,8,8,0,Dec-18,5,0,0
19106,user_19106,204,36,0,36,May-19,0,1,1
19107,user_19107,7451,43,2,41,May-19,0,1,1
19108,user_19108,86,13,2,11,May-19,0,1,1
19109,user_19109,9,2,2,0,Dec-18,5,0,0
19110,user_19110,1177,39,14,25,May-19,0,1,1
19112,user_19112,355,15,3,12,Mar-19,2,0,0
19113,user_19113,96,8,2,6,Apr-19,1,1,0
19114,user_19114,7603,89,0,89,May-19,0,1,1
19115,user_19115,640,9,0,9,Apr-19,1,1,0
19116,user_19116,531,57,4,53,May-19,0,1,1
19117,user_19117,130,6,1,5,Jan-19,4,0,0
19118,user_19118,684,13,9,4,Mar-19,2,0,0
19119,user_19119,12970,440,1,439,May-19,0,1,1
19120,user_19120,2355,14,0,14,Jan-19,4,0,0
19121,user_19121,7532,44,41,3,Mar-19,2,0,0
19122,user_19122,8511,108,71,37,Jan-19,4,0,0
19123,user_19123,1796,55,0,55,May-19,0,1,1
19124,user_19124,590,7,0,7,May-19,0,0,1
19125,user_19125,515,12,0,12,Mar-19,2,0,0
19126,user_19126,271,40,2,38,May-19,0,1,1
19127,user_19127,63,9,5,4,Apr-19,1,1,0
19128,user_19128,1199,103,0,103,Apr-19,1,1,0
19129,user_19129,39,5,0,5,Jan-19,4,0,0
19130,user_19130,18,3,3,0,Dec-18,5,0,0
19131,user_19131,2183,168,7,161,May-19,0,1,1
19132,user_19132,15,2,2,0,Dec-18,5,0,0
19133,user_19133,901,11,1,10,Jan-19,4,0,0
19134,user_19134,1562,46,5,41,May-19,0,1,1
19135,user_19135,58751,712,67,645,May-19,0,1,1
19136,user_19136,26,3,3,0,Dec-18,5,0,0
19137,user_19137,1677,85,3,82,May-19,0,1,1
19138,user_19138,16,3,2,1,Jan-19,4,0,0
19140,user_19140,274,17,15,2,Jan-19,4,0,0
19141,user_19141,10,1,1,0,Dec-18,5,0,0
19142,user_19142,1134,68,0,68,May-19,0,1,1
19143,user_19143,42264,65,18,47,May-19,0,1,1
19144,user_19144,24092,106,13,93,Apr-19,1,1,0
19145,user_19145,2849,41,2,39,May-19,0,1,1
19146,user_19146,262,12,9,3,Mar-19,2,0,0
19147,user_19147,9,2,2,0,Dec-18,5,0,0
19148,user_19148,120,25,0,25,Feb-19,3,0,0
19149,user_19149,2227,96,6,90,May-19,0,1,1
19150,user_19150,12231,58,2,56,Apr-19,1,1,0
19151,user_19151,49,9,0,9,May-19,0,1,1
19152,user_19152,6361,86,55,31,Apr-19,1,1,0
19153,user_19153,10,1,1,0,Dec-18,5,0,0
19154,user_19154,7721,28,0,28,May-19,0,1,1
19155,user_19155,10,4,4,0,Dec-18,5,0,0
19156,user_19156,10,2,2,0,Dec-18,5,0,0
19157,user_19157,16,4,4,0,Dec-18,5,0,0
19158,user_19158,3245,106,39,67,May-19,0,1,1
19159,user_19159,83,25,12,13,May-19,0,1,1
19160,user_19160,9,2,2,0,Dec-18,5,0,0
19161,user_19161,398,61,3,58,Apr-19,1,1,0
19162,user_19162,21,4,4,0,Dec-18,5,0,0
19163,user_19163,340,26,0,26,May-19,0,0,1
19164,user_19164,1435,49,18,31,May-19,0,1,1
19165,user_19165,16598,160,14,146,May-19,0,1,1
19166,user_19166,16,2,2,0,Dec-18,5,0,0
19167,user_19167,1853,65,2,63,Mar-19,2,0,0
19168,user_19168,3129,60,36,24,May-19,0,1,1
19169,user_19169,6925,63,0,63,May-19,0,1,1
19170,user_19170,9223,332,8,324,May-19,0,1,1
19171,user_19171,8,2,2,0,Dec-18,5,0,0
19172,user_19172,1406,12,3,9,Feb-19,3,0,0
19173,user_19173,106,8,0,8,Apr-19,1,1,0
19174,user_19174,2092,35,2,33,Apr-19,1,1,0
19175,user_19175,277,8,1,7,Apr-19,1,1,0
19176,user_19176,9,2,2,0,Dec-18,5,0,0
19177,user_19177,9233,297,24,273,May-19,0,1,1
19179,user_19179,5340,357,2,355,May-19,0,1,1
19180,user_19180,1573,32,3,29,May-19,0,1,1
19181,user_19181,5961,42,13,29,May-19,0,1,1
19182,user_19182,6058,127,44,83,Feb-19,3,0,0
19183,user_19183,378,15,0,15,Apr-19,1,1,0
19184,user_19184,1074,17,0,17,May-19,0,1,1
19185,user_19185,2418,58,3,55,May-19,0,1,1
19187,user_19187,32,5,2,3,May-19,0,0,1
19188,user_19188,116,11,3,8,Apr-19,1,1,0
19189,user_19189,163,12,4,8,Mar-19,2,0,0
19190,user_19190,3182,127,2,125,May-19,0,1,1
19191,user_19191,1042,17,2,15,Jan-19,4,0,0
19192,user_19192,1192,195,9,186,May-19,0,1,1
19193,user_19193,379,7,2,5,Feb-19,3,0,0
19194,user_19194,143445,423,4,419,May-19,0,1,1
19195,user_19195,2723,86,2,84,May-19,0,1,1
19196,user_19196,956,21,0,21,Apr-19,1,1,0
19197,user_19197,1031,47,4,43,Apr-19,1,1,0
19198,user_19198,10666,218,4,214,Apr-19,1,1,0
19199,user_19199,886,102,0,102,May-19,0,1,1
19200,user_19200,48,4,0,4,Apr-19,1,1,0
19201,user_19201,2857,142,3,139,May-19,0,1,1
19202,user_19202,3000,32,7,25,Apr-19,1,1,0
19203,user_19203,57,9,7,2,Feb-19,3,0,0
19204,user_19204,389,74,3,71,Apr-19,1,1,0
19205,user_19205,1115,34,0,34,May-19,0,1,1
19206,user_19206,3460,76,7,69,Apr-19,1,1,0
19207,user_19207,20,2,2,0,Dec-18,5,0,0
19208,user_19208,28,7,2,5,Apr-19,1,1,0
19209,user_19209,1228,16,4,12,Jan-19,4,0,0
19210,user_19210,952,7,4,3,Jan-19,4,0,0
19211,user_19211,75,5,4,1,Jan-19,4,0,0
19212,user_19212,705,15,0,15,Apr-19,1,1,0
19213,user_19213,4481,49,3,46,Apr-19,1,1,0
19214,user_19214,56,11,11,0,Dec-18,5,0,0
19215,user_19215,6890,11,0,11,May-19,0,1,1
19216,user_19216,1850,65,17,48,May-19,0,1,1
19217,user_19217,2828,82,3,79,Apr-19,1,1,0
19219,user_19219,3563,35,4,31,May-19,0,1,1
19220,user_19220,21,3,3,0,Dec-18,5,0,0
19221,user_19221,20,2,2,0,Dec-18,5,0,0
19222,user_19222,378,9,3,6,Mar-19,2,0,0
19223,user_19223,95,8,3,5,Apr-19,1,1,0
19224,user_19224,4465,113,2,111,May-19,0,1,1
19225,user_19225,128,16,3,13,May-19,0,1,1
19227,user_19227,45985,41,2,39,May-19,0,1,1
19228,user_19228,111,6,4,2,Jan-19,4,0,0
19229,user_19229,654,36,0,36,Mar-19,2,0,0
19230,user_19230,6398,247,0,247,Apr-19,1,1,0
19231,user_19231,2355,33,0,33,May-19,0,1,1
19232,user_19232,23,4,2,2,Mar-19,2,0,0
19233,user_19233,6802,84,0,84,May-19,0,1,1
19234,user_19234,1241,117,2,115,May-19,0,1,1
19235,user_19235,905,29,3,26,Mar-19,2,0,0
19236,user_19236,78,7,3,4,Feb-19,3,0,0
19237,user_19237,1685,97,2,95,May-19,0,1,1
19238,user_19238,4698,113,2,111,May-19,0,1,1
19239,user_19239,9,2,2,0,Dec-18,5,0,0
19240,user_19240,1,1,1,0,Dec-18,5,0,0
19241,user_19241,1593,85,2,83,Apr-19,1,1,0
19242,user_19242,14394,52,2,50,Apr-19,1,1,0
19243,user_19243,5,1,1,0,Dec-18,5,0,0
19244,user_19244,5500,19,4,15,Mar-19,2,0,0
19245,user_19245,3232,37,4,33,Apr-19,1,1,0
19246,user_19246,1121,56,4,52,May-19,0,1,1
19247,user_19247,147,11,0,11,Apr-19,1,1,0
19248,user_19248,20112,133,3,130,May-19,0,1,1
19249,user_19249,1299,11,3,8,Mar-19,2,0,0
19250,user_19250,378,30,6,24,May-19,0,1,1
19251,user_19251,5,4,2,2,Jan-19,4,0,0
19252,user_19252,3210,75,7,68,May-19,0,1,1
19253,user_19253,12721,567,2,565,May-19,0,1,1
19254,user_19254,1297,63,17,46,May-19,0,0,1
19255,user_19255,959,5,0,5,Apr-19,1,1,0
19256,user_19256,623,14,7,7,Jan-19,4,0,0
19257,user_19257,201,20,6,14,May-19,0,1,1
19258,user_19258,1832,34,7,27,Apr-19,1,1,0
19259,user_19259,10347,721,2,719,May-19,0,1,1
19260,user_19260,9,2,0,2,Apr-19,1,1,0
19261,user_19261,2424,37,2,35,May-19,0,1,1
19262,user_19262,13996,105,0,105,May-19,0,1,1
19263,user_19263,6332,229,0,229,May-19,0,1,1
19264,user_19264,479,10,4,6,Mar-19,2,0,0
19265,user_19265,18,3,3,0,Dec-18,5,0,0
19266,user_19266,10100,315,8,307,Apr-19,1,1,0
19268,user_19268,39,12,4,8,Apr-19,1,1,0
19269,user_19269,73319,91,19,72,May-19,0,1,1
19270,user_19270,1132,79,0,79,May-19,0,1,1
19271,user_19271,2322,157,0,157,May-19,0,1,1
19272,user_19272,9,4,4,0,Dec-18,5,0,0
19273,user_19273,2,2,2,0,Dec-18,5,0,0
19274,user_19274,1241,37,2,35,May-19,0,1,1
19275,user_19275,8173,98,3,95,May-19,0,1,1
19277,user_19277,2600,187,15,172,May-19,0,1,1
19278,user_19278,39,4,2,2,Feb-19,3,0,0
19279,user_19279,4846,38,0,38,May-19,0,1,1
19280,user_19280,5491,91,21,70,May-19,0,1,1
19281,user_19281,2256,67,3,64,May-19,0,1,1
19282,user_19282,132,3,3,0,Dec-18,5,0,0
19283,user_19283,2490,107,25,82,May-19,0,1,1
19284,user_19284,387,41,1,40,May-19,0,1,1
19285,user_19285,18,6,2,4,Jan-19,4,0,0
19286,user_19286,299,23,4,19,May-19,0,1,1
19287,user_19287,10,1,1,0,Dec-18,5,0,0
19288,user_19288,9,2,2,0,Dec-18,5,0,0
19289,user_19289,11,2,2,0,Dec-18,5,0,0
19290,user_19290,14261,87,2,85,May-19,0,1,1
19291,user_19291,9,2,2,0,Dec-18,5,0,0
19292,user_19292,4075,80,2,78,Apr-19,1,1,0
19293,user_19293,5820,67,3,64,Apr-19,1,1,0
19294,user_19294,3714,239,1,238,May-19,0,1,1
19295,user_19295,2228,7,4,3,Feb-19,3,0,0
19296,user_19296,2350,22,2,20,Mar-19,2,0,0
19297,user_19297,15689,332,24,308,May-19,0,1,1
19298,user_19298,20,2,2,0,Dec-18,5,0,0
19299,user_19299,164,2,0,2,Jan-19,4,0,0
19300,user_19300,51745,46,21,25,Apr-19,1,1,0
19301,user_19301,607,13,2,11,Mar-19,2,0,0
19302,user_19302,1178,78,9,69,May-19,0,1,1
19303,user_19303,3938,165,2,163,May-19,0,1,1
19304,user_19304,877,20,2,18,May-19,0,1,1
19306,user_19306,1102,24,0,24,May-19,0,1,1
19307,user_19307,3792,98,2,96,Apr-19,1,1,0
19308,user_19308,9,2,0,2,May-19,0,0,1
19309,user_19309,2407,133,5,128,May-19,0,1,1
19310,user_19310,9,2,2,0,Dec-18,5,0,0
19311,user_19311,5721,202,26,176,May-19,0,1,1
19312,user_19312,3034,30,1,29,May-19,0,1,1
19313,user_19313,1871,64,13,51,Apr-19,1,1,0
19314,user_19314,2255,57,2,55,May-19,0,1,1
19315,user_19315,11,2,2,0,Dec-18,5,0,0
19316,user_19316,1385,102,6,96,May-19,0,1,1
19317,user_19317,3119,111,0,111,May-19,0,1,1
19318,user_19318,69,20,11,9,Apr-19,1,1,0
19319,user_19319,1462,78,19,59,May-19,0,1,1
19320,user_19320,1029,17,0,17,Jan-19,4,0,0
19322,user_19322,14090,72,7,65,May-19,0,1,1
19323,user_19323,3889,23,6,17,Apr-19,1,1,0
19324,user_19324,2162,52,2,50,May-19,0,1,1
19325,user_19325,6390,256,3,253,May-19,0,1,1
19327,user_19327,8524,241,4,237,May-19,0,1,1
19328,user_19328,18,3,2,1,Feb-19,3,0,0
19329,user_19329,13049,67,14,53,May-19,0,1,1
19330,user_19330,631,6,5,1,Jan-19,4,0,0
19331,user_19331,9,1,1,0,Dec-18,5,0,0
19332,user_19332,1229,80,1,79,May-19,0,1,1
19333,user_19333,104,11,6,5,Mar-19,2,0,0
19334,user_19334,7789,39,7,32,May-19,0,1,1
19335,user_19335,1762,72,2,70,May-19,0,1,1
19336,user_19336,18965,309,41,268,May-19,0,1,1
19337,user_19337,3394,96,25,71,Apr-19,1,1,0
19338,user_19338,3469,28,0,28,Mar-19,2,0,0
19339,user_19339,7349,285,4,281,May-19,0,1,1
19341,user_19341,81,4,2,2,Mar-19,2,0,0
19342,user_19342,9865,17,3,14,Mar-19,2,0,0
19343,user_19343,10,3,1,2,Mar-19,2,0,0
19344,user_19344,43,2,0,2,Feb-19,3,0,0
19345,user_19345,5017,114,1,113,May-19,0,1,1
19346,user_19346,1448,129,2,127,May-19,0,1,1
19347,user_19347,1811,36,4,32,Mar-19,2,0,0
19348,user_19348,665,18,8,10,Jan-19,4,0,0
19349,user_19349,2890,109,1,108,May-19,0,1,1
19350,user_19350,108,12,12,0,Dec-18,5,0,0
19351,user_19351,292372,199,9,190,May-19,0,1,1
19352,user_19352,32,14,5,9,May-19,0,1,1
19353,user_19353,207,35,2,33,May-19,0,1,1
19354,user_19354,1473,164,2,162,May-19,0,1,1
19355,user_19355,18253,362,2,360,May-19,0,1,1
19356,user_19356,8,1,1,0,Dec-18,5,0,0
19357,user_19357,424,18,10,8,May-19,0,1,1
19358,user_19358,24781,416,20,396,May-19,0,1,1
19359,user_19359,490,35,13,22,Apr-19,1,1,0
19360,user_19360,42140,70,4,66,Apr-19,1,1,0
19361,user_19361,14823,292,2,290,May-19,0,1,1
19362,user_19362,7908,15,0,15,May-19,0,1,1
19363,user_19363,89,8,0,8,Jan-19,4,0,0
19364,user_19364,18,3,3,0,Dec-18,5,0,0
19365,user_19365,18014,675,0,675,May-19,0,1,1
19366,user_19366,343,29,2,27,Apr-19,1,1,0
19367,user_19367,0,1,0,1,Apr-19,1,1,0
19369,user_19369,38,7,0,7,Jan-19,4,0,0
19370,user_19370,12791,142,2,140,Mar-19,2,0,0
19371,user_19371,70,10,0,10,May-19,0,0,1
19372,user_19372,797,19,4,15,Feb-19,3,0,0
19373,user_19373,4134,257,2,255,May-19,0,1,1
19374,user_19374,5538,110,0,110,May-19,0,1,1
19375,user_19375,341,3,0,3,May-19,0,1,1
19376,user_19376,3223,158,20,138,May-19,0,1,1
19378,user_19378,2901,39,2,37,May-19,0,1,1
19379,user_19379,56,8,2,6,Apr-19,1,1,0
19380,user_19380,253,10,2,8,May-19,0,1,1
19381,user_19381,141677,518,2,516,May-19,0,1,1
19382,user_19382,424,92,0,92,May-19,0,1,1
19383,user_19383,46,5,0,5,Jan-19,4,0,0
19384,user_19384,6896,91,5,86,May-19,0,1,1
19385,user_19385,6998,109,4,105,May-19,0,1,1
19387,user_19387,51,3,3,0,Dec-18,5,0,0
19388,user_19388,4797,120,5,115,May-19,0,1,1
19389,user_19389,1341,22,5,17,Feb-19,3,0,0
19390,user_19390,29394,732,2,730,May-19,0,1,1
19392,user_19392,1734,18,11,7,Apr-19,1,1,0
19393,user_19393,11,4,1,3,Apr-19,1,1,0
19394,user_19394,119,13,2,11,May-19,0,1,1
19395,user_19395,209,5,2,3,Feb-19,3,0,0
19396,user_19396,10998,33,3,30,May-19,0,1,1
19397,user_19397,9,3,3,0,Dec-18,5,0,0
19398,user_19398,20,10,10,0,Dec-18,5,0,0
19399,user_19399,11097,277,16,261,Apr-19,1,1,0
19400,user_19400,43,2,0,2,Jan-19,4,0,0
19401,user_19401,146,21,9,12,Apr-19,1,1,0
19402,user_19402,3919,209,4,205,May-19,0,1,1
19403,user_19403,1258,25,0,25,Mar-19,2,0,0
19404,user_19404,1649,80,4,76,May-19,0,1,1
19405,user_19405,193,85,1,84,May-19,0,1,1
19406,user_19406,165,32,6,26,Apr-19,1,1,0
19407,user_19407,3337,215,8,207,May-19,0,1,1
19408,user_19408,231,28,2,26,Feb-19,3,0,0
19409,user_19409,63,6,0,6,Jan-19,4,0,0
19410,user_19410,8,4,3,1,Feb-19,3,0,0
19412,user_19412,339,11,0,11,May-19,0,0,1
19413,user_19413,34,1,1,0,Dec-18,5,0,0
19414,user_19414,2051,34,2,32,May-19,0,0,1
19415,user_19415,533,28,2,26,May-19,0,1,1
19416,user_19416,20,6,0,6,Apr-19,1,1,0
19417,user_19417,4843,335,2,333,May-19,0,1,1
19418,user_19418,1295,19,7,12,Mar-19,2,0,0
19419,user_19419,931,91,4,87,Apr-19,1,1,0
19420,user_19420,8689,568,2,566,May-19,0,1,1
19421,user_19421,122,18,1,17,May-19,0,1,1
19423,user_19423,5315,89,38,51,Apr-19,1,1,0
19424,user_19424,772,29,0,29,Apr-19,1,1,0
19425,user_19425,598,24,2,22,May-19,0,1,1
19426,user_19426,33168,178,4,174,May-19,0,1,1
19427,user_19427,1243,130,0,130,May-19,0,1,1
19428,user_19428,1277,22,2,20,Apr-19,1,1,0
19429,user_19429,1131,92,5,87,May-19,0,1,1
